matchId,queueId,Diff_LV,Diff_CS,Diff_jglCS,Diff-K,Diff-K-top,K-WIN-top,K-LOSE-top,Diff-K-jug,K-WIN-jug,K-LOSE-jug,Diff-K-mid,K-WIN-mid,K-LOSE-mid,Diff-K-ad,K-WIN-ad,K-LOSE-ad,Diff-K-sup,K-WIN-sup,K-LOSE-sup,invadeKill,Diff-A,Diff_WARDplaced,Diff-ControlWARDplaced,LOSE_controlWARDPlaced,WIN_controlWARDPlaced,Diff_WARDkill,Diff_Inhibitor,Diff_TOWERkill,Diff_FirstDRAGON,Diff_FirstHERALD,Diff_Firsttower,Diff_FirstBLOOD,dragonType,result
KR_6760872941,420,4,22,12,15,5,5,0,3,5,2,2,3,1,1,2,1,4,4,0,0,16,2,3,1,4,-2,0,1,1,-1,1,1,4,1
KR_6747221082,420,2,-57,-8,7,2,2,0,1,2,1,5,6,1,1,3,2,-2,0,2,0,6,-2,1,2,3,0,0,-1,-1,-1,-1,-1,1,1
KR_6696278550,420,-4,0,-5,-1,2,4,2,-4,3,7,-2,2,4,3,3,0,0,1,1,1,-3,-1,0,8,8,0,0,0,-1,-1,0,1,5,1
KR_6758506482,420,4,107,28,9,5,5,0,-4,2,6,7,8,1,0,1,1,1,1,0,3,10,-35,3,2,5,3,0,1,0,1,1,1,0,1
KR_6737735876,420,1,26,-12,-6,-1,0,1,-4,1,5,0,2,2,1,3,2,-2,0,2,0,-5,2,0,4,4,1,0,-1,0,-1,-1,-1,0,1
KR_6612942058,420,3,16,9,4,0,1,1,-1,3,4,4,6,2,0,1,1,1,3,2,0,0,201,-3,6,3,3,0,0,1,-1,1,1,5,1
KR_6724604289,420,6,42,37,11,-2,2,4,3,4,1,5,6,1,5,8,3,0,0,0,-1,9,27,5,2,7,-6,0,4,1,1,1,-1,1,1
KR_6705390961,440,2,57,-38,7,1,4,3,-3,0,3,0,1,1,9,9,0,0,2,2,0,9,-139,-1,4,3,28,0,1,1,0,1,1,3,1
KR_6759655737,420,2,31,32,-4,0,1,1,-4,2,6,1,5,4,1,3,2,-2,3,5,0,0,115,2,2,4,0,0,0,1,1,1,1,3,1
KR_6712994762,420,1,-52,-4,5,0,4,4,3,3,0,-1,1,2,3,5,2,0,0,0,0,4,1,1,3,4,3,0,-1,-1,-1,1,1,6,1
KR_6721180529,420,3,15,23,10,8,8,0,-1,4,5,-1,2,3,3,3,0,1,2,1,0,7,-5,-3,6,3,4,0,3,1,1,1,1,5,1
KR_6627214952,420,1,53,-4,6,1,2,1,0,2,2,-1,2,3,6,8,2,0,0,0,1,13,18,5,2,7,0,0,1,-1,-1,1,1,5,1
KR_6554968057,420,2,10,13,0,-4,1,5,0,2,2,0,1,1,3,4,1,1,1,0,0,4,-9,-1,5,4,2,0,-1,1,-1,-1,1,4,1
KR_6689632010,420,3,-19,4,-2,3,3,0,1,2,1,-1,1,2,0,4,4,-5,2,7,0,-4,15,-2,7,5,6,0,1,1,-1,1,-1,1,1
KR_6634099950,420,0,29,12,0,-1,1,2,1,4,3,0,0,0,1,3,2,-1,1,2,0,-4,1,2,3,5,0,0,-1,1,-1,-1,1,4,1
KR_6759263656,420,-2,-70,-12,-3,0,2,2,0,2,2,-1,1,2,-2,0,2,0,3,3,0,2,3,-2,3,1,5,0,0,1,1,0,-1,2,1
KR_6728303259,440,1,46,16,1,1,7,6,-4,2,6,1,5,4,3,5,2,0,1,1,2,8,-2,-1,4,3,-3,0,0,1,-1,1,1,3,1
KR_6729697307,440,-1,-15,-4,5,0,2,2,2,7,5,0,4,4,4,12,8,-1,0,1,2,9,-28,0,4,4,7,0,-2,0,-1,-1,-1,0,1
KR_6750798024,420,6,118,28,22,1,2,1,4,4,0,11,12,1,3,3,0,3,3,0,1,20,227,5,0,5,-1,0,3,1,1,1,1,5,1
KR_6627203642,420,3,-26,9,7,-1,3,4,4,5,1,5,5,0,-1,1,2,0,0,0,1,6,0,-1,6,5,-1,0,0,-1,1,0,1,4,1
KR_6759527672,420,-2,66,-78,3,2,5,3,-8,1,9,6,9,3,3,4,1,0,3,3,-2,5,-15,-1,7,6,-3,0,1,-1,-1,1,1,6,1
KR_6761984290,420,5,47,-20,8,1,2,1,1,4,3,4,4,0,0,2,2,2,2,0,0,7,17,6,3,9,-6,0,0,-1,1,0,-1,1,1
KR_6757578241,420,4,50,4,10,1,3,2,3,3,0,1,1,0,2,4,2,3,3,0,1,11,4,2,4,6,-1,0,-1,1,-1,-1,1,5,1
KR_6754176073,420,2,-12,3,6,1,2,1,-1,3,4,2,2,0,1,1,0,3,3,0,0,8,124,0,3,3,2,0,0,1,-1,0,-1,3,1
KR_6734493597,420,7,21,40,7,3,4,1,-1,1,2,2,2,0,0,1,1,3,3,0,0,4,-11,0,4,4,1,0,1,1,-1,1,-1,2,1
KR_6447843339,420,2,39,-26,14,0,2,2,8,9,1,5,5,0,0,7,7,1,2,1,-1,12,96,7,2,9,4,0,2,1,1,1,-1,5,1
KR_6733720131,440,3,11,36,6,4,5,1,2,6,4,-3,2,5,2,2,0,1,2,1,0,7,-13,-1,6,5,1,0,0,-1,1,0,-1,5,1
KR_6661222511,420,4,-19,11,10,4,6,2,5,6,1,3,3,0,-3,2,5,1,2,1,0,6,249,-6,9,3,-1,0,2,0,1,1,1,0,1
KR_6677215421,420,2,-3,-20,4,0,0,0,2,2,0,3,5,2,0,2,2,-1,0,1,1,13,1,3,3,6,1,0,0,1,-1,0,1,2,1
KR_6727131136,420,0,30,-32,-1,2,4,2,-1,1,2,2,5,3,-5,2,7,1,1,0,0,-2,3,-3,5,2,-3,0,1,-1,1,1,-1,2,1
KR_6561500934,420,4,53,16,3,1,3,2,2,3,1,-6,0,6,3,5,2,3,4,1,1,9,2,3,3,6,1,0,1,-1,0,1,1,5,1
KR_6747762055,420,-4,-31,-12,-5,-2,5,7,-3,0,3,1,4,3,0,1,1,-1,0,1,0,-5,3,-4,6,2,-7,0,-2,-1,-1,-1,-1,6,1
KR_6699442687,420,2,20,16,2,4,5,1,0,1,1,0,2,2,-1,1,2,-1,0,1,1,-1,3,0,4,4,-3,0,1,0,1,1,1,0,1
KR_6688583764,420,4,18,9,12,1,3,2,3,3,0,3,3,0,4,4,0,1,1,0,1,9,9,2,1,3,1,0,2,1,1,1,1,4,1
KR_6599695293,420,0,4,-8,0,2,2,0,2,2,0,-5,0,5,-2,3,5,3,4,1,0,2,8,4,4,8,-4,0,0,1,0,0,1,2,1
KR_6604253753,420,0,-13,3,-2,0,2,2,-2,2,4,5,6,1,-2,3,5,-3,1,4,0,-8,-5,-2,4,2,1,0,0,1,-1,1,-1,1,1
KR_6629235109,420,0,-19,-1,-5,3,5,2,1,3,2,0,3,3,-6,1,7,-3,0,3,-1,-5,0,-5,9,4,-1,0,0,-1,1,1,-1,2,1
KR_6764691358,420,-2,-60,-8,2,-1,2,3,0,2,2,0,3,3,2,2,0,1,1,0,0,0,-2,0,3,3,0,0,1,-1,1,1,-1,1,1
KR_6750865411,420,1,27,4,1,-2,3,5,0,2,2,-1,0,1,5,7,2,-1,2,3,0,6,2,1,4,5,3,0,1,1,-1,1,-1,6,1
KR_6744923119,440,0,-30,16,-5,3,3,0,0,3,3,-3,0,3,-4,0,4,-1,0,1,0,-3,-8,-5,6,1,-1,0,0,0,0,-1,-1,0,1
KR_6691338702,420,1,2,58,-6,0,1,1,-2,3,5,2,4,2,-3,2,5,-3,1,4,1,-8,12,-3,5,2,-1,0,1,-1,1,1,1,1,1
KR_6724001205,420,-2,37,4,-2,1,1,0,0,2,2,-4,0,4,1,4,3,0,0,0,1,1,-3,-2,9,7,3,0,0,-1,1,0,1,4,1
KR_6759336927,440,-2,3,-32,2,-2,0,2,2,5,3,2,2,0,-1,3,4,1,1,0,0,9,-6,-1,4,3,-23,0,0,0,-1,0,1,0,1
KR_6742082940,440,3,12,10,5,-1,2,3,2,2,0,1,1,0,-1,2,3,4,6,2,0,5,20,-2,6,4,-4,0,1,1,-1,-1,1,1,1
KR_6686455200,420,8,126,56,19,8,11,3,-1,3,4,1,3,2,9,9,0,2,2,0,0,5,1,0,4,4,-2,0,4,1,1,1,1,3,1
KR_6761802524,420,0,24,-4,3,3,4,1,3,4,1,1,1,0,-6,2,8,2,2,0,0,-2,-6,1,2,3,-2,0,1,-1,1,1,1,4,1
KR_6752795741,420,1,5,4,1,2,3,1,2,5,3,0,1,1,-1,2,3,-2,0,2,0,5,-13,2,2,4,0,0,1,0,0,1,1,0,1
KR_6744083878,420,2,93,1,6,0,2,2,0,4,4,2,3,1,3,3,0,1,1,0,0,3,224,-1,8,7,8,0,0,1,1,1,1,5,1
KR_6733605544,420,-2,-59,4,-8,0,2,2,-1,1,2,-4,1,5,-2,2,4,-1,1,2,0,-7,-1,2,2,4,0,0,-1,-1,-1,-1,-1,2,1
KR_6753987492,420,8,191,-1,16,10,10,0,-1,2,3,2,4,2,3,4,1,2,2,0,0,8,7,-3,7,4,-3,0,1,1,1,1,1,5,1
KR_6740498641,440,-4,-7,14,-6,0,1,1,-3,1,4,1,2,1,-2,4,6,-2,1,3,0,-6,0,-1,4,3,-4,0,-1,0,-1,-1,-1,0,1
KR_6752589094,440,1,6,17,1,3,4,1,2,3,1,0,1,1,-2,0,2,-2,0,2,0,-2,-12,-6,7,1,-1,0,0,0,0,1,1,0,1
KR_6757360545,440,0,39,12,1,2,5,3,1,2,1,-5,1,6,-2,3,5,5,5,0,0,-3,-470,-1,3,2,0,0,1,0,1,1,1,0,1
KR_6749986507,420,1,-10,12,6,-2,0,2,1,2,1,1,1,0,5,7,2,1,1,0,0,11,21,2,4,6,-3,0,0,1,0,0,1,2,1
KR_6748668152,440,0,17,24,-2,-6,2,8,1,2,1,6,6,0,-4,2,6,1,3,2,0,-1,-16,4,0,4,2,0,0,1,-1,-1,-1,2,1
KR_6730520761,420,4,70,-29,10,-4,4,8,5,6,1,0,2,2,11,13,2,-2,0,2,-1,14,11,-4,8,4,2,0,1,-1,1,1,-1,2,1
KR_6638411139,420,5,23,32,9,2,2,0,3,4,1,-2,1,3,2,5,3,4,4,0,0,14,2,4,2,6,1,0,0,1,-1,0,1,1,1
KR_6757436226,420,-1,-32,1,-6,-1,2,3,2,5,3,-3,5,8,-2,3,5,-2,0,2,0,-5,-1,-5,6,1,2,0,0,-1,1,1,1,3,1
KR_6570502952,420,3,19,17,0,2,3,1,3,4,1,0,1,1,-3,0,3,-2,0,2,0,-3,13,1,4,5,6,0,1,1,1,1,-1,5,1
KR_6739429606,440,-1,-5,-15,3,1,2,1,1,4,3,1,3,2,1,2,1,-1,2,3,0,4,34,-3,8,5,-24,0,2,1,1,1,-1,6,1
KR_6762591151,420,2,42,-12,-2,-1,0,1,-1,3,4,-2,1,3,0,4,4,2,2,0,0,-3,-20,-3,6,3,-1,0,2,-1,-1,1,1,1,1
KR_6755163517,420,2,-29,15,1,1,4,3,0,3,3,-3,2,5,2,5,3,1,2,1,0,-3,3,1,1,2,1,0,-1,0,1,1,1,0,1
KR_6539723535,420,-1,45,-20,0,3,4,1,1,2,1,-3,1,4,1,5,4,-2,0,2,-1,1,4,3,5,8,1,0,1,1,-1,1,-1,6,1
KR_6695690945,420,0,28,-4,-1,1,2,1,-8,2,10,2,7,5,3,3,0,1,3,2,-1,-1,-32,-1,1,0,1,0,-1,1,-1,-1,-1,5,1
KR_6761277152,420,2,3,-9,7,0,3,3,3,4,1,4,8,4,2,3,1,-2,0,2,0,4,-15,-1,2,1,1,0,0,-1,-1,1,1,1,1
KR_6658656722,440,3,37,16,11,5,5,0,2,3,1,3,3,0,4,5,1,-3,0,3,0,1,-413,5,2,7,-23,0,2,1,1,1,1,4,1
KR_6348338059,420,-1,29,-11,1,-2,0,2,-4,1,5,5,5,0,2,5,3,0,1,1,1,3,2,3,4,7,1,0,0,1,-1,0,1,2,1
KR_6686501864,420,0,-14,6,-2,1,5,4,3,3,0,-5,3,8,-1,1,2,0,2,2,0,-12,-5,-6,10,4,0,0,0,1,-1,-1,1,3,1
KR_6753887366,420,1,-47,4,-6,-1,0,1,-2,1,3,-2,2,4,1,4,3,-2,0,2,-2,-11,0,-1,8,7,2,0,-1,1,1,-1,1,1,1
KR_6675202381,420,5,80,25,1,4,5,1,1,3,2,-3,0,3,-1,2,3,0,2,2,-1,-2,-2,-2,8,6,-4,0,1,-1,-1,1,-1,3,1
KR_6740342989,420,4,25,13,9,2,3,1,8,11,3,0,1,1,1,3,2,-2,0,2,1,12,-1,1,3,4,0,0,0,1,-1,-1,1,6,1
KR_6714202997,420,4,-9,28,6,2,2,0,-2,1,3,5,7,2,1,1,0,0,0,0,0,1,33,3,3,6,0,0,0,0,1,0,1,0,1
KR_6764452072,420,2,-3,-1,4,9,9,0,-7,2,9,3,6,3,4,5,1,-5,1,6,0,0,14,1,4,5,-1,0,1,0,0,1,1,0,1
KR_6675389382,420,2,48,-8,8,1,1,0,0,2,2,3,3,0,3,4,1,1,1,0,0,9,-2,1,3,4,-2,0,1,-1,1,1,1,2,1
KR_6758492029,440,4,54,5,15,6,6,0,2,3,1,5,7,2,0,3,3,2,2,0,0,21,8,2,6,8,2,0,0,1,-1,1,1,2,1
KR_6761314333,420,1,12,-1,-7,2,3,1,0,1,1,-2,2,4,-6,3,9,-1,1,2,0,-13,6,0,4,4,-3,0,1,-1,0,1,1,6,1
KR_6720610218,420,-1,10,0,-2,-5,1,6,-4,1,5,2,3,1,4,4,0,1,1,0,0,0,18,-2,4,2,3,0,1,1,-1,1,-1,2,1
KR_6762716262,420,2,-19,8,7,0,1,1,-1,3,4,2,2,0,7,7,0,-1,0,1,0,11,35,-3,10,7,16,0,0,1,-1,1,1,3,1
KR_6761283158,420,1,20,3,0,1,1,0,1,7,6,1,3,2,-3,3,6,0,1,1,0,-2,6,-2,9,7,-1,0,-1,-1,-1,1,1,2,1
KR_6726635684,420,2,14,25,7,1,4,3,0,1,1,5,8,3,3,3,0,-2,3,5,0,3,-20,0,6,6,-1,0,2,-1,1,1,-1,3,1
KR_6716547951,420,4,-45,43,15,6,6,0,4,4,0,4,10,6,4,7,3,-3,2,5,0,15,-10,3,3,6,1,0,0,1,1,1,-1,1,1
KR_6494768892,420,-1,-68,-8,2,-1,0,1,-1,4,5,-1,2,3,-1,2,3,6,6,0,1,7,49,-4,6,2,6,0,0,1,0,-1,1,3,1
KR_6724333845,420,6,71,31,14,5,5,0,6,6,0,0,1,1,3,5,2,0,0,0,0,15,11,3,1,4,-2,0,2,1,1,1,1,4,1
KR_6756689382,420,0,22,-13,0,1,3,2,0,3,3,-1,1,2,1,2,1,-1,0,1,0,-1,-3,-1,5,4,-1,0,1,-1,-1,1,-1,1,1
KR_6679890130,420,2,54,4,3,2,3,1,0,1,1,1,1,0,0,0,0,0,0,0,0,1,107,0,5,5,-1,0,0,0,1,0,1,0,1
KR_6707108619,420,3,4,23,8,4,4,0,-1,0,1,-3,1,4,5,6,1,3,3,0,0,6,-2,4,3,7,-1,0,2,1,1,1,1,4,1
KR_6740337667,420,-1,42,0,1,0,1,1,-2,1,3,5,6,1,-1,2,3,-1,1,2,0,-2,5,5,4,9,-2,0,-1,-1,-1,-1,-1,2,1
KR_6712372198,420,4,56,12,5,1,1,0,3,4,1,-1,1,2,1,4,3,1,3,2,0,7,10,-1,5,4,-1,0,0,1,-1,0,1,5,1
KR_6697123107,420,2,117,-36,0,1,2,1,-4,2,6,2,3,1,3,7,4,-2,0,2,0,-6,1,-1,3,2,4,0,1,0,-1,1,1,0,1
KR_6349094159,420,2,27,12,3,-3,1,4,0,3,3,-3,2,5,8,9,1,1,1,0,0,5,131,3,6,9,1,0,1,1,-1,1,1,6,1
KR_6758520327,420,2,20,7,7,-1,2,3,2,4,2,2,2,0,4,4,0,0,0,0,1,13,-3,3,4,7,3,0,1,1,1,1,1,6,1
KR_6604450791,420,3,63,15,7,0,1,1,4,8,4,6,7,1,-1,3,4,-2,0,2,0,9,4,2,3,5,1,0,1,1,1,1,1,3,1
KR_6743542736,420,-2,-12,16,0,-5,0,5,5,6,1,0,2,2,0,3,3,0,0,0,0,4,-6,-3,6,3,3,0,1,1,1,1,1,6,1
KR_6757503723,440,-4,-23,0,-13,1,2,1,-6,3,9,-3,1,4,-4,1,5,-1,2,3,0,-5,4,-2,6,4,3,0,-1,0,-1,1,-1,0,1
KR_6645145403,420,0,37,-4,1,-6,0,6,5,7,2,3,4,1,0,1,1,-1,0,1,0,9,7,3,2,5,0,0,1,-1,1,1,1,4,1
KR_6675252158,420,6,-10,11,16,0,1,1,0,3,3,4,4,0,7,8,1,5,6,1,1,13,13,-1,4,3,0,0,0,1,1,1,1,4,1
KR_6753647962,420,-2,-22,0,-6,1,5,4,-4,1,5,0,4,4,-5,1,6,2,3,1,0,-13,2,-2,6,4,1,0,1,-1,1,1,1,4,1
KR_6657253224,440,-1,-16,-12,-9,2,3,1,-1,4,5,-6,2,8,-3,0,3,-1,0,1,-2,-9,-149,0,2,2,-33,0,0,-1,-1,-1,-1,1,1
KR_6669803754,420,3,-43,8,4,-1,1,2,4,6,2,-7,1,8,3,3,0,5,5,0,0,4,-2,1,3,4,-1,0,1,-1,1,1,-1,2,1
KR_6701424287,440,-2,-45,4,2,1,1,0,0,1,1,-4,0,4,3,5,2,2,2,0,0,7,4,-1,8,7,0,0,-1,1,-1,-1,1,3,1
KR_6685443651,420,1,65,24,4,5,5,0,1,3,2,-1,3,4,0,1,1,-1,0,1,2,4,29,-1,2,1,-1,0,0,1,-1,0,1,4,1
KR_6734066942,440,3,12,32,0,0,3,3,-2,1,3,7,12,5,-7,1,8,2,3,1,-2,-12,1,-6,6,0,-3,0,1,1,0,1,-1,6,1
KR_6746274760,420,1,-14,56,-1,4,4,0,2,7,5,0,3,3,-4,0,4,-3,0,3,-1,2,-4,1,6,7,3,0,0,1,1,-1,-1,3,1
KR_6714719560,420,-2,-57,-30,-5,-3,0,3,3,6,3,-2,0,2,-2,1,3,-1,0,1,1,-2,10,5,2,7,-6,0,-1,-1,1,-1,1,5,1
KR_6695767813,420,4,84,0,10,0,1,1,-2,4,6,8,10,2,3,4,1,1,1,0,0,5,122,5,4,9,-3,0,3,1,1,1,-1,4,1
KR_6632548028,420,4,84,-4,12,1,2,1,0,1,1,2,4,2,8,8,0,1,1,0,0,10,-4,-1,4,3,4,0,-1,1,1,-1,1,4,1
KR_6742258017,420,2,65,-20,11,2,3,1,3,3,0,-3,0,3,5,5,0,4,4,0,0,12,19,-2,5,3,4,0,2,1,1,1,1,5,1
KR_6759793649,440,2,34,12,5,3,3,0,1,3,2,1,1,0,0,1,1,0,0,0,0,1,11,3,3,6,3,0,0,0,1,0,1,0,1
KR_6758098118,420,1,-53,12,7,2,4,2,4,4,0,-2,3,5,3,4,1,0,1,1,-1,5,3,1,3,4,1,0,1,1,1,1,-1,2,1
KR_6664142210,420,3,41,16,5,5,5,0,2,3,1,1,3,2,-1,1,2,-2,0,2,0,0,2,0,6,6,0,0,0,-1,1,1,-1,4,1
KR_6758544170,420,4,53,-1,8,1,2,1,0,1,1,6,6,0,2,5,3,-1,1,2,0,3,0,3,3,6,6,0,1,1,-1,1,1,4,1
KR_6739486935,440,-1,21,15,-2,1,1,0,1,1,0,0,2,2,0,2,2,-4,0,4,0,0,48,2,1,3,-17,0,1,1,0,1,1,3,1
KR_6761837538,420,8,35,48,8,9,9,0,2,4,2,-2,0,2,-1,6,7,0,0,0,0,2,1,-1,4,3,-1,0,1,1,1,1,-1,4,1
KR_6505476263,440,-1,9,5,-1,2,4,2,1,2,1,-1,3,4,-1,4,5,-2,0,2,0,0,-4,-2,8,6,-1,0,0,1,-1,-1,1,4,1
KR_6520715110,420,2,15,21,0,3,4,1,-5,0,5,5,6,1,-2,0,2,-1,1,2,1,-6,1,1,6,7,5,0,1,-1,1,1,-1,6,1
KR_6740498592,420,7,82,37,18,4,6,2,8,11,3,2,4,2,4,6,2,0,1,1,0,19,-244,6,4,10,-1,0,1,1,1,1,1,5,1
KR_6763667332,420,0,5,-12,3,-2,2,4,-1,2,3,3,3,0,2,4,2,1,3,2,0,9,12,4,1,5,-1,0,0,0,1,0,1,0,1
KR_6749908253,420,1,13,-4,5,0,3,3,-2,0,2,5,7,2,3,3,0,-1,0,1,-1,8,1,-2,3,1,2,0,1,1,1,1,-1,6,1
KR_6720070277,420,-1,11,12,-1,2,4,2,-1,0,1,-4,1,5,0,2,2,2,2,0,0,1,148,-2,5,3,3,0,0,-1,1,1,1,5,1
KR_6717824469,420,3,106,3,0,4,4,0,0,3,3,-2,0,2,-4,2,6,2,3,1,0,-3,2,1,3,4,-2,0,3,0,-1,1,1,0,1
KR_6763533115,440,0,-45,-8,2,-1,0,1,-1,2,3,2,2,0,2,7,5,0,2,2,0,2,19,3,4,7,-2,0,0,1,-1,1,1,4,1
KR_6759565625,420,3,12,12,9,2,4,2,4,5,1,0,1,1,1,2,1,2,2,0,-1,8,9,6,2,8,-1,0,1,0,-1,1,-1,0,1
KR_6591657714,420,4,-2,16,9,3,5,2,1,2,1,4,5,1,2,2,0,-1,2,3,0,9,-5,4,1,5,5,0,-2,1,-1,-1,-1,3,1
KR_6731421712,440,1,37,4,4,0,0,0,-2,0,2,4,5,1,2,2,0,0,2,2,0,7,17,2,3,5,3,0,2,1,1,1,1,5,1
KR_6596893555,420,0,-2,4,-5,-2,0,2,-5,6,11,2,4,2,1,4,3,-1,2,3,0,-6,23,3,5,8,-12,0,0,1,1,0,-1,3,1
KR_6745256226,420,3,25,20,6,0,3,3,0,3,3,0,1,1,3,5,2,3,5,2,-1,4,2,3,3,6,-1,0,0,0,0,1,-1,0,1
KR_6732882484,420,0,64,33,-3,0,0,0,-1,1,2,0,0,0,-1,1,2,-1,2,3,1,-3,43,-1,6,5,-28,0,1,1,-1,1,1,2,1
KR_6761603681,420,2,-14,-4,1,-3,1,4,2,4,2,2,2,0,0,1,1,0,1,1,0,6,9,3,1,4,-1,0,0,1,0,0,-1,4,1
KR_6667553036,420,11,223,8,15,7,7,0,2,2,0,2,2,0,3,3,0,1,2,1,0,12,30,2,3,5,0,0,5,0,1,1,1,0,1
KR_6761000676,420,1,53,-16,7,-1,1,2,5,7,2,7,8,1,-4,1,5,0,1,1,0,5,-12,0,4,4,0,0,1,1,1,1,1,6,1
KR_6745336749,440,3,5,20,3,2,2,0,1,1,0,0,1,1,0,1,1,0,2,2,0,2,-26,3,4,7,-4,0,0,1,-1,0,-1,5,1
KR_6733664893,440,0,24,-19,0,-3,0,3,-2,2,4,1,5,4,4,7,3,0,4,4,1,7,28,0,3,3,-2,0,2,1,1,1,1,2,1
KR_6345060413,420,2,39,2,5,2,4,2,4,5,1,-1,1,2,0,1,1,0,0,0,0,3,4,2,3,5,0,0,0,0,0,1,1,0,1
KR_6720539019,420,3,76,21,7,1,3,2,-2,3,5,7,7,0,2,5,3,-1,3,4,0,-6,-3,-2,8,6,1,0,1,0,1,1,1,0,1
KR_6694764109,420,2,76,2,3,5,5,0,4,5,1,-1,1,2,-6,1,7,1,2,1,0,-7,16,-2,4,2,1,0,1,1,1,1,-1,5,1
KR_6753323472,420,-2,-29,-30,-2,3,4,1,-4,2,6,0,4,4,-1,0,1,0,0,0,0,-2,7,-4,7,3,0,0,-1,0,0,-1,-1,0,1
KR_6745742098,420,5,102,24,18,1,2,1,3,5,2,5,5,0,8,12,4,1,1,0,1,8,6,-2,7,5,4,0,2,1,-1,1,1,5,1
KR_6756748453,420,5,182,11,17,5,5,0,1,2,1,3,4,1,5,6,1,3,4,1,0,11,35,0,4,4,1,0,4,1,1,1,-1,3,1
KR_6709776229,420,-2,-16,-14,-4,0,2,2,-3,2,5,-4,1,5,3,3,0,0,0,0,0,-3,16,-1,6,5,1,0,0,1,-1,1,-1,5,1
KR_6760997809,420,0,31,23,0,-2,0,2,-1,2,3,2,4,2,2,5,3,-1,1,2,1,-5,-1,-2,5,3,2,0,-1,1,-1,1,1,6,1
KR_6705068200,420,2,45,-8,1,3,4,1,3,7,4,-2,1,3,-2,4,6,-1,1,2,-1,0,99,-1,10,9,-5,0,1,-1,0,1,-1,6,1
KR_6711212567,420,6,68,27,11,3,3,0,10,12,2,0,0,0,-1,1,2,-1,0,1,0,11,5,1,4,5,-1,0,0,-1,-1,0,1,2,1
KR_6759714198,420,3,-75,11,5,2,5,3,-1,1,2,1,1,0,3,4,1,0,2,2,-1,14,-6,-4,7,3,0,0,-1,-1,-1,-1,-1,2,1
KR_6729076865,420,6,88,-9,15,5,5,0,2,4,2,7,8,1,-1,0,1,2,2,0,0,9,18,6,3,9,-6,0,1,1,1,1,1,5,1
KR_6723517867,420,2,17,4,1,4,6,2,-3,2,5,1,2,1,-3,4,7,2,2,0,-1,-3,-11,-5,9,4,9,0,0,1,-1,-1,-1,5,1
KR_6741568862,420,2,-71,4,3,-1,1,2,3,4,1,-5,0,5,6,7,1,0,0,0,0,2,-11,0,3,3,-2,0,-1,-1,-1,-1,1,2,1
KR_6695753749,420,3,56,-7,11,3,3,0,0,2,2,3,4,1,5,6,1,0,0,0,0,6,-45,-2,6,4,32,0,2,1,-1,1,1,3,1
KR_6751932103,420,-1,-16,-24,-3,-4,1,5,-2,4,6,1,1,0,4,4,0,-2,1,3,0,1,3,2,3,5,0,0,0,0,-1,1,-1,0,1
KR_6764034369,420,1,25,-9,4,1,1,0,4,5,1,-2,1,3,-1,1,2,2,2,0,0,3,0,-2,4,2,-1,0,0,1,-1,0,-1,3,1
KR_6741914008,440,5,69,-3,9,-1,5,6,4,6,2,5,6,1,-1,0,1,2,3,1,0,1,43,-1,4,3,-19,0,1,1,0,1,1,3,1
KR_6631755220,420,7,22,26,14,10,10,0,0,3,3,0,1,1,1,5,4,3,3,0,0,10,5,-2,4,2,3,0,1,1,1,1,1,4,1
KR_6684681728,420,1,73,-8,-1,-1,1,2,4,6,2,-2,2,4,0,2,2,-2,0,2,0,2,-10,-3,6,3,5,0,0,-1,1,0,-1,1,1
KR_6761274261,420,1,-48,20,-7,1,1,0,1,4,3,-5,1,6,-3,0,3,-1,1,2,0,-11,-5,-3,5,2,-2,0,1,0,0,1,-1,0,1
KR_6644629366,420,2,-4,19,-4,-2,0,2,-1,1,2,1,2,1,-2,3,5,0,0,0,0,-9,-4,3,3,6,2,0,0,-1,1,0,-1,3,1
KR_6746865856,420,6,32,14,11,0,1,1,3,4,1,8,8,0,0,3,3,0,2,2,0,2,-15,-1,9,8,9,0,1,1,1,1,-1,3,1
KR_6757395788,420,1,-3,-15,8,-3,1,4,2,4,2,2,4,2,5,5,0,2,2,0,0,15,4,2,5,7,2,0,1,-1,1,1,-1,6,1
KR_6660077849,440,3,100,8,6,2,2,0,5,6,1,-2,0,2,-1,2,3,2,3,1,0,-5,3,-2,5,3,5,0,0,1,1,1,-1,3,1
KR_6761438338,440,-2,13,-45,-2,1,1,0,1,2,1,-2,2,4,-1,1,2,-1,3,4,0,3,4,0,8,8,-3,0,0,1,-1,0,-1,6,1
KR_6752723465,420,1,14,16,5,4,4,0,0,1,1,3,6,3,-1,2,3,-1,0,1,-1,2,-26,-2,6,4,5,0,-1,-1,1,-1,-1,4,1
KR_6514528269,420,6,63,24,5,5,5,0,-4,2,6,0,2,2,1,4,3,3,3,0,0,2,20,4,4,8,-1,0,2,1,1,1,-1,5,1
KR_6022269121,420,5,130,27,3,0,2,2,-1,5,6,3,3,0,-3,2,5,4,4,0,0,7,8,-2,6,4,2,0,3,1,1,1,-1,1,1
KR_6608625604,420,1,42,10,1,6,6,0,0,3,3,-4,0,4,0,0,0,-1,0,1,0,-11,-4,-3,10,7,1,0,1,1,1,1,1,3,1
KR_6759843789,420,0,56,-12,3,-1,1,2,2,3,1,-3,1,4,6,9,3,-1,0,1,1,0,5,4,1,5,3,0,0,0,1,1,1,0,1
KR_6756200087,440,1,0,-16,-3,0,2,2,-2,2,4,-1,1,2,-1,7,8,1,1,0,1,-4,1,-3,9,6,2,0,0,-1,1,0,1,4,1
KR_6580100673,420,3,20,-9,6,3,3,0,-1,4,5,1,2,1,3,4,1,0,0,0,1,11,16,-3,10,7,2,0,0,1,-1,-1,1,2,1
KR_6731292249,420,3,-1,8,10,-4,1,5,4,4,0,1,4,3,8,9,1,1,1,0,0,12,1,6,1,7,-3,0,-1,1,1,-1,1,6,1
KR_6708731417,440,14,176,48,14,2,3,1,4,4,0,2,2,0,3,5,2,3,3,0,0,14,17,1,0,1,-1,0,5,1,1,1,1,2,1
KR_6753285601,420,6,83,-12,13,3,3,0,2,2,0,3,3,0,3,3,0,2,2,0,0,12,9,5,3,8,4,0,2,-1,1,1,1,5,1
KR_6736163263,420,1,-13,-4,6,2,3,1,3,4,1,0,2,2,-1,2,3,2,4,2,0,7,-10,1,5,6,1,0,0,-1,1,1,-1,6,1
KR_6274859371,420,4,77,13,10,-1,1,2,2,3,1,4,5,1,8,8,0,-3,0,3,0,17,7,4,3,7,-4,0,0,1,-1,-1,-1,3,1
KR_6736653758,420,3,88,52,11,0,1,1,2,2,0,5,7,2,1,2,1,3,4,1,0,3,4,-3,5,2,3,0,1,0,-1,1,1,0,1
KR_6736305645,420,3,23,8,-1,2,3,1,-4,0,4,-5,0,5,6,8,2,0,0,0,0,8,-19,-3,5,2,2,0,1,0,-1,-1,-1,0,1
KR_6740248839,440,-1,-27,-3,-4,1,1,0,-2,1,3,2,4,2,-2,4,6,-3,0,3,0,-6,10,2,4,6,-4,0,1,-1,-1,1,1,5,1
KR_6657368177,420,4,66,39,6,3,5,2,-1,4,5,6,7,1,-1,2,3,-1,1,2,1,3,0,4,5,9,3,0,3,1,1,1,1,3,1
KR_6733702796,420,-1,-55,0,-7,-1,3,4,-1,1,2,-2,1,3,-3,4,7,0,0,0,0,-11,-10,-4,6,2,-1,0,0,-1,-1,-1,-1,4,1
KR_6634312806,420,1,33,-6,6,8,9,1,0,2,2,-2,0,2,0,3,3,0,1,1,0,7,6,-2,4,2,-3,0,2,1,1,1,-1,1,1
KR_6667669071,420,2,5,48,-1,1,2,1,0,3,3,-6,0,6,4,5,1,0,0,0,-1,-8,192,-3,6,3,0,0,0,1,1,0,-1,3,1
KR_6732213523,420,2,27,0,3,-1,1,2,3,5,2,2,3,1,0,3,3,-1,1,2,0,6,2,5,2,7,0,0,-1,1,-1,-1,1,3,1
KR_6708774987,420,3,53,-7,8,6,6,0,4,7,3,-2,2,4,2,2,0,-2,3,5,1,9,0,0,6,6,1,0,1,-1,1,1,1,3,1
KR_6656396456,420,0,-15,-5,-2,-3,1,4,-3,0,3,7,10,3,0,3,3,-3,0,3,0,-6,65,0,4,4,-3,0,1,-1,-1,1,-1,5,1
KR_6762566230,420,0,-46,12,9,0,1,1,-1,4,5,2,3,1,9,10,1,-1,1,2,0,7,229,4,1,5,-2,0,0,1,1,0,1,6,1
KR_6734503505,420,-1,-42,-28,-1,-2,3,5,-2,2,4,-1,4,5,3,4,1,1,2,1,0,5,4,3,0,3,-1,0,-1,-1,-1,-1,1,2,1
KR_6740287129,420,5,62,16,5,5,7,2,1,3,2,0,1,1,-2,1,3,1,1,0,-1,6,-16,-4,10,6,-1,0,1,-1,1,1,-1,4,1
KR_6749119814,420,1,11,-12,3,1,3,2,-1,1,2,0,1,1,3,4,1,0,0,0,0,7,197,-6,8,2,0,0,1,-1,0,1,1,4,1
KR_6751120830,420,-1,-25,5,-7,-3,1,4,0,1,1,4,5,1,2,3,1,-10,0,10,0,-5,21,2,2,4,1,0,-2,-1,1,-1,-1,5,1
KR_6721063650,420,3,11,0,5,2,4,2,-1,3,4,0,2,2,4,7,3,0,3,3,0,0,10,5,2,7,-1,0,1,-1,1,1,-1,6,1
KR_6626414637,420,6,91,-3,12,4,5,1,0,2,2,2,3,1,7,10,3,-1,2,3,1,16,-6,-1,4,3,4,0,2,1,1,1,1,1,1
KR_6706798758,420,-1,-44,16,-4,0,2,2,2,6,4,0,2,2,-2,0,2,-4,0,4,-2,-9,-47,-1,7,6,16,0,-2,-1,-1,-1,-1,5,1
KR_6762416531,420,6,47,10,11,6,6,0,-2,3,5,-1,1,2,6,6,0,2,3,1,0,2,5,6,3,9,-2,0,2,-1,1,1,-1,6,1
KR_6727081910,420,1,-9,-10,3,3,6,3,-2,2,4,-2,1,3,3,5,2,1,1,0,0,6,0,1,5,6,0,0,0,-1,1,-1,-1,3,1
KR_6758437195,420,1,-53,3,6,2,6,4,3,5,2,6,7,1,-4,2,6,-1,0,1,1,14,33,4,3,7,3,0,0,0,1,-1,1,0,1
KR_6648873822,420,3,18,-4,13,-3,0,3,6,6,0,4,6,2,7,8,1,-1,1,2,0,17,7,-1,3,2,4,0,1,-1,1,1,-1,6,1
KR_6667537379,420,1,109,-16,1,5,5,0,-2,1,3,0,2,2,-1,0,1,-1,0,1,0,-7,-19,-4,7,3,7,0,0,-1,1,0,1,2,1
KR_6730546878,440,2,45,8,3,2,4,2,2,2,0,-4,2,6,2,2,0,1,1,0,0,2,4,-1,3,2,1,0,1,-1,1,1,1,4,1
KR_6651399156,420,-2,38,-25,11,-1,1,2,9,9,0,-1,0,1,2,3,1,2,2,0,0,18,-33,0,5,5,25,0,0,1,1,1,1,2,1
KR_6672205909,420,2,37,4,8,1,1,0,4,6,2,0,0,0,0,1,1,3,3,0,0,5,-7,-4,5,1,1,0,3,1,1,1,1,5,1
KR_6369753607,420,-1,67,-32,8,2,2,0,3,5,2,-5,0,5,6,7,1,2,3,1,0,20,0,0,0,0,-2,0,0,1,-1,-1,1,2,1
KR_6702567876,420,-2,-13,-12,0,4,5,1,3,3,0,-3,2,5,-1,4,5,-3,0,3,0,2,3,-2,4,2,-2,0,1,-1,1,1,-1,1,1
KR_6658324815,420,2,66,15,3,1,3,2,-2,1,3,4,6,2,0,0,0,0,0,0,2,5,2,-1,6,5,-5,0,0,1,-1,0,1,6,1
KR_6614899926,420,5,68,13,9,8,8,0,1,1,0,6,6,0,-4,1,5,-2,1,3,0,-3,-133,0,3,3,-5,0,1,-1,1,1,1,6,1
KR_6615663599,420,-3,-12,-4,0,-2,0,2,-1,3,4,-3,0,3,5,5,0,1,1,0,0,4,0,0,5,5,-2,0,0,0,1,1,1,0,1
KR_6605916708,420,-1,-57,-17,1,2,6,4,1,7,6,-1,0,1,0,3,3,-1,0,1,-1,5,3,-2,7,5,6,0,2,1,1,1,-1,2,1
KR_6608202320,420,2,16,-4,2,3,3,0,-2,3,5,1,2,1,-3,1,4,3,3,0,0,1,109,2,3,5,-1,0,0,1,1,1,1,4,1
KR_6630200385,420,4,33,27,4,2,4,2,0,4,4,1,4,3,1,4,3,0,0,0,0,-1,-3,3,4,7,1,0,1,1,1,1,1,6,1
KR_6621550723,420,0,71,16,3,0,0,0,0,3,3,0,1,1,7,8,1,-4,0,4,0,5,-33,-5,8,3,3,0,1,1,1,1,1,1,1
KR_6738476891,440,0,-54,17,-2,-1,2,3,3,6,3,-2,0,2,-2,1,3,0,0,0,0,-2,2,5,1,6,-3,0,-2,-1,1,-1,1,4,1
KR_6621725232,420,1,52,-16,2,2,3,1,-3,4,7,-4,0,4,7,7,0,0,1,1,0,2,-20,-4,5,1,-2,0,-1,1,-1,-1,-1,3,1
KR_6603984114,420,3,46,23,-1,3,3,0,-2,1,3,1,2,1,-1,2,3,-2,0,2,0,-3,16,-2,5,3,-1,0,0,0,-1,0,-1,0,1
KR_6750313090,420,-1,-8,-16,-6,-1,1,2,2,3,1,-1,1,2,-4,2,6,-2,0,2,0,0,-8,-1,7,6,-3,0,0,-1,-1,0,-1,5,1
KR_6715424889,420,0,14,-4,-2,1,3,2,-4,2,6,1,1,0,4,7,3,-4,0,4,-1,-7,5,3,4,7,-1,0,-1,1,-1,-1,-1,3,1
KR_6676049010,420,3,61,19,3,-1,2,3,-4,3,7,6,7,1,2,3,1,0,1,1,0,5,11,-2,7,5,-2,0,0,-1,-1,1,1,3,1
KR_6727247088,440,-1,38,-20,-4,-3,0,3,1,3,2,-1,2,3,0,1,1,-1,2,3,0,-5,6,-2,7,5,1,0,0,-1,-1,-1,-1,3,1
KR_6745093223,420,-1,-15,29,-7,-1,3,4,0,2,2,1,1,0,-5,0,5,-2,0,2,0,-7,-12,-3,8,5,-5,0,0,-1,1,0,1,3,1
KR_6749208024,440,2,24,16,1,2,4,2,-1,0,1,0,3,3,-1,2,3,1,2,1,0,-6,-1,2,2,4,3,0,0,1,1,0,-1,6,1
KR_6591556996,420,0,0,24,1,-1,2,3,0,3,3,-1,1,2,2,3,1,1,1,0,0,-2,4,-6,11,5,1,0,1,-1,1,-1,1,1,1
KR_6755983564,420,2,32,-4,3,0,1,1,0,1,1,-1,2,3,0,1,1,4,4,0,0,1,3,-4,9,5,2,0,1,1,1,1,1,2,1
KR_6702627598,420,4,62,9,10,6,7,1,1,2,1,1,3,2,1,3,2,1,1,0,0,5,10,3,4,7,0,0,1,1,1,1,1,4,1
KR_6655122885,420,4,106,22,17,6,8,2,6,8,2,0,0,0,5,6,1,0,0,0,0,6,-37,-4,5,1,2,0,2,1,1,1,-1,6,1
KR_6714307961,420,3,14,16,4,1,1,0,-5,2,7,5,6,1,3,4,1,0,5,5,0,-2,6,4,2,6,-4,0,0,1,1,0,1,4,1
KR_6703224267,420,2,35,-6,4,2,2,0,-1,2,3,4,6,2,0,1,1,-1,1,2,1,1,1,1,5,6,4,0,1,1,1,1,1,5,1
KR_6718125010,440,1,-14,10,3,3,4,1,0,2,2,1,1,0,-1,3,4,0,0,0,0,1,231,1,1,2,-1,0,0,-1,1,0,-1,4,1
KR_6709453303,420,2,20,-16,4,0,0,0,2,4,2,-2,0,2,5,6,1,-1,0,1,0,1,-1,0,8,8,0,0,0,0,-1,0,-1,0,1
KR_6731757684,440,3,32,8,-1,-2,2,4,0,3,3,2,2,0,-2,2,4,1,2,1,0,-7,-8,-2,5,3,4,0,2,-1,-1,1,1,6,1
KR_6760819487,420,-1,-18,-24,-11,0,5,5,-4,1,5,-3,1,4,-1,5,6,-3,1,4,0,-5,18,-2,5,3,-1,0,0,1,1,0,-1,6,1
KR_6727724616,440,-4,-36,-28,-2,-1,0,1,-4,0,4,-2,2,4,1,1,0,4,5,1,0,0,6,2,3,5,-4,0,1,1,-1,1,1,4,1
KR_6743088354,420,0,27,0,-1,-1,2,3,0,3,3,-2,2,4,2,2,0,0,0,0,0,3,19,3,4,7,6,0,0,0,0,0,1,0,1
KR_6760558990,420,-1,2,36,0,-1,1,2,3,4,1,-1,2,3,0,2,2,-1,0,1,0,5,-63,0,3,3,2,0,0,0,0,0,-1,0,1
KR_6757986981,420,-2,-22,-30,5,4,4,0,2,2,0,-1,1,2,-2,2,4,2,3,1,0,4,-23,1,6,7,5,0,0,-1,-1,0,-1,1,1
KR_6602338579,420,0,19,-15,2,-3,0,3,0,3,3,4,6,2,6,7,1,-5,0,5,1,4,2,3,4,7,-4,0,1,1,1,1,1,4,1
KR_6696106561,420,-1,-32,20,-8,-3,0,3,-8,1,9,2,5,3,0,1,1,1,1,0,-1,-10,0,-2,5,3,-7,0,-1,1,-1,-1,-1,4,1
KR_6759432162,420,-3,-44,18,-4,-2,2,4,-4,1,5,4,4,0,-2,5,7,0,0,0,0,-4,-3,-5,8,3,-1,0,-1,-1,0,-1,-1,1,1
KR_6764136676,420,2,48,22,5,1,1,0,1,1,0,-1,2,3,3,4,1,1,1,0,0,2,-59,3,1,4,3,0,1,-1,0,1,1,6,1
KR_6751298230,440,0,3,-6,1,4,4,0,-2,0,2,2,2,0,0,0,0,-3,0,3,0,-2,0,-4,9,5,0,0,0,1,1,0,-1,3,1
KR_6748327785,420,-1,7,-20,-3,-2,1,3,2,5,3,-4,0,4,4,6,2,-3,1,4,-1,-11,-4,4,7,11,-4,0,0,-1,-1,0,-1,5,1
KR_6755299909,440,-2,-76,16,-7,0,1,1,-6,1,7,-2,1,3,0,2,2,1,3,2,-1,-9,-1,2,2,4,0,0,-1,-1,-1,-1,-1,6,1
KR_6633468502,420,1,15,-9,6,3,3,0,0,1,1,-1,5,6,7,10,3,-3,1,4,0,10,1,8,1,9,-4,0,1,1,0,1,1,4,1
KR_6683332907,420,0,-48,16,3,0,1,1,4,5,1,-4,1,5,2,2,0,1,1,0,0,5,-78,-1,4,3,25,0,0,-1,1,0,-1,3,1
KR_6719478031,420,3,28,20,8,2,2,0,-2,1,3,1,6,5,5,8,3,2,3,1,3,15,107,-6,9,3,4,0,2,1,1,1,1,1,1
KR_6714134519,420,3,57,24,6,3,3,0,2,6,4,1,4,3,-1,4,5,1,1,0,2,8,41,6,3,9,-7,0,1,1,1,1,1,6,1
KR_6736701969,420,1,26,8,1,0,0,0,1,5,4,3,3,0,-2,3,5,-1,3,4,0,-2,1,0,3,3,6,0,1,1,0,1,1,3,1
KR_6763061010,420,0,11,2,-2,5,5,0,-2,3,5,-5,0,5,-1,1,2,1,4,3,0,-2,111,5,1,6,0,0,1,1,1,1,-1,6,1
KR_6744785371,420,1,51,34,3,2,4,2,6,7,1,-5,0,5,3,5,2,-3,1,4,0,11,-6,2,1,3,3,0,1,1,1,1,1,4,1
KR_6471826618,420,4,70,17,9,6,6,0,1,2,1,1,2,1,1,3,2,0,1,1,-1,0,19,-1,6,5,6,0,1,0,1,1,-1,0,1
KR_6762629335,420,1,-19,-8,4,2,4,2,-3,1,4,4,6,2,0,6,6,1,2,1,1,8,5,-1,5,4,3,0,0,1,0,0,-1,3,1
KR_6722000591,420,2,-37,-12,3,2,3,1,2,6,4,-2,1,3,-3,3,6,4,5,1,-1,4,2,-1,4,3,2,0,1,-1,-1,1,-1,1,1
KR_6755216585,420,-4,10,-6,-12,-2,1,3,-5,1,6,-1,2,3,-4,0,4,0,1,1,0,-12,-11,0,3,3,-2,0,0,-1,1,0,1,6,1
KR_6692543982,420,-2,31,2,1,-2,0,2,-2,1,3,2,3,1,2,6,4,1,2,1,0,-3,-1,-1,7,6,3,0,1,-1,1,1,-1,2,1
KR_6726526860,420,4,53,-3,6,2,2,0,6,6,0,-2,0,2,4,4,0,-4,0,4,0,11,-8,0,5,5,0,0,-1,-1,1,1,-1,1,1
KR_6494260296,420,2,56,15,7,2,4,2,-1,1,2,-4,1,5,6,6,0,4,4,0,0,9,-188,0,4,4,2,0,0,-1,1,0,1,2,1
KR_6745780583,420,4,87,5,6,1,2,1,3,4,1,0,3,3,4,5,1,-2,0,2,0,2,0,1,4,5,3,0,2,1,1,1,1,1,1
KR_6731816735,440,-7,-62,-70,-17,-4,0,4,-4,3,7,-5,4,9,-2,3,5,-2,0,2,0,-27,-44,-1,3,2,17,0,-1,1,-1,-1,-1,3,1
KR_6764170353,420,5,37,0,11,1,3,2,6,6,0,3,6,3,2,3,1,-1,0,1,0,2,-8,-4,7,3,7,0,2,-1,1,1,1,6,1
KR_6760628589,420,2,52,19,6,-2,0,2,2,3,1,2,3,1,1,3,2,3,5,2,0,12,-2,-1,5,4,7,0,2,1,1,1,1,2,1
KR_6753624345,420,-3,14,15,-7,2,2,0,-1,0,1,-5,0,5,-1,2,3,-2,0,2,0,-13,-1,3,1,4,-2,0,0,1,1,0,-1,4,1
KR_6675058492,420,1,-46,16,5,1,2,1,5,7,2,1,4,3,-3,2,5,1,2,1,-1,10,0,-4,7,3,8,0,-2,-1,-1,-1,-1,1,1
KR_6626921111,420,4,82,16,10,3,3,0,0,5,5,3,3,0,3,5,2,1,4,3,0,-3,-40,-3,6,3,20,0,1,1,-1,1,-1,3,1
KR_6712840688,420,3,30,6,3,-1,0,1,0,3,3,-1,2,3,4,6,2,1,2,1,0,4,7,-1,4,3,1,0,2,1,1,1,-1,6,1
KR_6751762140,420,0,18,-8,0,-2,0,2,0,0,0,4,6,2,-1,1,2,-1,1,2,0,1,5,4,1,5,-3,0,1,-1,1,1,1,4,1
KR_6760982962,420,1,17,12,1,0,3,3,3,4,1,-3,0,3,1,2,1,0,0,0,0,2,-28,-1,4,3,4,0,2,1,-1,1,1,1,1
KR_6664376787,420,3,83,22,10,4,4,0,-2,1,3,1,2,1,7,8,1,0,1,1,0,10,-5,-4,9,5,1,0,1,1,-1,1,-1,1,1
KR_6633391364,420,5,59,44,9,4,5,1,-1,3,4,-3,3,6,8,8,0,1,1,0,2,7,4,-1,4,3,5,0,3,1,-1,1,1,5,1
KR_6686678237,420,4,-18,36,7,1,1,0,1,5,4,2,3,1,2,5,3,1,1,0,0,8,-12,1,6,7,-1,0,0,1,-1,0,1,2,1
KR_6761052905,420,0,3,24,3,1,2,1,-1,3,4,2,4,2,-3,1,4,4,4,0,-2,-2,8,-1,6,5,0,0,0,1,1,0,-1,6,1
KR_6645235406,420,-2,24,0,-8,-3,1,4,-8,2,10,1,4,3,5,5,0,-3,0,3,0,-9,-5,-4,8,4,-3,0,0,1,1,0,-1,2,1
KR_6545524206,420,4,47,20,18,2,4,2,3,4,1,6,7,1,5,8,3,2,2,0,0,26,6,0,6,6,8,0,3,1,1,1,-1,4,1
KR_6752877748,440,1,31,-11,5,7,7,0,-2,2,4,-5,1,6,8,9,1,-3,2,5,1,0,6,2,2,4,-1,0,0,-1,1,1,1,4,1
KR_6760431229,440,1,-21,-8,9,-2,1,3,2,2,0,4,5,1,1,5,4,4,6,2,1,8,1,6,3,9,0,0,0,1,0,0,1,5,1
KR_6755424831,420,0,62,15,-1,3,4,1,-2,2,4,1,2,1,-4,1,5,1,2,1,0,-4,14,3,1,4,-2,0,0,1,1,1,1,1,1
KR_6709266823,420,4,19,-8,5,0,2,2,1,1,0,1,1,0,1,5,4,2,3,1,0,6,-2,-5,8,3,2,0,1,-1,1,1,-1,5,1
KR_6754384410,420,-1,21,36,-5,-3,0,3,-1,7,8,-2,2,4,-1,2,3,2,2,0,0,0,-98,0,6,6,-3,0,0,1,0,0,1,4,1
KR_6762526967,440,1,16,-11,0,-1,2,3,1,1,0,0,2,2,0,0,0,0,1,1,0,-6,2,0,5,5,-1,0,1,1,0,1,-1,3,1
KR_6762109983,420,2,-32,20,6,0,1,1,9,10,1,9,10,1,-11,1,12,-1,3,4,-1,1,342,1,4,5,0,0,0,1,1,-1,-1,4,1
KR_6658923392,420,0,21,-26,6,1,1,0,2,6,4,4,7,3,-1,1,2,0,1,1,1,8,-5,0,7,7,6,0,1,1,1,1,1,5,1
KR_6626832027,420,2,31,-8,4,0,0,0,-3,0,3,-2,2,4,7,8,1,2,2,0,0,4,-37,4,3,7,22,0,0,1,-1,0,1,6,1
KR_6746346486,420,1,17,-12,5,-1,0,1,-3,1,4,0,3,3,11,12,1,-2,0,2,0,5,14,-2,5,3,-1,0,2,1,-1,1,1,2,1
KR_6657423280,420,0,-13,-5,2,1,3,2,-2,3,5,-3,2,5,4,4,0,2,2,0,0,6,4,5,4,9,4,0,1,1,1,1,-1,1,1
KR_6758828371,420,2,-4,20,-6,-1,2,3,-3,3,6,1,2,1,-3,2,5,0,1,1,0,-6,-16,-2,6,4,-1,0,-1,-1,-1,-1,-1,1,1
KR_6675271749,420,2,71,-12,5,6,6,0,-1,1,2,0,3,3,0,1,1,0,0,0,0,0,3,1,4,5,-1,0,1,1,1,1,-1,2,1
KR_6645563140,420,0,15,12,1,1,3,2,4,7,3,-1,0,1,-1,0,1,-2,0,2,0,-1,0,-3,4,1,-1,0,-1,1,0,-1,-1,3,1
KR_6734576744,420,2,7,24,12,5,5,0,8,12,4,3,4,1,-3,1,4,-1,0,1,0,10,5,-1,5,4,-1,0,2,1,1,1,1,4,1
KR_6727669128,420,6,46,1,11,1,1,0,0,3,3,6,6,0,3,5,2,1,1,0,0,11,1,-2,5,3,2,0,2,-1,1,1,1,4,1
KR_6763361129,420,4,47,32,4,1,4,3,2,2,0,0,1,1,3,4,1,-2,0,2,0,6,-260,-7,9,2,6,0,-1,1,0,-1,-1,6,1
KR_6746346198,420,4,43,-22,13,-2,0,2,2,2,0,5,5,0,7,7,0,1,1,0,0,13,4,-1,8,7,4,0,0,-1,-1,1,1,4,1
KR_6747661722,420,1,-55,5,2,1,1,0,1,3,2,-1,2,3,2,3,1,-1,0,1,1,5,-6,-1,4,3,8,0,0,-1,0,0,1,1,1
KR_6745035401,420,-2,-26,18,-2,0,1,1,3,4,1,-2,2,4,-3,3,6,0,2,2,1,2,-3,-2,3,1,-3,0,-1,-1,0,-1,1,6,1
KR_6604889216,420,-2,-85,-9,-2,-1,2,3,-1,2,3,-2,1,3,3,4,1,-1,0,1,0,2,-8,0,7,7,2,0,0,-1,1,0,-1,5,1
KR_6670069684,420,0,18,21,5,-2,1,3,0,4,4,1,1,0,6,6,0,0,0,0,0,11,29,2,3,5,-3,0,0,1,1,1,1,6,1
KR_6732578016,420,2,17,44,11,2,3,1,5,6,1,1,2,1,3,3,0,0,0,0,0,7,-3,3,1,4,-1,0,1,1,1,1,1,3,1
KR_6660347930,440,3,-6,21,4,-6,1,7,3,5,2,2,3,1,5,6,1,0,0,0,0,0,4,-1,3,2,0,0,2,-1,1,1,-1,2,1
KR_6761435215,420,2,3,8,4,5,5,0,0,1,1,1,2,1,-2,5,7,0,1,1,0,8,-17,-3,5,2,-1,0,-1,-1,-1,-1,-1,2,1
KR_6722685384,420,5,67,-6,13,-2,2,4,8,9,1,2,6,4,2,2,0,3,3,0,0,18,16,6,0,6,-2,0,0,1,-1,1,-1,5,1
KR_6760610491,440,1,-29,-9,5,1,2,1,3,3,0,-5,0,5,4,7,3,2,3,1,1,15,-315,-5,6,1,3,0,1,1,-1,1,1,5,1
KR_6667724109,440,1,-8,17,7,3,5,2,-1,2,3,1,3,2,1,1,0,3,4,1,0,8,9,4,4,8,2,0,-1,1,-1,-1,1,1,1
KR_6667662576,420,2,116,-15,3,2,4,2,3,6,3,2,4,2,-2,0,2,-2,0,2,0,1,9,5,4,9,-1,0,1,1,1,1,-1,3,1
KR_6761955202,420,3,88,6,2,1,1,0,0,1,1,3,3,0,0,0,0,-2,2,4,0,3,7,-3,5,2,1,0,0,-1,1,0,1,2,1
KR_6668728359,420,-3,-4,-19,-2,-3,1,4,1,4,3,0,2,2,0,3,3,0,3,3,-1,-4,-4,-5,9,4,1,0,0,-1,-1,0,-1,1,1
KR_6632707595,420,0,1,-8,1,1,2,1,1,3,2,0,2,2,-1,5,6,0,0,0,0,7,21,3,5,8,-1,0,0,1,-1,0,1,1,1
KR_6216388659,420,1,25,8,2,-3,0,3,0,2,2,7,8,1,-1,0,1,-1,0,1,0,4,-10,-2,4,2,-6,0,1,1,1,1,1,4,1
KR_6758040227,420,0,60,15,0,-1,1,2,1,5,4,-2,0,2,1,2,1,1,1,0,0,5,8,-1,5,4,-5,0,1,1,1,1,-1,1,1
KR_6676453627,420,3,80,-6,-2,6,7,1,-3,2,5,0,0,0,-5,1,6,0,1,1,1,-14,11,-7,9,2,2,0,2,-1,0,1,1,4,1
KR_6724364097,420,1,22,-5,2,3,5,2,-1,1,2,-1,0,1,0,2,2,1,1,0,-1,1,5,5,3,8,-2,0,1,-1,-1,1,-1,2,1
KR_6715753248,420,6,120,18,16,5,5,0,1,1,0,5,6,1,6,7,1,-1,1,2,1,10,-19,-5,8,3,7,0,3,0,1,1,1,0,1
KR_6743324879,420,3,33,-4,6,-1,2,3,4,5,1,-1,2,3,5,7,2,-1,2,3,0,12,-49,-6,10,4,24,0,0,-1,1,-1,-1,1,1
KR_6761974268,420,-1,-10,-12,-3,-4,1,5,0,1,1,-3,1,4,4,6,2,0,0,0,0,2,-1,0,3,3,-2,0,0,-1,-1,-1,-1,1,1
KR_6703679237,440,1,-9,36,0,1,4,3,-7,0,7,8,8,0,1,3,2,-3,3,6,-1,-4,0,2,4,6,1,0,-1,1,-1,-1,-1,2,1
KR_6531342145,420,0,24,16,1,1,1,0,-3,1,4,0,2,2,1,5,4,2,2,0,1,-3,195,4,2,6,-3,0,1,1,-1,1,1,2,1
KR_6736442549,420,1,13,7,1,0,4,4,0,2,2,-1,0,1,0,2,2,2,3,1,0,2,64,2,2,4,-19,0,1,1,1,1,1,4,1
KR_6693484352,420,-2,11,-49,-2,0,1,1,8,9,1,-2,1,3,-2,1,3,-6,0,6,0,9,131,-3,6,3,8,0,-1,-1,-1,-1,-1,5,1
KR_6705554228,420,0,25,-31,-2,4,4,0,-3,0,3,-3,1,4,0,2,2,0,0,0,0,0,2,1,3,4,-1,0,-1,1,-1,-1,-1,5,1
KR_6621647226,420,6,18,8,14,0,3,3,5,6,1,3,4,1,5,6,1,1,1,0,0,11,-1,0,6,6,4,0,-1,1,-1,-1,-1,3,1
KR_6716661313,420,4,76,3,8,1,2,1,1,1,0,5,5,0,1,1,0,0,1,1,0,7,18,2,1,3,2,0,0,1,-1,0,1,1,1
KR_6760871582,420,1,54,-1,6,2,3,1,-2,3,5,3,4,1,3,7,4,0,2,2,0,6,-18,2,2,4,-4,0,0,1,-1,0,-1,6,1
KR_6629777851,420,1,12,4,3,3,3,0,-2,1,3,5,6,1,-3,4,7,0,2,2,-1,-6,-1,3,2,5,2,0,0,1,0,-1,-1,1,1
KR_6762436764,420,5,53,22,10,6,6,0,3,4,1,-1,2,3,4,5,1,-2,1,3,0,8,313,0,7,7,-1,0,1,1,-1,1,-1,6,1
KR_6506486095,420,2,26,8,5,-1,0,1,-1,5,6,0,2,2,4,7,3,3,4,1,0,3,-99,1,4,5,1,0,0,-1,-1,1,1,1,1
KR_6146651780,420,3,9,32,6,1,2,1,-3,1,4,6,7,1,3,4,1,-1,0,1,0,14,-12,6,2,8,2,0,1,1,1,1,-1,2,1
KR_6761723800,420,0,-28,4,9,6,7,1,-1,2,3,2,5,3,2,7,5,0,2,2,3,20,6,5,1,6,0,0,0,1,1,0,1,2,1
KR_6763753610,420,7,26,-7,7,0,1,1,3,4,1,2,6,4,3,5,2,-1,0,1,0,3,303,-2,3,1,-3,0,1,-1,1,1,1,6,1
KR_6633314891,420,7,140,40,12,3,5,2,4,7,3,1,2,1,3,4,1,1,2,1,-1,10,6,1,3,4,3,0,0,1,-1,1,-1,5,1
KR_6756768705,420,3,62,-20,5,5,5,0,2,2,0,-4,1,5,0,2,2,2,3,1,0,4,7,3,1,4,-1,0,1,1,-1,1,-1,6,1
KR_6592895165,420,2,79,40,1,1,1,0,3,6,3,1,3,2,-4,1,5,0,1,1,0,2,-5,3,2,5,3,0,0,-1,-1,-1,-1,3,1
KR_6670121341,420,7,65,9,11,2,4,2,6,6,0,2,4,2,0,1,1,1,2,1,1,5,2,-3,8,5,1,0,2,1,-1,1,1,6,1
KR_6762546707,420,-2,-53,32,-7,-2,0,2,-1,5,6,1,3,2,-4,1,5,-1,0,1,0,-7,-5,-5,11,6,3,0,-1,-1,1,-1,1,5,1
KR_6725282869,420,-2,34,-36,-5,-4,0,4,2,3,1,-5,2,7,1,3,2,1,1,0,0,4,-28,2,3,5,-3,0,-1,1,-1,-1,-1,5,1
KR_6728545643,420,6,93,15,14,-1,2,3,10,10,0,3,5,2,2,4,2,0,1,1,0,18,-8,-1,8,7,8,0,3,1,0,1,1,2,1
KR_6737869239,440,0,-41,-16,6,-2,0,2,3,5,2,-2,0,2,5,5,0,2,2,0,0,5,-8,-1,4,3,4,0,-1,-1,-1,-1,1,2,1
KR_6733638721,420,0,83,-14,1,-1,2,3,-3,1,4,1,1,0,4,5,1,0,2,2,0,7,1,2,4,6,3,0,1,-1,1,1,1,6,1
KR_6752092372,420,0,-2,20,-3,1,3,2,-2,1,3,1,6,5,-3,1,4,0,1,1,0,-9,-16,0,3,3,2,0,0,-1,1,1,-1,1,1
KR_6753900098,420,3,-35,-9,5,2,4,2,9,9,0,-4,1,5,-3,0,3,1,1,0,0,0,8,-2,6,4,-2,0,-1,-1,-1,-1,-1,3,1
KR_6748193143,420,3,-16,24,6,2,4,2,3,3,0,1,2,1,-2,0,2,2,3,1,0,5,-1,-1,5,4,-3,0,0,0,1,-1,1,0,1
KR_6760645656,420,2,-6,-27,8,2,2,0,1,2,1,-4,0,4,9,9,0,0,2,2,0,16,-8,0,4,4,0,0,1,1,1,1,1,3,1
KR_6682937656,420,-1,-7,-16,2,-4,3,7,1,5,4,5,6,1,-4,1,5,4,4,0,0,-10,-1,-6,9,3,-3,0,0,-1,-1,0,-1,2,1
KR_6679799642,420,1,-36,-1,1,-1,3,4,-1,2,3,0,4,4,3,3,0,0,0,0,0,-1,-11,0,4,4,2,0,0,1,1,0,-1,3,1
KR_6723063385,420,4,56,19,11,4,4,0,3,6,3,4,5,1,0,3,3,0,0,0,0,11,-63,2,1,3,27,0,1,1,1,1,1,2,1
KR_6745885002,420,1,-18,-8,0,-1,1,2,0,2,2,0,4,4,2,3,1,-1,0,1,0,10,-13,0,6,6,-2,0,0,1,1,0,-1,5,1
KR_6719660904,420,0,1,22,7,3,3,0,-4,2,6,2,3,1,7,8,1,-1,0,1,1,9,-4,3,3,6,0,0,0,1,1,1,1,3,1
KR_6612836191,420,4,32,-22,14,6,6,0,1,4,3,2,3,1,5,5,0,0,2,2,2,14,1,1,3,4,1,0,1,1,0,1,1,5,1
KR_6759410871,420,0,54,-19,1,7,7,0,-3,2,5,2,3,1,-3,2,5,-2,1,3,1,-5,-7,3,5,8,4,0,2,-1,1,1,1,1,1
KR_6673102305,420,3,52,6,4,-2,0,2,1,4,3,2,3,1,2,5,3,1,2,1,0,4,18,7,0,7,-4,0,1,0,0,1,1,0,1
KR_6745928686,420,-2,62,-21,-5,1,2,1,-1,2,3,1,1,0,-6,2,8,0,0,0,-1,-2,-1,0,4,4,-2,0,0,1,-1,-1,-1,6,1
KR_6758331910,420,-4,-97,-44,-4,-7,3,10,3,4,1,1,5,4,0,0,0,-1,0,1,0,0,4,4,5,9,-3,0,-1,0,0,-1,-1,0,1
KR_6761285588,420,5,97,4,8,1,2,1,2,2,0,3,4,1,1,2,1,1,1,0,-1,8,10,3,2,5,1,0,2,1,1,1,-1,4,1
KR_6724107931,420,-1,-13,-6,-1,3,3,0,-2,0,2,-2,1,3,0,2,2,0,1,1,0,-1,107,-1,3,2,0,0,0,-1,-1,-1,-1,2,1
KR_6750139057,420,2,23,8,9,0,1,1,3,3,0,1,2,1,1,4,3,4,4,0,0,11,20,6,2,8,5,0,-1,0,0,1,1,0,1
KR_6759937894,440,-4,33,-61,-3,-1,3,4,-1,3,4,-2,2,4,2,2,0,-1,1,2,-1,-5,-133,0,2,2,-3,0,-1,-1,-1,-1,-1,6,1
KR_6762854509,420,3,81,-11,9,4,4,0,2,4,2,-1,2,3,0,1,1,4,5,1,0,2,5,0,6,6,0,0,1,1,1,1,1,6,1
KR_6745419355,420,0,-16,-4,3,-1,0,1,3,5,2,-1,1,2,5,7,2,-3,0,3,0,6,22,4,1,5,2,0,0,0,1,-1,1,0,1
KR_6657912135,420,1,7,-8,3,2,2,0,-1,3,4,2,3,1,-1,2,3,1,2,1,1,2,-18,-2,6,4,7,0,0,-1,-1,-1,1,1,1
KR_6612880473,420,4,61,8,6,0,1,1,-3,1,4,0,1,1,5,5,0,4,4,0,0,9,1,2,5,7,-2,0,0,1,1,1,1,5,1
KR_6708220663,420,2,58,40,1,4,4,0,0,2,2,-2,2,4,-1,2,3,0,2,2,0,-7,12,1,2,3,-3,0,2,-1,-1,1,1,1,1
KR_6593643634,420,5,-24,28,16,4,5,1,1,5,4,1,2,1,7,8,1,3,5,2,0,17,-235,6,3,9,1,0,0,1,1,1,-1,6,1
KR_6749520698,420,1,55,31,2,2,4,2,-4,0,4,6,6,0,-1,1,2,-1,0,1,0,-7,4,-1,7,6,-1,0,1,-1,1,1,1,5,1
KR_6736487102,420,3,9,-3,0,-3,1,4,3,4,1,2,4,2,3,3,0,-5,0,5,-1,4,23,-1,4,3,2,0,-1,-1,-1,1,-1,4,1
KR_6731012570,420,1,39,-14,5,-5,1,6,2,4,2,4,6,2,4,5,1,0,0,0,0,15,-5,4,3,7,5,0,1,1,1,1,1,1,1
KR_6568620829,420,2,76,3,5,0,2,2,-3,0,3,4,7,3,5,5,0,-1,0,1,0,1,-64,-4,7,3,4,0,2,1,1,1,1,5,1
KR_6629226980,420,5,62,-28,15,6,7,1,2,3,1,0,2,2,5,7,2,2,3,1,1,22,5,4,2,6,7,0,3,1,1,1,1,6,1
KR_6761296861,420,3,11,12,12,-1,0,1,4,6,2,8,8,0,2,3,1,-1,3,4,1,11,3,6,4,10,1,0,3,1,1,1,1,4,1
KR_6546391218,420,4,25,22,1,2,4,2,6,7,1,0,2,2,-6,1,7,-1,0,1,0,3,1,3,5,8,3,0,0,0,1,1,1,0,1
KR_6763285423,420,0,-7,-16,-5,-2,1,3,-3,1,4,1,1,0,-3,2,5,2,2,0,0,-5,-145,-1,6,5,-1,0,1,-1,1,1,1,4,1
KR_6730197796,420,-5,-73,-12,-8,2,4,2,1,3,2,-3,1,4,-5,0,5,-3,0,3,0,-9,90,1,3,4,0,0,0,1,-1,1,-1,2,1
KR_6738732493,420,-1,-11,9,5,-1,1,2,1,3,2,3,5,2,2,6,4,0,1,1,0,5,10,4,1,5,-2,0,1,-1,1,1,1,5,1
KR_6660552702,420,5,22,-3,12,1,1,0,4,5,1,-3,0,3,10,10,0,0,2,2,1,15,-132,-1,2,1,2,1,4,1,1,1,1,3,1
KR_6761060403,420,2,16,11,9,1,3,2,2,4,2,6,6,0,3,4,1,-3,1,4,1,15,-4,0,4,4,2,0,-1,-1,-1,-1,1,4,1
KR_6497303589,440,0,-79,-3,-4,-1,3,4,-4,1,5,-1,0,1,0,1,1,2,3,1,-1,-2,-38,2,2,4,14,0,-2,0,-1,-1,-1,0,1
KR_6691851930,440,2,47,24,3,3,6,3,-3,1,4,4,5,1,-3,0,3,2,2,0,0,2,-23,-2,4,2,1,0,2,-1,0,1,1,6,1
KR_6691805864,440,5,-42,38,13,-1,1,2,2,2,0,5,7,2,1,1,0,6,7,1,0,22,2,1,2,3,-1,0,0,-1,1,1,-1,1,1
KR_6745278300,420,3,-18,36,2,4,4,0,2,3,1,-2,1,3,-1,2,3,-1,0,1,0,-3,-21,5,4,9,-3,0,0,1,1,0,-1,1,1
KR_6719851150,420,-3,1,11,-4,1,5,4,0,4,4,-1,1,2,-4,0,4,0,1,1,0,-7,-2,-1,5,4,-5,0,0,-1,1,0,1,4,1
KR_6716486878,420,6,143,0,-1,-2,0,2,1,3,2,-4,1,5,2,3,1,2,2,0,0,-1,12,0,1,1,-1,1,8,1,1,1,-1,5,1
KR_6761239372,420,4,12,48,4,-2,1,3,1,1,0,3,3,0,1,1,0,1,1,0,0,4,7,-2,4,2,2,0,0,-1,1,-1,1,3,1
KR_6421487373,420,11,102,11,20,3,3,0,5,6,1,6,7,1,4,4,0,2,3,1,1,18,-2,1,2,3,4,1,7,0,1,1,1,0,1
KR_6698389418,420,1,72,-24,3,2,2,0,0,1,1,1,2,1,2,3,1,-2,0,2,0,4,-27,3,3,6,4,0,0,-1,-1,0,1,6,1
KR_6660154430,440,-1,39,18,-9,-1,1,2,4,6,2,-3,3,6,-6,2,8,-3,0,3,0,-15,1,2,6,8,0,0,2,0,1,1,1,0,1
KR_6694280080,420,2,28,43,-2,1,2,1,-1,0,1,1,3,2,-3,1,4,0,2,2,0,-4,-2,-1,7,6,0,0,-1,1,1,-1,-1,2,1
KR_6760127889,420,3,42,20,6,3,3,0,7,7,0,-3,2,5,0,3,3,-1,0,1,0,5,2,-1,5,4,7,0,0,1,0,1,1,4,1
KR_6646464296,440,-2,-23,8,-11,0,0,0,-4,0,4,-5,0,5,-1,3,4,-1,2,3,0,-6,-5,0,4,4,0,0,-1,1,-1,-1,-1,1,1
KR_6569792192,420,7,70,20,16,2,4,2,1,3,2,9,11,2,2,2,0,2,2,0,0,6,-2,-5,10,5,4,0,1,-1,-1,1,1,6,1
KR_6756550130,420,3,79,-4,13,3,5,2,-1,2,3,5,5,0,3,4,1,3,3,0,0,10,252,1,5,6,2,0,1,-1,1,1,-1,1,1
KR_6735350240,420,4,25,17,10,1,3,2,-4,1,5,3,5,2,8,8,0,2,2,0,-1,8,20,3,4,7,0,0,0,1,1,0,-1,2,1
KR_6762646426,420,3,6,-23,2,1,2,1,-1,2,3,3,4,1,3,4,1,-4,0,4,0,1,-13,0,6,6,5,0,0,-1,-1,0,1,4,1
KR_6730531364,420,-1,-13,-8,5,-1,1,2,3,5,2,1,1,0,1,3,2,1,1,0,0,8,6,2,5,7,3,0,0,1,1,0,-1,3,1
KR_6764126261,420,3,-12,27,7,-1,3,4,5,7,2,3,5,2,-1,2,3,1,1,0,0,7,-209,4,3,7,3,0,1,1,-1,-1,1,1,1
KR_6738876430,420,1,-43,32,5,-1,2,3,2,6,4,1,2,1,1,5,4,2,2,0,2,14,-13,-3,7,4,2,0,0,-1,1,-1,1,4,1
KR_6731086995,420,1,70,-9,-1,-2,3,5,1,6,5,0,2,2,1,4,3,-1,1,2,0,-5,1,2,2,4,-2,0,-1,-1,1,-1,1,5,1
KR_6755060872,420,0,-70,16,3,0,1,1,0,4,4,2,4,2,1,4,3,0,0,0,1,7,2,3,2,5,1,0,-1,1,-1,-1,1,3,1
KR_6735465606,420,3,30,36,11,2,3,1,4,4,0,5,6,1,0,1,1,0,2,2,0,7,114,2,2,4,0,0,2,1,1,1,1,5,1
KR_6754264025,420,1,14,23,2,3,5,2,2,3,1,-1,0,1,0,1,1,-2,1,3,0,1,31,3,4,7,-2,0,0,-1,1,-1,-1,4,1
KR_6706247356,420,0,-43,27,6,-5,0,5,0,1,1,5,7,2,7,8,1,-1,1,2,0,11,16,3,3,6,0,0,0,1,1,1,1,4,1
KR_6753341764,420,-4,-20,40,-4,1,3,2,-5,1,6,-5,0,5,4,6,2,1,1,0,0,-6,5,5,4,9,-3,0,1,0,-1,1,1,0,1
KR_6318908427,420,3,30,35,5,-2,2,4,4,7,3,-1,1,2,2,3,1,2,4,2,0,12,6,0,3,3,2,0,1,1,-1,1,1,1,1
KR_6627485870,420,2,-10,5,4,-2,0,2,4,6,2,-4,1,5,6,6,0,0,0,0,0,2,1,4,3,7,0,0,0,1,-1,0,-1,6,1
KR_6758281120,420,3,88,0,10,0,0,0,4,5,1,-3,2,5,8,8,0,1,1,0,0,14,-14,5,0,5,-3,0,3,-1,1,1,1,5,1
KR_6761850918,420,3,39,12,4,2,2,0,-2,2,4,4,4,0,0,2,2,0,3,3,0,6,-402,0,4,4,-2,0,0,-1,1,0,-1,4,1
KR_6730857313,440,-2,-36,20,-2,-2,0,2,-1,6,7,-1,2,3,1,5,4,1,3,2,3,3,-4,-1,4,3,2,0,-1,-1,0,-1,1,4,1
KR_6608686197,420,0,42,11,1,-1,0,1,2,4,2,0,2,2,4,4,0,-4,2,6,0,5,-4,-5,9,4,4,0,1,-1,-1,1,1,6,1
KR_6705728586,420,6,72,12,11,2,2,0,0,3,3,3,5,2,5,5,0,1,3,2,2,16,186,-1,6,5,2,0,1,1,1,1,1,4,1
KR_6752588076,420,7,79,-16,19,7,7,0,0,1,1,7,7,0,4,5,1,1,1,0,0,10,10,3,2,5,-4,0,0,1,1,1,1,6,1
KR_6686420349,420,-3,24,-14,-2,0,3,3,3,4,1,0,3,3,-4,1,5,-1,0,1,-1,-5,-7,0,4,4,3,0,1,-1,-1,1,-1,4,1
KR_6573119064,420,0,70,-1,4,-1,1,2,1,4,3,2,5,3,7,8,1,-5,1,6,0,12,22,0,2,2,-3,0,1,1,1,1,1,1,1
KR_6761875077,420,4,79,26,4,2,3,1,-1,4,5,4,8,4,1,4,3,-2,0,2,0,-2,-1,-1,2,1,-1,0,1,1,1,1,-1,2,1
KR_6610187466,420,2,30,5,2,5,5,0,3,5,2,-6,0,6,0,1,1,0,0,0,0,0,-10,-1,5,4,2,0,0,-1,1,0,1,6,1
KR_6764749112,420,2,-24,-16,4,0,1,1,1,2,1,3,5,2,1,2,1,-1,0,1,0,8,2,3,5,8,-2,0,-1,1,-1,-1,-1,4,1
KR_6647692880,420,0,10,-13,1,1,1,0,1,1,0,0,0,0,0,2,2,-1,0,1,0,-1,116,1,5,6,4,0,1,1,1,1,1,6,1
KR_6606351330,420,7,53,40,14,2,2,0,5,7,2,2,4,2,0,3,3,5,6,1,1,18,45,2,4,6,-23,0,2,1,1,1,1,5,1
KR_6697061885,420,5,49,36,11,1,2,1,3,5,2,5,5,0,2,4,2,0,1,1,1,13,2,-5,7,2,0,0,1,1,0,1,1,1,1
KR_6716447441,420,2,-41,13,4,1,4,3,-1,0,1,1,3,2,0,3,3,3,4,1,0,6,-6,-4,7,3,-1,0,-1,1,0,-1,-1,2,1
KR_6760816720,420,0,-13,-20,14,1,2,1,2,3,1,6,7,1,6,8,2,-1,0,1,0,14,6,4,3,7,1,0,0,-1,0,1,1,5,1
KR_6756355600,420,1,-40,12,-1,1,1,0,6,7,1,0,4,4,-6,3,9,-2,2,4,-2,0,6,4,2,6,-1,0,1,0,0,1,-1,0,1
KR_6583930195,420,4,105,21,15,4,5,1,4,5,1,-3,0,3,9,9,0,1,1,0,0,11,19,4,2,6,1,0,3,1,1,1,1,2,1
KR_6732204850,420,-2,-46,31,-3,-1,1,2,0,2,2,-2,1,3,-1,2,3,1,2,1,-1,-3,37,-2,7,5,-30,0,0,1,-1,0,-1,4,1
KR_6687492620,420,0,-7,-20,2,1,2,1,0,2,2,-1,1,2,1,3,2,1,2,1,0,7,17,-2,9,7,-4,0,0,1,-1,1,1,6,1
KR_6712327810,420,4,9,3,10,1,3,2,1,3,2,9,10,1,0,3,3,-1,1,2,0,15,23,4,2,6,-1,0,1,-1,1,1,1,3,1
KR_6761378491,420,-2,-5,-31,4,3,5,2,-1,0,1,0,1,1,2,3,1,0,0,0,1,7,61,-2,4,2,-4,0,0,0,1,0,1,0,1
KR_6660230258,420,1,72,-17,7,0,1,1,-2,2,4,6,6,0,2,3,1,1,1,0,0,11,2,1,1,2,-1,0,3,1,1,1,1,4,1
KR_6717910560,420,3,4,8,8,-3,1,4,1,3,2,10,10,0,-1,4,5,1,2,1,0,17,10,1,5,6,2,0,0,1,-1,-1,-1,6,1
KR_6667812062,420,-1,-78,12,0,0,2,2,0,3,3,0,1,1,-2,1,3,2,2,0,0,2,13,2,2,4,-1,0,1,1,-1,1,-1,6,1
KR_6760425546,420,3,12,12,8,0,1,1,1,3,2,3,4,1,3,3,0,1,1,0,0,3,2,-2,6,4,0,0,-1,1,-1,-1,1,4,1
KR_6758992055,420,2,32,6,8,-4,1,5,-5,1,6,14,14,0,4,5,1,-1,0,1,1,0,8,3,4,7,1,0,1,1,-1,1,1,2,1
KR_6749528514,440,3,43,8,9,1,3,2,2,2,0,-1,1,2,9,9,0,-2,0,2,0,7,-6,-2,5,3,6,0,0,0,1,0,1,0,1
KR_6670114572,420,4,4,32,5,2,3,1,-1,2,3,0,1,1,3,6,3,1,1,0,-1,0,11,2,4,6,-2,0,1,1,-1,1,-1,3,1
KR_6660097401,440,2,87,-2,6,2,2,0,-5,0,5,1,2,1,7,9,2,1,1,0,0,8,10,4,0,4,-2,0,0,-1,0,1,1,1,1
KR_6753507770,420,7,92,42,10,2,3,1,4,6,2,-2,0,2,5,5,0,1,1,0,-1,11,-158,-2,7,5,3,0,4,1,1,1,-1,1,1
KR_6706184035,420,4,64,-5,3,1,4,3,-4,0,4,-2,1,3,0,2,2,8,8,0,0,3,2,0,4,4,-1,0,0,-1,1,1,1,5,1
KR_6717156927,420,1,37,0,7,-2,1,3,-2,1,3,4,9,5,3,6,3,4,5,1,0,13,-73,-2,5,3,5,0,2,-1,1,1,-1,1,1
KR_6730459048,440,-1,-1,7,-2,-4,0,4,-4,1,5,-1,2,3,5,5,0,2,3,1,0,7,-8,2,4,6,2,0,-2,1,-1,-1,-1,1,1
KR_6698126349,420,1,1,19,3,-3,1,4,2,4,2,-3,0,3,5,5,0,2,2,0,0,8,5,-5,9,4,3,0,0,-1,1,-1,-1,3,1
KR_6718928357,420,3,10,-21,10,2,4,2,2,4,2,-2,0,2,4,5,1,4,4,0,0,2,-97,6,2,8,3,0,-1,1,1,-1,1,5,1
KR_6639264280,440,6,107,45,13,1,3,2,-1,1,2,5,5,0,8,9,1,0,0,0,0,13,-200,4,1,5,1,0,2,1,1,1,1,1,1
KR_6726687008,420,1,13,-24,4,4,4,0,0,2,2,1,2,1,0,2,2,-1,1,2,0,-5,22,-2,6,4,-2,0,1,1,1,1,1,2,1
KR_6729236763,420,2,67,-11,3,2,2,0,1,5,4,-5,2,7,5,6,1,0,2,2,1,7,30,7,1,8,1,0,1,-1,-1,1,1,1,1
KR_6676991787,420,1,-34,20,4,1,4,3,3,6,3,-2,3,5,0,1,1,2,2,0,0,4,-32,2,4,6,5,0,0,1,1,1,1,3,1
KR_6761213537,420,3,20,-4,5,1,2,1,0,2,2,0,3,3,-1,6,7,5,6,1,0,11,-4,-2,6,4,-1,0,2,0,-1,1,1,0,1
KR_6675269948,420,6,-3,15,9,1,1,0,2,2,0,2,3,1,3,3,0,1,1,0,0,7,0,3,1,4,3,0,2,-1,1,1,1,1,1
KR_6671233856,420,0,-32,-16,4,-3,0,3,2,3,1,1,2,1,4,5,1,0,1,1,0,7,13,0,6,6,3,0,0,1,-1,-1,-1,4,1
KR_6678458342,420,2,57,-4,-1,-1,1,2,0,2,2,1,4,3,-3,1,4,2,3,1,0,-5,104,3,2,5,2,0,-1,-1,-1,-1,1,1,1
KR_6688935126,420,0,49,-8,-4,1,2,1,-1,1,2,0,1,1,-2,2,4,-2,0,2,0,-7,39,6,3,9,-15,0,0,-1,1,0,-1,5,1
KR_6709785863,420,3,29,32,5,1,1,0,-4,3,7,6,6,0,1,2,1,1,2,1,1,11,55,6,3,9,-15,0,1,1,1,1,1,3,1
KR_6082587627,420,-2,-75,-1,-2,-3,0,3,2,3,1,-8,1,9,3,4,1,4,4,0,0,10,10,1,2,3,-1,0,1,-1,1,1,-1,1,1
KR_6649776491,420,1,10,29,8,-2,1,3,-1,0,1,0,0,0,11,13,2,0,2,2,1,13,-35,1,3,4,19,0,0,1,1,1,1,1,1
KR_6728957569,420,-4,-54,-16,-5,-1,0,1,-3,4,7,2,3,1,-1,2,3,-2,0,2,0,-13,-29,-1,3,2,-2,0,0,-1,0,0,-1,4,1
KR_6629138609,420,3,25,28,2,2,3,1,3,3,0,0,4,4,-2,2,4,-1,1,2,-1,5,2,1,5,6,-3,0,1,0,1,1,-1,0,1
KR_6764111024,420,3,-39,23,2,-1,0,1,3,7,4,1,3,2,0,1,1,-1,0,1,0,-1,-4,-3,7,4,-5,0,0,1,-1,0,-1,1,1
KR_6759052600,420,2,99,7,3,-2,2,4,2,4,2,-3,2,5,3,5,2,3,4,1,0,8,5,1,2,3,2,0,0,1,0,0,-1,2,1
KR_6662897768,420,0,16,36,1,2,6,4,0,2,2,-3,1,4,4,5,1,-2,0,2,0,-2,10,5,6,11,3,0,-2,-1,-1,1,1,1,1
KR_6748547888,420,2,31,32,4,0,1,1,-6,1,7,-1,1,2,7,9,2,4,4,0,0,3,176,3,1,4,0,0,1,1,1,1,1,1,1
KR_6758329626,420,1,77,-8,2,5,6,1,-2,1,3,2,4,2,0,1,1,-3,1,4,1,-2,9,2,4,6,2,0,1,1,1,1,1,6,1
KR_6759118725,420,3,7,8,5,5,7,2,1,2,1,-2,3,5,0,3,3,1,2,1,0,-3,-11,-1,5,4,0,0,1,1,1,1,1,5,1
KR_6712899356,420,0,27,-36,2,0,0,0,-2,2,4,-1,1,2,7,10,3,-2,1,3,1,10,-1,2,4,6,-3,0,1,-1,1,1,1,4,1
KR_6589064414,420,8,60,16,16,4,5,1,3,6,3,2,3,1,7,7,0,0,0,0,0,13,-79,0,3,3,15,0,2,1,1,1,-1,1,1
KR_6686157864,420,1,0,21,6,1,1,0,-3,2,5,2,3,1,2,4,2,4,4,0,0,7,-38,-1,4,3,4,0,1,0,1,1,-1,0,1
KR_6686562096,420,1,4,-20,-1,-1,1,2,4,8,4,2,2,0,-5,0,5,-1,1,2,0,-2,14,3,4,7,-6,0,0,-1,1,0,-1,6,1
KR_6579363563,420,-3,4,-39,-3,-2,0,2,2,4,2,-1,2,3,0,3,3,-2,2,4,0,-1,7,-2,6,4,3,0,1,1,0,1,1,5,1
KR_6707499052,420,3,75,8,3,0,2,2,2,5,3,1,3,2,-2,1,3,2,5,3,0,-1,-89,0,5,5,6,0,0,1,-1,-1,1,3,1
KR_6658217056,420,4,66,1,10,-3,1,4,-3,1,4,7,7,0,3,4,1,6,7,1,1,9,8,4,3,7,-3,0,2,1,1,1,1,6,1
KR_6750986535,440,3,70,13,5,2,3,1,4,5,1,2,2,0,-2,3,5,-1,0,1,0,1,12,2,7,9,1,0,1,1,1,1,-1,4,1
KR_6539648445,420,2,50,17,6,1,4,3,4,9,5,-1,0,1,2,3,1,0,2,2,0,5,216,-3,9,6,0,0,0,-1,1,0,-1,3,1
KR_6750676740,420,-2,-33,-12,-2,-2,1,3,-4,2,6,3,6,3,0,3,3,1,1,0,1,4,9,0,8,8,-5,0,0,1,1,1,1,5,1
KR_6764322663,420,2,102,4,12,-1,1,2,4,8,4,-5,0,5,9,15,6,5,5,0,2,15,10,2,3,5,1,0,3,-1,1,1,1,4,1
KR_6723861696,420,0,19,-42,5,-2,4,6,1,3,2,7,7,0,-4,0,4,3,3,0,0,1,-14,0,4,4,1,0,1,-1,-1,1,1,2,1
KR_6713453379,420,5,44,6,17,1,3,2,4,8,4,4,5,1,2,4,2,6,6,0,3,13,8,-2,4,2,5,0,2,1,-1,1,-1,5,1
KR_6740430297,420,1,21,-8,8,-2,1,3,2,4,2,7,7,0,1,3,2,0,0,0,0,3,-1,1,2,3,1,0,1,1,1,1,-1,3,1
KR_6728936597,420,3,26,4,6,1,2,1,9,9,0,1,3,2,-6,0,6,1,1,0,0,6,0,2,4,6,1,0,0,1,1,1,1,4,1
KR_6733088572,420,1,8,30,-7,-1,0,1,-6,2,8,0,2,2,1,3,2,-1,1,2,0,-5,-1,2,6,8,1,0,0,1,1,0,1,6,1
KR_6751708743,420,0,50,12,1,1,1,0,0,3,3,2,4,2,-1,3,4,-1,1,2,0,1,-41,-1,6,5,21,0,1,-1,-1,1,1,4,1
KR_6762888647,420,1,28,3,4,0,3,3,0,4,4,1,2,1,3,4,1,0,0,0,0,2,-1,1,3,4,5,0,0,1,-1,0,1,2,1
KR_6668991318,420,-1,-23,-7,-5,-2,1,3,2,5,3,-3,0,3,-2,5,7,0,1,1,0,-8,-344,-3,8,5,6,0,-2,1,0,-1,1,3,1
KR_6303878680,420,2,0,-4,7,-4,1,5,6,10,4,3,4,1,1,2,1,1,1,0,0,4,-17,-9,13,4,4,0,0,-1,1,1,1,4,1
KR_6627088600,420,1,27,-4,2,0,4,4,1,4,3,-3,0,3,4,4,0,0,3,3,0,10,3,0,5,5,2,0,2,-1,-1,-1,1,1,1
KR_6757741651,420,2,-11,49,2,-1,0,1,5,6,1,-2,1,3,0,3,3,0,1,1,0,1,18,5,1,6,-4,0,0,1,1,0,-1,3,1
KR_6683570067,420,2,63,24,6,2,2,0,1,2,1,0,0,0,2,4,2,1,1,0,0,5,-172,3,1,4,-2,0,1,-1,1,1,1,3,1
KR_6717196387,420,2,10,16,7,5,5,0,1,4,3,4,5,1,1,2,1,-4,0,4,0,15,8,0,6,6,-2,0,0,1,-1,-1,1,4,1
KR_6733198856,420,5,33,16,11,0,1,1,1,1,0,8,8,0,2,3,1,0,0,0,0,11,3,0,3,3,-1,0,1,1,1,1,-1,3,1
KR_6434617029,420,1,-30,-12,-2,3,4,1,2,6,4,0,1,1,-6,0,6,-1,0,1,0,-7,-5,-6,9,3,-5,0,-1,-1,1,1,-1,6,1
KR_6699531332,420,0,77,-12,5,7,7,0,4,5,1,-2,0,2,-4,2,6,0,3,3,0,3,-8,2,2,4,9,0,0,1,1,1,-1,4,1
KR_6651823546,420,-1,-34,-3,3,1,2,1,0,3,3,2,2,0,-1,3,4,1,3,2,2,7,1,-3,6,3,-4,0,1,-1,-1,1,1,6,1
KR_6667401339,420,2,109,28,11,-1,2,3,0,3,3,7,7,0,6,8,2,-1,0,1,0,7,1,1,4,5,-2,0,1,1,1,1,1,1,1
KR_6660128895,420,3,34,24,7,4,4,0,1,4,3,1,1,0,2,4,2,-1,0,1,0,3,-3,1,5,6,1,0,0,-1,1,0,1,6,1
KR_6764515896,420,1,33,-4,10,6,6,0,3,4,1,1,4,3,0,2,2,0,0,0,0,12,6,2,4,6,-1,0,2,1,1,1,1,2,1
KR_6740470595,420,0,41,-4,2,2,4,2,2,3,1,-1,2,3,1,2,1,-2,1,3,-1,-7,3,5,4,9,-2,0,0,1,-1,0,-1,1,1
KR_6762792467,420,1,-33,4,2,2,3,1,2,3,1,0,1,1,-2,4,6,0,0,0,0,1,-11,5,4,9,-1,0,0,-1,1,1,-1,6,1
KR_6742016211,420,2,83,18,3,1,2,1,0,1,1,-5,4,9,5,5,0,2,2,0,0,3,10,2,4,6,2,0,2,1,1,1,1,6,1
KR_6741908838,440,4,80,42,13,2,2,0,3,3,0,11,12,1,-5,0,5,2,3,1,0,6,-1,-7,10,3,6,0,1,1,1,1,1,1,1
KR_6723920860,420,1,-19,8,12,-2,0,2,2,5,3,1,1,0,11,13,2,0,1,1,0,14,6,4,3,7,0,0,0,1,-1,-1,1,2,1
KR_6759752876,420,3,28,19,4,1,1,0,2,2,0,-1,2,3,2,5,3,0,1,1,0,8,1,0,6,6,3,0,0,1,-1,0,1,2,1
KR_6739027411,420,0,-13,36,4,1,4,3,2,2,0,1,4,3,0,2,2,0,1,1,0,2,-269,-3,7,4,-2,0,-1,1,1,-1,1,4,1
KR_6698962243,420,3,29,25,3,4,4,0,-1,1,2,1,4,3,1,1,0,-2,0,2,0,4,0,1,7,8,4,0,2,1,1,1,-1,3,1
KR_6716132330,440,1,20,16,4,-2,1,3,2,5,3,1,4,3,3,3,0,0,0,0,0,8,5,4,1,5,2,0,0,1,-1,0,1,3,1
KR_6747136462,420,2,87,-2,2,5,5,0,-4,0,4,4,7,3,-3,1,4,0,0,0,0,1,-4,-1,5,4,-1,0,1,-1,1,1,1,6,1
KR_6709976798,420,-2,-20,12,-2,-2,2,4,-3,1,4,0,1,1,1,3,2,2,2,0,0,1,2,-1,7,6,-2,0,-1,1,-1,-1,-1,4,1
KR_6728650209,440,3,31,8,4,-3,1,4,4,5,1,3,3,0,2,6,4,-2,0,2,0,-7,338,-1,2,1,-4,0,1,1,1,1,-1,3,1
KR_6764011585,420,1,5,16,4,-1,1,2,2,3,1,3,4,1,0,2,2,0,2,2,0,4,-46,0,3,3,25,0,0,0,1,-1,-1,0,1
KR_6643484531,420,-1,-13,-32,1,-2,1,3,1,3,2,6,6,0,-1,0,1,-3,0,3,0,7,-5,1,4,5,2,0,1,-1,1,1,-1,1,1
KR_6760460015,440,-1,-36,8,2,-3,3,6,8,8,0,-1,1,2,-4,4,8,2,3,1,0,7,1,0,5,5,-1,0,1,-1,1,1,-1,3,1
KR_6676323980,420,1,14,11,4,1,1,0,0,3,3,2,2,0,1,5,4,0,1,1,0,4,-7,-3,5,2,4,0,1,-1,1,1,1,3,1
KR_6538084860,420,3,-8,20,5,0,1,1,1,4,3,0,2,2,5,5,0,-1,1,2,-1,1,-5,2,7,9,2,0,0,1,-1,0,-1,1,1
KR_6761535326,420,0,-49,-56,5,-3,1,4,1,2,1,1,2,1,4,6,2,2,2,0,0,8,7,6,1,7,2,0,2,0,-1,1,-1,0,1
KR_6714172709,440,1,-49,0,10,1,1,0,2,5,3,6,6,0,0,2,2,1,1,0,0,13,11,-1,4,3,-3,0,0,0,1,1,1,0,1
KR_6666047710,420,1,32,8,9,1,3,2,3,5,2,-1,2,3,2,6,4,4,4,0,2,8,-4,-6,11,5,1,0,0,1,1,0,1,2,1
KR_6764524201,420,3,48,18,7,2,3,1,2,2,0,3,3,0,1,2,1,-1,0,1,0,6,323,2,3,5,19,0,-2,1,1,-1,1,5,1
KR_6736610695,420,6,147,6,13,8,8,0,-2,1,3,4,4,0,2,5,3,1,1,0,0,-1,4,1,2,3,0,0,1,0,1,1,1,0,1
KR_6644739557,440,3,65,27,5,3,5,2,3,11,8,0,1,1,-1,3,4,0,2,2,0,1,5,2,3,5,-2,0,1,-1,0,1,-1,5,1
KR_6763002643,420,1,-5,-16,7,4,4,0,2,3,1,2,3,1,3,5,2,-4,0,4,0,8,-4,1,4,5,0,0,0,-1,1,0,1,5,1
KR_6764449447,440,1,-7,-20,-1,-2,1,3,-4,0,4,3,3,0,3,6,3,-1,1,2,0,2,-3,-5,6,1,3,0,1,0,-1,1,-1,0,1
KR_6730131922,420,-5,-35,-36,-3,1,1,0,-1,0,1,-1,4,5,-1,0,1,-1,0,1,0,1,8,0,5,5,-4,0,0,-1,1,-1,1,1,1
KR_6591695836,420,3,41,-4,3,0,1,1,-2,1,3,2,3,1,2,2,0,1,1,0,0,4,2,0,6,6,4,0,1,0,1,1,1,0,1
KR_6724207427,420,1,-5,-40,2,-3,1,4,1,4,3,2,3,1,3,3,0,-1,0,1,0,8,-2,1,3,4,3,0,1,1,-1,-1,-1,2,1
KR_6028363355,420,2,-17,-11,8,1,2,1,4,5,1,0,2,2,2,3,1,1,1,0,0,8,0,5,4,9,2,0,-1,1,-1,-1,-1,2,1
KR_6617798961,420,-2,-63,4,2,-1,1,2,2,5,3,-2,1,3,1,4,3,2,2,0,0,1,29,3,4,7,2,0,0,-1,1,-1,1,5,1
KR_6755724052,440,0,-110,77,-6,-2,1,3,-2,1,3,-4,2,6,-3,1,4,5,6,1,0,-9,12,3,4,7,-7,0,-1,0,1,-1,-1,0,1
KR_6654326928,420,0,-24,-7,-4,-4,2,6,-1,0,1,0,2,2,-2,1,3,3,3,0,0,-3,-42,3,5,8,25,0,0,0,1,0,1,0,1
KR_6752368847,420,2,-34,-2,3,3,6,3,0,5,5,-1,0,1,1,3,2,0,2,2,0,9,-8,0,5,5,4,0,0,1,-1,0,-1,3,1
KR_6758254848,420,0,-9,-11,3,-2,1,3,-3,0,3,4,4,0,4,6,2,0,1,1,0,3,-16,-2,6,4,-3,0,0,1,-1,0,-1,4,1
KR_6760780289,420,2,37,-16,9,1,3,2,-2,0,2,5,6,1,3,5,2,2,3,1,0,7,24,6,0,6,4,0,0,1,1,1,1,6,1
KR_6763305192,420,2,33,12,7,0,0,0,3,4,1,1,3,2,3,5,2,0,1,1,-1,1,7,2,3,5,-1,0,1,1,1,1,-1,5,1
KR_6744073757,420,-1,29,29,-2,-1,0,1,2,5,3,0,2,2,-1,4,5,-2,0,2,0,0,32,6,4,10,-2,0,0,1,-1,0,1,6,1
KR_6740508732,420,1,41,-35,1,2,4,2,-4,1,5,4,6,2,2,4,2,-3,3,6,0,3,-23,2,3,5,-3,0,0,1,0,-1,1,1,1
KR_6698045302,420,-2,-14,-40,-8,0,1,1,-1,4,5,0,2,2,-6,3,9,-1,1,2,-2,-16,1,-3,9,6,-3,0,0,1,-1,0,-1,1,1
KR_6676001666,420,4,54,13,6,-1,1,2,0,3,3,9,11,2,-3,2,5,1,1,0,0,-2,-5,-1,4,3,-2,0,2,-1,1,1,1,3,1
KR_6348449546,420,3,72,12,5,6,6,0,-2,0,2,-1,0,1,1,3,2,1,2,1,0,2,-2,0,7,7,5,0,1,1,-1,1,-1,2,1
KR_6709402038,420,0,-11,24,5,-2,2,4,0,1,1,0,0,0,8,9,1,-1,1,2,0,13,-4,0,3,3,1,0,0,1,-1,0,1,6,1
KR_6760319226,440,1,8,-15,10,5,6,1,6,9,3,0,2,2,0,2,2,-1,0,1,-1,8,-190,0,4,4,1,0,1,1,1,1,-1,2,1
KR_6750331621,440,-2,-92,20,2,-4,0,4,-1,1,2,2,3,1,4,6,2,1,1,0,-1,7,-24,1,3,4,2,0,-1,1,-1,-1,-1,5,1
KR_6641377819,420,0,44,-12,5,1,1,0,-2,2,4,1,4,3,7,7,0,-2,0,2,0,4,2,-1,4,3,4,0,2,-1,1,1,1,1,1
KR_6679844229,420,1,78,13,6,2,2,0,2,2,0,0,2,2,2,2,0,0,2,2,1,4,-6,4,5,9,6,0,2,1,1,1,1,5,1
KR_6678604146,420,2,59,3,8,7,7,0,0,3,3,1,2,1,0,3,3,0,1,1,0,9,8,6,2,8,-3,0,2,1,1,1,1,1,1
KR_6754436451,420,4,4,36,4,2,3,1,7,8,1,-6,0,6,-1,0,1,2,2,0,0,7,-223,1,0,1,-1,0,1,1,1,1,1,2,1
KR_6546992753,420,0,-37,16,8,-1,3,4,2,4,2,1,2,1,6,8,2,0,0,0,0,9,21,-1,9,8,3,0,-1,1,1,-1,1,1,1
KR_6624006665,420,-2,-9,-4,-7,-8,0,8,1,3,2,3,5,2,-1,3,4,-2,1,3,0,-7,-3,2,3,5,-2,0,1,1,1,1,-1,1,1
KR_6741937025,420,1,8,2,0,-1,2,3,-1,2,3,3,3,0,0,2,2,-1,0,1,0,0,-22,-1,5,4,1,0,1,1,1,1,1,3,1
KR_6726449140,420,0,24,23,-6,3,4,1,-1,3,4,-7,0,7,0,4,4,-1,0,1,0,-3,-50,0,4,4,23,0,-2,-1,-1,-1,-1,3,1
KR_6764055474,420,-2,-47,-12,-3,4,4,0,1,1,0,1,4,3,-8,0,8,-1,0,1,0,-7,-1,-4,5,1,3,0,-1,1,-1,-1,-1,5,1
KR_6761067896,440,0,-35,8,5,-5,0,5,3,3,0,2,4,2,6,8,2,-1,1,2,0,10,4,2,3,5,2,0,-1,1,-1,-1,-1,2,1
KR_6668183765,420,5,26,-7,7,-3,2,5,-1,1,2,6,10,4,4,4,0,1,4,3,0,9,-231,0,6,6,-2,0,2,1,1,1,1,5,1
KR_6644681470,420,4,93,-8,9,0,1,1,3,3,0,3,3,0,6,7,1,-3,0,3,0,10,-1,3,3,6,-1,0,1,1,1,1,1,5,1
KR_6723635476,420,3,8,56,5,1,3,2,5,7,2,1,3,2,1,1,0,-3,1,4,0,4,-1,-2,4,2,2,0,1,1,1,1,-1,4,1
KR_6732618772,420,1,39,18,2,1,2,1,2,8,6,-1,1,2,0,0,0,0,0,0,-1,0,-36,-4,5,1,23,0,1,1,-1,1,-1,4,1
KR_6672100140,420,2,38,40,2,-1,0,1,-3,3,6,0,2,2,5,6,1,1,1,0,0,-2,-7,-3,9,6,-1,0,0,0,-1,0,1,0,1
KR_6645511584,420,5,34,16,10,4,4,0,-2,1,3,-1,0,1,5,6,1,4,4,0,0,8,5,1,3,4,1,0,2,1,1,1,1,4,1
KR_6345142364,420,-2,5,-29,-2,0,2,2,1,3,2,-3,0,3,-2,2,4,2,2,0,0,0,-13,-4,7,3,2,0,0,0,1,0,1,0,1
KR_6762916737,420,0,-3,4,-1,-1,3,4,1,2,1,0,3,3,0,0,0,-1,1,2,1,8,4,0,2,2,5,0,0,-1,-1,0,1,3,1
KR_6759104946,420,2,-1,16,6,-2,0,2,2,2,0,2,4,2,2,3,1,2,5,3,0,8,-1,-1,2,1,-3,0,0,-1,1,1,1,3,1
KR_6697897367,420,5,38,-13,4,1,5,4,4,4,0,-3,0,3,3,5,2,-1,1,2,0,-2,1,1,5,6,4,0,2,-1,1,1,-1,5,1
KR_6763075219,440,5,82,36,16,9,10,1,8,10,2,2,4,2,0,1,1,-3,1,4,1,15,-4,-3,4,1,3,0,3,1,1,1,1,1,1
KR_6703229609,420,4,30,21,4,4,4,0,-4,1,5,2,4,2,2,4,2,0,3,3,0,6,-18,-1,3,2,2,0,-1,1,1,-1,1,3,1
KR_6756538379,420,1,77,31,7,1,1,0,4,5,1,-4,2,6,2,4,2,4,4,0,2,10,15,3,6,9,4,0,-1,1,-1,-1,1,5,1
KR_6714377283,420,2,57,-16,5,-1,2,3,3,6,3,-2,3,5,7,7,0,-2,0,2,-2,5,-2,3,2,5,3,0,0,1,0,1,-1,6,1
KR_6696191288,420,2,54,17,7,2,2,0,1,5,4,0,1,1,0,2,2,4,4,0,0,4,2,-1,4,3,5,0,1,1,1,1,1,5,1
KR_6662685145,420,3,2,51,-1,4,4,0,1,6,5,3,4,1,-9,5,14,0,4,4,1,3,112,2,1,3,2,0,1,1,1,1,1,5,1
KR_6740320624,440,3,17,16,5,3,5,2,4,8,4,-3,0,3,0,3,3,1,2,1,0,0,20,0,7,7,1,0,1,1,1,1,-1,4,1
KR_6725238853,420,1,26,-8,9,4,5,1,2,3,1,3,3,0,0,2,2,0,1,1,1,5,2,5,3,8,-3,0,0,-1,1,-1,1,1,1
KR_6556447305,420,-1,-18,-31,5,2,3,1,1,5,4,0,1,1,0,4,4,2,2,0,1,2,-112,1,6,7,4,0,1,-1,1,1,1,1,1
KR_6606024910,420,0,-21,6,3,-8,0,8,4,6,2,3,4,1,3,4,1,1,3,2,1,14,273,2,1,3,0,0,-1,1,-1,-1,1,1,1
KR_6758487457,420,2,23,-2,-1,-3,2,5,-1,1,2,2,3,1,-1,2,3,2,2,0,0,7,16,1,3,4,3,0,1,0,1,1,-1,0,1
KR_6714596242,420,6,121,-12,8,3,4,1,3,4,1,-2,4,6,3,4,1,1,2,1,-2,3,-8,2,1,3,-2,0,0,1,-1,-1,-1,5,1
KR_6764603304,440,6,105,11,16,0,1,1,8,9,1,4,5,1,5,9,4,-1,2,3,-3,7,3,3,3,6,2,0,2,0,1,1,-1,0,1
KR_6618327302,420,2,53,-4,11,3,5,2,5,10,5,3,5,2,0,2,2,0,1,1,0,11,15,5,2,7,-4,0,1,1,1,1,1,4,1
KR_6761359318,440,4,28,17,7,3,3,0,2,5,3,0,3,3,3,6,3,-1,2,3,0,6,10,5,3,8,-1,0,0,-1,1,1,1,6,1
KR_6604192744,420,-2,21,-8,0,3,4,1,0,1,1,-3,2,5,1,2,1,-1,0,1,0,2,-108,2,5,7,3,0,0,0,-1,-1,1,0,1
KR_6675525861,420,1,9,20,-3,2,4,2,-4,3,7,0,3,3,-1,0,1,0,1,1,0,-12,-7,-3,5,2,1,0,1,-1,1,1,-1,6,1
KR_6710167721,420,3,33,26,16,4,5,1,-1,4,5,3,3,0,7,10,3,3,3,0,2,19,2,-1,6,5,-1,0,1,0,1,1,1,0,1
KR_6201587829,420,-1,-5,8,4,0,2,2,0,0,0,-2,3,5,4,6,2,2,3,1,0,8,-1,4,2,6,-4,0,1,1,-1,1,1,5,1
KR_6761631612,420,1,-13,4,7,2,2,0,1,3,2,5,5,0,0,2,2,-1,1,2,0,8,6,3,4,7,-5,0,0,1,1,0,-1,5,1
KR_6743858158,420,1,36,12,2,0,1,1,2,4,2,0,3,3,2,2,0,-2,0,2,0,1,19,-6,6,0,38,0,-1,1,-1,-1,1,3,1
KR_6729105993,420,2,58,-24,5,-1,2,3,0,3,3,2,5,3,0,3,3,4,5,1,0,12,-1,1,5,6,0,0,0,1,-1,-1,1,4,1
KR_6691966299,420,0,1,-23,3,1,4,3,-4,0,4,0,2,2,9,11,2,-3,0,3,0,-7,8,-1,8,7,0,0,0,1,-1,0,1,2,1
KR_6751232259,440,-1,-37,-12,2,1,3,2,-2,4,6,3,4,1,1,3,2,-1,0,1,0,-4,-4,-1,6,5,-2,0,1,-1,1,1,1,5,1
KR_6761500035,420,2,14,-1,4,-2,2,4,-1,2,3,0,2,2,2,5,3,5,6,1,0,9,-6,-4,7,3,-2,0,0,-1,-1,0,1,2,1
KR_6697959308,420,4,82,4,9,5,5,0,5,5,0,1,2,1,-3,1,4,1,2,1,1,7,-120,4,7,11,4,0,0,1,1,1,1,6,1
KR_6112275974,420,1,22,-28,6,4,5,1,-1,3,4,1,3,2,2,2,0,0,0,0,1,6,-11,0,5,5,3,0,1,0,1,1,1,0,1
KR_6749491205,420,3,-10,-4,4,0,4,4,-4,1,5,3,3,0,2,4,2,3,4,1,0,5,6,0,5,5,-3,0,-1,-1,0,-1,-1,4,1
KR_6695475928,420,0,28,5,0,0,2,2,-2,4,6,3,4,1,-1,2,3,0,0,0,-1,1,-10,-5,6,1,0,0,-1,1,-1,-1,-1,4,1
KR_6625959899,420,2,54,20,5,-1,0,1,2,3,1,-1,3,4,3,5,2,2,3,1,0,10,15,0,5,5,0,0,3,1,1,1,-1,1,1
KR_6745599480,420,-1,-49,-8,1,-3,0,3,4,5,1,0,3,3,0,1,1,0,1,1,-1,5,86,1,4,5,1,0,1,-1,1,1,-1,2,1
KR_6757906649,440,2,30,4,6,0,6,6,6,7,1,3,4,1,1,1,0,-4,0,4,0,1,29,5,3,8,-5,0,0,1,-1,1,-1,5,1
KR_6658142308,420,0,37,44,-3,3,4,1,-5,1,6,1,2,1,1,3,2,-3,0,3,0,-8,-5,0,4,4,-1,0,0,1,1,1,1,3,1
KR_6535038431,440,4,16,0,7,-4,0,4,8,9,1,-1,2,3,1,1,0,3,4,1,0,1,0,4,3,7,0,0,1,0,1,1,1,0,1
KR_6758981805,420,0,-24,32,-6,-2,2,4,-2,2,4,0,4,4,-3,2,5,1,2,1,0,-4,6,2,3,5,-1,0,1,1,1,1,1,4,1
KR_6658619594,440,8,77,57,12,2,4,2,1,6,5,2,3,1,3,3,0,4,4,0,0,5,-62,0,7,7,5,0,3,1,1,1,1,3,1
KR_6734771555,440,2,60,-5,3,0,1,1,5,11,6,2,5,3,1,4,3,-5,1,6,0,-1,74,4,5,9,0,0,1,1,0,1,1,4,1
KR_6720219415,420,5,64,28,6,-2,1,3,6,7,1,2,2,0,0,1,1,0,0,0,0,5,-15,-3,8,5,4,0,0,1,1,0,-1,2,1
KR_6741292504,420,-1,43,-18,-3,-1,2,3,1,4,3,-4,1,5,1,3,2,0,0,0,0,-4,11,3,3,6,-3,0,-1,1,-1,-1,-1,2,1
KR_6579352185,420,1,-28,37,5,3,3,0,-1,4,5,1,1,0,-1,3,4,3,4,1,0,5,-4,2,4,6,1,0,-1,1,-1,-1,1,3,1
KR_6761068216,420,2,-11,39,5,-5,0,5,-1,1,2,3,5,2,4,4,0,4,6,2,0,1,4,3,4,7,3,0,0,1,-1,-1,1,1,1
KR_6694136815,420,2,-42,21,-3,-1,2,3,-3,4,7,0,5,5,1,1,0,0,0,0,-1,-2,-17,-7,10,3,5,0,0,-1,0,0,-1,5,1
KR_6729641741,420,4,40,0,7,3,4,1,3,6,3,-1,3,4,0,2,2,2,2,0,0,1,62,1,5,6,-13,0,1,1,1,1,1,5,1
KR_6760510333,420,-3,-15,0,0,-2,0,2,-3,0,3,1,2,1,2,3,1,2,4,2,0,7,-2,-4,6,2,-1,0,0,1,1,0,-1,5,1
KR_6413489414,420,2,7,4,10,0,1,1,6,7,1,0,1,1,6,6,0,-2,0,2,1,17,0,0,5,5,-3,0,0,-1,1,1,1,3,1
KR_6699976554,420,2,-67,0,6,1,2,1,1,5,4,0,3,3,1,4,3,3,4,1,0,4,20,-2,8,6,2,0,0,-1,1,1,1,3,1
KR_6618892658,420,2,92,8,6,0,0,0,5,5,0,1,2,1,3,6,3,-3,0,3,0,5,4,0,3,3,2,0,0,1,0,0,1,5,1
KR_6760939924,440,1,-43,-10,7,1,3,2,-1,1,2,0,0,0,4,5,1,3,6,3,0,6,-9,4,1,5,-1,0,1,-1,1,-1,-1,3,1
KR_6740840050,420,1,50,16,-2,0,3,3,-1,1,2,2,2,0,-1,0,1,-2,1,3,0,-4,-6,-1,3,2,-1,0,0,1,-1,0,-1,2,1
KR_6653834505,420,2,58,16,4,4,5,1,1,2,1,0,1,1,-1,2,3,0,1,1,0,-2,195,-3,5,2,26,0,0,1,1,1,-1,3,1
KR_6749541524,420,-2,-81,-9,-2,-3,1,4,2,3,1,-2,1,3,1,2,1,0,1,1,0,1,12,1,4,5,-4,0,0,1,1,-1,1,5,1
KR_6745807511,420,3,86,21,2,-1,2,3,2,5,3,0,1,1,0,3,3,1,2,1,1,-1,-10,-3,7,4,-1,0,0,1,1,1,1,3,1
KR_6720612392,420,0,16,-20,-2,2,4,2,-1,3,4,0,3,3,-3,0,3,0,0,0,0,-1,-27,5,1,6,-6,0,-1,1,-1,-1,-1,5,1
KR_6669931366,420,-1,8,-12,2,0,5,5,0,1,1,1,2,1,1,1,0,0,1,1,0,4,-4,-1,6,5,6,0,0,-1,-1,-1,1,3,1
KR_6592590078,420,4,112,48,8,-1,0,1,4,5,1,0,2,2,5,7,2,0,1,1,0,13,187,-2,6,4,-3,0,2,-1,-1,1,1,4,1
KR_6745198768,420,2,40,31,5,3,3,0,0,2,2,0,1,1,3,3,0,-1,0,1,0,4,-2,1,3,4,-2,0,1,1,-1,1,-1,6,1
KR_6634035108,420,3,-21,-8,3,0,4,4,2,2,0,1,1,0,0,1,1,0,1,1,1,4,8,-1,5,4,-1,0,1,-1,-1,1,1,6,1
KR_6692223526,420,2,-55,16,1,-1,0,1,0,1,1,-2,1,3,3,7,4,1,2,1,1,1,-3,-4,9,5,4,0,0,1,0,0,1,1,1
KR_6763940188,420,3,4,16,4,3,3,0,1,2,1,0,1,1,0,2,2,0,1,1,-1,-1,-4,-1,2,1,0,0,1,0,0,1,-1,0,1
KR_6761127601,420,3,14,7,7,0,1,1,3,6,3,4,4,0,0,2,2,0,0,0,0,18,-20,-2,5,3,8,0,1,1,1,1,-1,5,1
KR_6704441877,420,-2,14,16,-1,0,2,2,2,6,4,-1,2,3,-2,3,5,0,0,0,1,-3,1,2,4,6,0,0,-1,-1,1,-1,1,2,1
KR_6665356445,420,-1,6,-3,-2,-2,2,4,1,3,2,0,1,1,-2,3,5,1,2,1,0,-6,4,-1,3,2,-2,0,1,-1,1,1,1,3,1
KR_6016817322,420,0,30,-23,4,2,3,1,1,1,0,1,1,0,-1,3,4,1,1,0,0,1,3,3,6,9,0,0,0,-1,1,0,1,5,1
KR_6694422695,440,3,2,-6,1,-4,0,4,2,3,1,2,4,2,-2,1,3,3,3,0,0,3,-8,-3,8,5,2,0,0,1,-1,0,1,6,1
KR_6724490404,420,4,78,0,5,4,4,0,-1,2,3,-2,0,2,1,1,0,3,4,1,1,5,57,0,3,3,-20,0,1,-1,1,1,1,2,1
KR_6761930554,420,2,-34,4,8,6,6,0,1,2,1,-3,0,3,4,6,2,0,1,1,0,5,6,0,3,3,0,0,2,1,1,1,-1,3,1
KR_6679247392,440,3,33,4,10,0,1,1,2,5,3,5,5,0,4,4,0,-1,0,1,0,13,-8,5,2,7,4,0,0,0,1,0,1,0,1
KR_6741973788,420,0,-11,12,1,1,1,0,0,4,4,0,1,1,-1,0,1,1,1,0,-1,0,0,1,5,6,-6,0,-1,-1,-1,-1,-1,2,1
KR_6754607531,420,1,30,32,-2,4,4,0,0,3,3,0,2,2,-2,1,3,-4,0,4,0,-4,-2,0,5,5,4,0,2,-1,-1,1,1,2,1
KR_6677194242,420,2,21,16,7,-1,1,2,3,5,2,1,3,2,4,4,0,0,0,0,1,12,1,-2,8,6,7,0,3,-1,1,1,1,4,1
KR_6760893118,420,0,27,-8,1,0,1,1,0,2,2,-3,0,3,3,3,0,1,1,0,0,4,136,-2,4,2,2,0,2,1,1,1,1,5,1
KR_6739542327,440,7,8,28,11,0,1,1,-1,2,3,10,10,0,1,1,0,1,1,0,0,9,19,2,3,5,1,0,1,1,1,1,1,3,1
KR_6751179942,420,-1,44,8,1,3,3,0,0,2,2,3,4,1,-3,0,3,-2,1,3,0,-4,0,-5,7,2,1,0,0,-1,-1,0,-1,4,1
KR_6727124171,420,0,-10,9,1,4,4,0,1,3,2,-1,3,4,-3,2,5,0,2,2,0,-1,-24,-1,6,5,9,0,2,-1,-1,1,1,4,1
KR_6725512975,420,2,12,12,4,0,4,4,5,6,1,1,2,1,0,0,0,-2,0,2,0,4,30,4,1,5,-9,0,1,-1,1,1,1,2,1
KR_6453864762,420,5,90,4,11,2,4,2,3,6,3,4,4,0,2,3,1,0,0,0,0,11,3,1,4,5,3,0,0,-1,1,0,1,6,1
KR_6645294928,420,1,53,17,-3,0,1,1,-1,2,3,2,2,0,-3,0,3,-1,1,2,0,-4,20,-1,5,4,-2,0,-1,-1,1,-1,1,4,1
KR_6506151969,420,1,51,0,-3,0,0,0,0,2,2,2,2,0,-3,4,7,-2,2,4,-1,-7,-44,3,6,9,-1,0,0,1,1,-1,-1,5,1
KR_6762498414,420,3,18,1,4,-6,1,7,2,4,2,4,5,1,1,1,0,3,6,3,0,1,-12,-3,6,3,3,0,-1,-1,-1,-1,1,3,1
KR_6705512310,440,2,86,14,1,0,1,1,1,3,2,-1,2,3,1,4,3,0,1,1,1,1,1,-4,11,7,0,0,1,-1,1,1,1,6,1
KR_6728913129,420,-4,-28,-24,1,-4,3,7,3,3,0,2,3,1,-1,1,2,1,1,0,0,4,-2,-1,8,7,-2,0,-1,1,-1,-1,1,3,1
KR_6763588383,420,6,128,12,14,3,4,1,4,6,2,1,2,1,3,5,2,3,3,0,0,6,6,2,2,4,2,0,1,0,1,1,1,0,1
KR_6688252985,420,4,71,8,7,1,2,1,4,6,2,-1,1,2,3,3,0,0,1,1,1,10,-16,2,1,3,1,0,3,1,1,1,1,4,1
KR_6681045773,420,2,26,-28,4,-1,2,3,-3,1,4,7,7,0,2,2,0,-1,0,1,0,8,25,2,4,6,-3,0,2,1,1,1,-1,1,1
KR_6628898959,420,2,-62,26,5,2,3,1,-3,0,3,-2,2,4,6,6,0,2,4,2,0,12,126,2,3,5,-2,0,1,1,0,1,-1,3,1
KR_6762793186,420,1,-27,-9,5,-3,2,5,0,3,3,-1,1,2,8,11,3,1,1,0,0,11,4,4,5,9,1,0,0,1,0,0,-1,2,1
KR_6678473188,420,-2,12,-19,-5,3,3,0,0,2,2,-4,0,4,-2,0,2,-2,1,3,0,-8,-330,1,4,5,-5,0,-1,-1,-1,-1,-1,4,1
KR_5800308911,420,2,47,-15,13,-4,0,4,-3,1,4,8,8,0,11,13,2,1,2,1,1,7,15,2,5,7,-4,0,-1,1,-1,-1,1,2,1
KR_6734382890,420,1,26,-12,3,-2,1,3,-3,1,4,-2,0,2,10,10,0,0,1,1,0,9,6,-3,10,7,-1,0,0,-1,-1,-1,-1,6,1
KR_6755776630,420,3,87,-4,9,2,2,0,-4,1,5,-1,2,3,11,11,0,1,1,0,1,11,-35,2,8,10,26,0,1,1,-1,1,1,5,1
KR_6760654833,420,3,72,0,15,4,4,0,1,4,3,7,9,2,5,7,2,-2,0,2,2,15,4,5,1,6,2,0,2,1,1,1,1,4,1
KR_6661697372,420,3,18,4,8,0,2,2,1,3,2,4,5,1,-2,5,7,5,6,1,1,8,4,4,4,8,-2,0,1,1,1,1,1,4,1
KR_6737215186,420,2,16,-17,11,3,4,1,8,10,2,-3,1,4,2,2,0,1,1,0,2,22,-57,5,1,6,12,0,2,1,1,1,1,4,1
KR_6730222174,420,-2,-19,4,-4,0,2,2,-4,2,6,0,3,3,2,3,1,-2,0,2,0,-7,0,3,1,4,-4,0,-1,1,-1,-1,-1,6,1
KR_6721144025,420,2,45,12,2,-2,1,3,0,2,2,-2,2,4,-1,2,3,7,8,1,-3,-4,3,2,6,8,5,0,2,1,1,1,-1,3,1
KR_6763923201,420,1,-17,-20,2,1,2,1,-2,2,4,3,5,2,3,5,2,-3,0,3,0,5,-162,-5,8,3,3,0,1,1,1,1,1,4,1
KR_6738079142,420,0,57,13,3,3,3,0,-1,3,4,-1,0,1,0,2,2,2,2,0,1,-4,-242,6,4,10,-1,0,0,-1,-1,1,-1,1,1
KR_6680097959,420,-1,12,-12,-12,-1,3,4,-13,2,15,-1,2,3,-2,3,5,5,5,0,-1,-7,7,4,1,5,-2,0,0,-1,1,0,-1,2,1
KR_6737326996,420,0,-7,-25,1,0,1,1,0,2,2,0,3,3,-1,3,4,2,2,0,0,-2,1,3,2,5,4,0,0,1,-1,0,1,4,1
KR_6757118446,420,-1,38,10,1,3,3,0,-1,2,3,-2,1,3,-1,4,5,2,3,1,0,4,-3,2,3,5,-2,0,1,1,1,1,1,6,1
KR_6753537174,420,3,3,33,3,2,3,1,-3,1,4,3,3,0,1,2,1,0,0,0,0,-5,2,0,2,2,0,0,1,0,-1,1,1,0,1
KR_6745853286,420,-1,-24,-30,4,3,5,2,3,3,0,-2,0,2,0,2,2,0,2,2,0,11,-31,3,2,5,3,0,0,1,-1,-1,-1,2,1
KR_6757764456,420,1,54,2,4,-3,2,5,0,1,1,1,3,2,4,6,2,2,3,1,1,7,352,-2,3,1,1,0,1,0,-1,1,1,0,1
KR_6763213778,420,2,-29,12,6,0,2,2,1,4,3,3,4,1,-2,4,6,4,4,0,0,7,9,9,0,9,-4,0,1,-1,1,1,-1,3,1
KR_6738229591,420,-1,-38,-17,0,-1,0,1,2,5,3,2,2,0,-3,2,5,0,2,2,0,-1,-35,-4,6,2,18,0,0,1,-1,0,1,3,1
KR_6723463833,420,-2,-7,-3,-11,-2,1,3,2,5,3,-4,0,4,-3,1,4,-4,0,4,0,-11,-2,1,4,5,-1,0,-1,-1,1,1,-1,5,1
KR_6737321990,420,5,39,-20,15,2,2,0,4,4,0,7,7,0,-1,5,6,3,4,1,0,9,97,2,2,4,7,0,1,1,1,1,1,5,1
KR_6750156057,420,3,-2,-4,3,3,4,1,-1,0,1,-1,1,2,3,6,3,-1,1,2,3,4,-10,-2,5,3,-1,0,1,-1,1,1,1,2,1
KR_6755046425,420,1,-3,2,6,-4,2,6,6,8,2,4,4,0,1,3,2,-1,0,1,-1,-1,-3,-5,6,1,3,0,0,1,1,0,-1,1,1
KR_6741050541,440,3,66,4,5,1,2,1,-2,2,4,4,6,2,1,3,2,1,1,0,0,5,8,1,3,4,-1,0,2,1,1,1,1,2,1
KR_6690315042,420,-1,-23,-8,-3,0,4,4,-4,1,5,-5,1,6,5,6,1,1,2,1,0,3,10,2,3,5,-7,0,-1,-1,-1,-1,1,1,1
KR_6762716101,420,2,-10,-18,2,4,4,0,-2,0,2,-3,3,6,1,2,1,2,3,1,0,6,-8,3,3,6,4,0,1,1,-1,1,-1,4,1
KR_6757066171,420,-1,-61,-12,-3,-4,0,4,-3,2,5,2,4,2,1,3,2,1,1,0,0,-1,-14,3,2,5,-3,0,0,-1,0,0,-1,4,1
KR_6757148878,420,-1,8,-1,-2,-6,1,7,1,3,2,2,2,0,1,3,2,0,1,1,0,5,-8,-1,4,3,4,0,-2,-1,-1,-1,1,3,1
KR_6759222612,420,-2,-81,11,-7,1,2,1,4,5,1,-6,0,6,-2,1,3,-4,1,5,-1,-4,5,1,5,6,-4,0,0,1,1,-1,-1,4,1
KR_6737502748,420,4,17,9,8,3,5,2,2,3,1,2,8,6,-5,0,5,6,7,1,2,0,50,1,5,6,-7,0,-1,1,-1,-1,1,2,1
KR_6759805620,440,1,60,-20,1,4,4,0,-2,0,2,1,2,1,-1,0,1,-1,0,1,0,0,0,2,3,5,5,0,1,1,1,1,-1,2,1
KR_6759894174,420,4,91,1,4,3,3,0,0,5,5,1,4,3,-2,1,3,2,2,0,0,-1,-8,-3,7,4,1,0,2,1,-1,1,-1,1,1
KR_6762525546,420,5,-24,10,10,5,7,2,5,6,1,-1,3,4,0,4,4,1,2,1,0,5,-1,2,4,6,-2,0,3,1,1,1,1,4,1
KR_6728441417,420,-1,-52,-28,-4,-2,7,9,-2,0,2,-3,0,3,0,4,4,3,3,0,-1,0,1,-1,2,1,1,0,-1,-1,-1,-1,-1,1,1
KR_6744566927,420,0,58,21,4,-1,1,2,4,5,1,-1,2,3,1,3,2,1,2,1,0,4,5,3,3,6,-2,0,0,1,-1,0,1,5,1
KR_6762689758,420,-1,-24,-24,7,2,2,0,3,3,0,-2,2,4,3,4,1,1,2,1,0,13,-6,-2,7,5,-6,0,1,1,-1,1,-1,6,1
KR_6742227388,420,4,96,28,17,5,5,0,2,3,1,-1,0,1,10,11,1,1,1,0,0,7,1,0,5,5,5,0,1,1,1,1,1,2,1
KR_6543435976,420,2,3,9,4,-1,0,1,2,5,3,-2,1,3,4,4,0,1,1,0,0,7,-122,0,5,5,3,0,0,-1,-1,1,1,6,1
KR_6676368542,420,7,37,2,24,2,3,1,3,5,2,4,6,2,17,17,0,-2,0,2,0,23,14,0,4,4,3,0,4,1,1,1,1,2,1
KR_6591589023,420,-1,-58,3,1,4,4,0,-1,4,5,0,4,4,-2,2,4,0,2,2,0,5,29,1,4,5,-1,0,0,-1,1,1,1,3,1
KR_6762354071,420,2,47,20,5,4,5,1,0,0,0,-1,1,2,2,3,1,0,0,0,0,1,35,-1,4,3,-10,0,2,-1,1,1,1,1,1
KR_6703248718,440,1,11,-9,1,0,3,3,-1,0,1,0,0,0,3,6,3,-1,1,2,0,-1,3,1,6,7,-3,0,0,1,1,0,-1,5,1
KR_6755024231,420,5,42,6,10,1,2,1,0,1,1,2,5,3,9,9,0,-2,1,3,1,15,-23,-2,5,3,3,0,1,1,-1,1,1,3,1
KR_6694229520,420,-1,-38,24,3,-2,2,4,4,6,2,-2,1,3,3,4,1,0,1,1,0,6,-7,0,6,6,4,0,-1,1,1,-1,-1,1,1
KR_6763594158,420,0,-74,2,4,2,2,0,0,1,1,1,2,1,5,5,0,-4,1,5,1,3,-7,-9,13,4,1,0,0,1,-1,0,1,4,1
KR_6752159213,440,3,5,20,10,4,7,3,2,2,0,-1,2,3,4,5,1,1,3,2,1,8,20,10,2,12,0,0,0,1,1,1,1,3,1
KR_6762521064,420,1,32,6,2,-2,0,2,1,2,1,-1,1,2,4,6,2,0,2,2,1,9,194,3,3,6,1,0,1,1,-1,1,1,3,1
KR_6762800304,420,3,-6,36,6,1,3,2,0,4,4,-2,2,4,5,6,1,2,3,1,0,1,9,2,2,4,-4,0,1,1,0,1,-1,5,1
KR_6745022274,420,5,13,19,8,8,8,0,1,4,3,1,1,0,1,7,6,-3,0,3,0,1,3,1,4,5,0,0,0,1,0,1,1,4,1
KR_6730628361,440,2,-25,-36,12,0,2,2,7,7,0,0,1,1,7,8,1,-2,0,2,0,10,-2,-1,7,6,1,0,0,-1,1,1,1,5,1
KR_6670200838,420,0,-31,-8,3,-5,0,5,3,5,2,0,0,0,6,7,1,-1,1,2,0,10,0,1,3,4,-3,0,0,-1,1,-1,1,1,1
KR_6764683945,420,1,-42,6,5,2,3,1,4,5,1,1,2,1,-3,2,5,1,3,2,0,7,-135,2,3,5,-5,0,0,-1,-1,0,-1,4,1
KR_6716381385,440,8,9,80,12,2,3,1,5,8,3,3,4,1,4,6,2,-2,1,3,-1,5,1,0,3,3,3,0,0,1,1,0,-1,5,1
KR_6383243696,420,-2,13,-26,-2,-3,1,4,0,0,0,-2,0,2,2,3,1,1,1,0,0,4,20,3,3,6,-2,0,0,0,-1,-1,-1,0,1
KR_6760544207,420,0,-29,-8,2,0,1,1,0,4,4,1,3,2,-1,3,4,2,3,1,1,3,6,-2,3,1,-2,0,0,1,0,0,1,4,1
KR_6607824534,420,1,-29,18,2,3,3,0,-4,2,6,1,5,4,2,2,0,0,0,0,0,-1,-3,4,5,9,-2,0,-1,0,-1,-1,-1,0,1
KR_6604879501,420,-2,21,21,-4,-3,0,3,-2,0,2,-5,1,6,4,6,2,2,2,0,0,-3,-102,-2,4,2,2,0,0,1,-1,0,1,5,1
KR_6713273833,420,4,59,8,5,1,2,1,3,4,1,-1,1,2,-1,0,1,3,5,2,0,9,46,2,5,7,-1,0,2,-1,1,1,1,4,1
KR_6633171482,420,4,95,44,2,-1,0,1,5,6,1,1,3,2,0,1,1,-3,2,5,0,-2,-5,-5,7,2,5,0,0,1,1,1,-1,5,1
KR_6708469730,420,3,15,28,4,-1,1,2,4,5,1,1,3,2,0,1,1,0,0,0,0,4,3,2,5,7,-2,0,0,1,1,0,-1,4,1
KR_6762438166,420,-3,-76,-9,-5,-3,1,4,-2,1,3,-3,2,5,4,7,3,-1,1,2,0,-5,-242,0,4,4,-1,0,0,-1,1,0,-1,3,1
KR_6471104069,420,5,58,4,17,1,2,1,4,5,1,11,11,0,-1,0,1,2,4,2,0,8,-1,1,4,5,0,0,1,1,0,1,1,1,1
KR_6737902753,420,7,13,32,12,0,3,3,2,4,2,3,5,2,3,6,3,4,4,0,0,14,16,-6,10,4,2,0,1,1,1,1,1,2,1
KR_6749967844,420,2,107,-3,-2,-4,0,4,1,1,0,1,2,1,0,1,1,0,3,3,0,-9,1,0,4,4,3,0,2,1,1,1,-1,1,1
KR_6724800286,420,3,57,-14,8,5,5,0,0,4,4,-1,0,1,2,5,3,2,3,1,-1,8,-1,-3,7,4,4,0,3,-1,1,1,-1,4,1
KR_6763199101,420,-3,25,-6,-6,-2,1,3,-8,1,9,3,3,0,1,3,2,0,2,2,0,-10,17,5,2,7,2,0,0,1,-1,0,1,3,1
KR_6716132882,420,3,96,26,-1,3,6,3,-4,0,4,1,4,3,-1,1,2,0,3,3,0,-5,145,-3,7,4,-12,0,2,-1,1,1,1,6,1
KR_6619309253,420,4,72,17,10,2,3,1,3,3,0,3,4,1,4,6,2,-2,0,2,0,10,6,3,3,6,7,0,2,1,1,1,1,3,1
KR_6745327300,420,2,16,4,2,4,6,2,1,6,5,-2,0,2,-1,1,2,0,1,1,-1,-5,-5,-1,6,5,-1,0,3,0,1,1,-1,0,1
KR_6668512800,420,2,28,32,-2,2,2,0,-3,1,4,4,4,0,-5,2,7,0,1,1,0,-5,-10,1,9,10,-2,0,0,1,1,0,-1,2,1
KR_6748011660,420,3,-15,-8,6,0,3,3,0,2,2,9,10,1,-3,2,5,0,3,3,-1,-8,-1,-2,4,2,-1,0,0,1,1,-1,-1,5,1
KR_6688272659,420,-1,-18,-1,-2,-3,1,4,-2,0,2,3,4,1,1,4,3,-1,1,2,0,2,7,2,3,5,2,0,-1,-1,-1,-1,-1,4,1
KR_6729136107,420,0,-62,11,3,-1,2,3,4,5,1,7,7,0,-7,0,7,0,1,1,0,5,32,1,5,6,1,0,-2,-1,1,-1,-1,1,1
KR_6724563784,440,2,60,14,10,5,6,1,1,4,3,0,2,2,3,5,2,1,1,0,1,3,0,0,5,5,2,0,0,1,1,1,1,5,1
KR_6522562696,420,4,63,20,1,-1,0,1,2,3,1,3,4,1,0,1,1,-3,0,3,0,-5,-10,0,5,5,1,0,2,1,1,1,1,4,1
KR_6626431348,420,0,-50,12,3,-2,0,2,3,3,0,3,5,2,-1,2,3,0,0,0,0,7,-2,-2,7,5,2,0,0,1,1,1,1,2,1
KR_6732862753,420,-1,-16,18,-1,-1,1,2,3,3,0,1,5,4,-5,1,6,1,3,2,0,0,134,-2,4,2,-2,0,0,-1,1,-1,-1,5,1
KR_6742060331,420,3,56,1,10,3,4,1,-2,0,2,3,5,2,4,8,4,2,4,2,0,3,-6,-2,6,4,2,0,1,-1,1,1,1,2,1
KR_6505868325,420,3,15,12,5,0,0,0,2,3,1,-2,0,2,5,6,1,0,1,1,0,5,-7,-1,6,5,2,0,0,1,0,1,-1,3,1
KR_6692394051,440,3,53,32,-2,2,2,0,0,2,2,-3,2,5,0,9,9,-1,2,3,1,-11,-188,-3,7,4,1,0,2,-1,0,1,1,3,1
KR_6764151459,420,1,23,-4,4,2,5,3,3,4,1,-1,4,5,1,2,1,-1,1,2,-1,6,7,5,2,7,-1,0,0,-1,0,0,-1,5,1
KR_6703273351,420,7,53,44,18,4,4,0,2,2,0,6,7,1,3,5,2,3,5,2,0,17,-3,-2,9,7,6,0,2,1,1,1,1,6,1
KR_6153003172,420,1,60,-6,-2,0,1,1,-6,0,6,2,2,0,1,2,1,1,1,0,0,-1,-14,-1,6,5,0,0,-1,-1,-1,-1,1,2,1
KR_6580835842,420,-2,18,-14,-8,-7,1,8,0,0,0,-2,1,3,-3,1,4,4,4,0,-2,-4,6,4,2,6,0,0,1,1,1,-1,-1,3,1
KR_6748176175,420,-1,3,0,-7,-2,2,4,-2,2,4,-1,1,2,0,0,0,-2,0,2,-1,-4,13,1,2,3,-3,0,0,-1,-1,0,-1,2,1
KR_6522782762,420,1,9,22,2,-3,2,5,2,3,1,1,4,3,0,0,0,2,2,0,0,0,-14,-1,5,4,9,0,0,-1,-1,0,1,2,1
KR_6764380365,420,-1,36,-1,3,0,3,3,-4,4,8,2,5,3,6,10,4,-1,2,3,0,15,33,5,2,7,-16,0,1,1,0,1,1,5,1
KR_6597559420,420,1,0,-24,5,-1,0,1,1,1,0,0,1,1,3,4,1,2,2,0,0,5,-7,-3,6,3,4,0,0,1,0,0,1,4,1
KR_6614949770,420,-3,-18,-21,-8,-2,1,3,-4,2,6,0,3,3,0,3,3,-2,0,2,0,-7,0,5,4,9,-1,0,-1,0,1,-1,-1,0,1
KR_6763650900,440,-1,-53,-12,1,2,4,2,-1,2,3,3,3,0,-1,2,3,-2,1,3,0,2,0,-1,8,7,-1,0,0,1,-1,-1,1,1,1
KR_6728337830,440,5,69,24,10,1,3,2,4,5,1,1,1,0,2,3,1,2,5,3,1,9,2,7,1,8,-1,0,3,1,1,1,1,2,1
KR_6762265207,420,3,27,4,7,1,2,1,4,5,1,0,4,4,2,3,1,0,0,0,0,14,137,2,4,6,1,0,1,0,1,1,1,0,1
KR_6749638234,420,0,42,-16,3,-3,0,3,6,8,2,0,1,1,-1,2,3,1,2,1,0,4,-2,0,4,4,-2,0,0,-1,1,1,1,1,1
KR_6611270902,420,5,78,28,10,2,2,0,8,9,1,0,1,1,0,3,3,0,0,0,0,3,-6,2,2,4,-1,0,1,0,1,1,-1,0,1
KR_6658128278,420,5,37,11,6,0,2,2,1,2,1,2,2,0,0,2,2,3,3,0,0,10,10,3,4,7,2,0,-1,1,1,-1,-1,2,1
KR_6760757579,420,-1,-37,0,-9,1,3,2,-1,1,2,-7,0,7,-2,1,3,0,1,1,0,-5,1,1,2,3,4,0,0,1,-1,-1,-1,5,1
KR_6764683445,420,1,-4,-16,0,-2,0,2,4,5,1,-4,0,4,2,4,2,0,0,0,0,6,2,3,6,9,3,0,0,1,-1,0,1,2,1
KR_6560464410,420,2,15,4,7,6,6,0,0,2,2,1,3,2,1,1,0,-1,0,1,0,6,3,0,4,4,-2,0,0,0,1,1,1,0,1
KR_6754089284,440,-2,81,-16,-1,-2,2,4,3,4,1,2,2,0,-1,0,1,-3,0,3,0,4,-4,0,4,4,0,0,1,1,1,1,-1,4,1
KR_6682987058,420,-1,19,-16,-3,2,4,2,4,6,2,-4,2,6,2,3,1,-7,0,7,1,-5,26,4,5,9,-4,0,1,1,1,1,1,2,1
KR_6619362368,420,2,80,16,5,3,3,0,0,2,2,2,4,2,1,1,0,-1,0,1,1,8,11,5,2,7,-5,0,2,1,-1,1,1,4,1
KR_6744838499,420,1,28,9,6,3,3,0,0,4,4,0,4,4,4,5,1,-1,0,1,0,2,1,0,5,5,5,0,1,-1,1,1,1,1,1
KR_6762630537,420,1,32,-12,2,5,6,1,-3,1,4,-1,2,3,2,2,0,-1,0,1,0,1,114,3,1,4,-3,0,0,-1,1,1,-1,1,1
KR_6764625520,420,3,-1,7,10,-1,1,2,0,2,2,2,5,3,9,12,3,0,2,2,1,9,-1,-4,5,1,0,0,0,1,1,1,1,4,1
KR_6758106623,420,1,27,-20,1,-5,3,8,2,2,0,1,4,3,2,7,5,1,1,0,0,7,-1,-1,8,7,4,0,0,1,-1,-1,1,2,1
KR_6729561356,420,3,41,5,5,2,4,2,3,4,1,1,5,4,1,2,1,-2,0,2,-1,-1,27,-3,5,2,-2,0,0,-1,-1,-1,-1,4,1
KR_6728566016,420,-1,-13,-24,2,1,4,3,0,1,1,-1,1,2,3,4,1,-1,0,1,0,5,3,5,4,9,-1,0,-1,1,-1,-1,-1,3,1
KR_6754521763,440,4,60,0,7,-5,2,7,12,14,2,1,3,2,-1,2,3,0,3,3,1,5,-7,-2,6,4,-1,0,0,0,0,0,1,0,1
KR_6752399010,420,1,27,20,-5,0,2,2,-1,1,2,-1,0,1,0,3,3,-3,0,3,0,-5,1,-8,9,1,0,0,0,-1,0,0,1,4,1
KR_6752869882,420,3,31,17,0,-1,3,4,-1,1,2,-1,2,3,2,4,2,1,3,2,0,-5,-36,4,2,6,2,0,0,1,-1,-1,-1,2,1
KR_6536897816,420,-2,-38,-15,-1,2,2,0,-3,2,5,0,2,2,-1,2,3,1,2,1,0,-1,7,5,3,8,-3,0,1,-1,-1,1,1,3,1
KR_6747392468,440,4,38,12,5,-1,0,1,-1,0,1,-2,0,2,5,5,0,4,4,0,0,4,-4,1,3,4,3,0,0,1,1,0,1,2,1
KR_6726368772,420,0,2,12,-2,0,0,0,-1,1,2,2,4,2,-3,2,5,0,1,1,0,-1,-2,1,1,2,1,0,-1,-1,-1,-1,1,1,1
KR_6675246714,420,1,-25,20,2,1,1,0,4,6,2,0,0,0,-3,2,5,0,0,0,0,2,-1,1,4,5,2,0,0,0,1,0,-1,0,1
KR_6627051671,420,-2,-53,12,-15,1,2,1,-1,4,5,-2,1,3,-12,2,14,-1,1,2,-3,-26,115,-4,9,5,-6,0,-2,-1,-1,1,-1,5,1
KR_6697031634,420,3,-18,32,9,0,3,3,4,7,3,4,7,3,-1,3,4,2,2,0,0,6,19,4,2,6,-2,0,1,-1,1,1,1,3,1
KR_6741924127,420,4,43,-8,13,4,5,1,4,4,0,1,2,1,1,2,1,3,3,0,0,17,11,2,4,6,-4,0,1,-1,1,1,1,1,1
KR_6758468466,420,6,48,-9,17,4,4,0,3,5,2,2,2,0,7,8,1,1,3,2,0,22,3,0,5,5,2,0,2,1,0,1,1,3,1
KR_6757128898,420,3,-18,24,4,0,1,1,0,2,2,2,2,0,3,4,1,-1,0,1,1,11,-149,-1,9,8,-7,0,0,-1,-1,0,1,3,1
KR_6626110059,420,1,21,11,7,-1,2,3,1,3,2,6,8,2,1,4,3,0,1,1,0,2,6,4,4,8,-2,0,0,1,1,0,1,4,1
KR_6736549731,420,3,6,20,7,-2,1,3,5,7,2,2,4,2,1,1,0,1,3,2,0,7,552,4,4,8,0,0,2,1,1,1,1,1,1
KR_6665707785,420,3,65,23,7,2,2,0,3,4,1,2,3,1,1,6,5,-1,1,2,0,-5,-7,-4,6,2,4,0,1,-1,1,1,-1,1,1
KR_6760594474,420,0,13,-16,6,2,4,2,-1,1,2,-6,0,6,4,8,4,7,7,0,0,9,2,5,5,10,-3,0,1,1,-1,1,1,4,1
KR_6579210654,420,5,58,21,6,0,1,1,-3,2,5,6,7,1,0,3,3,3,3,0,-1,4,-6,-6,7,1,5,0,2,1,1,1,-1,1,1
KR_6654740011,420,1,-2,0,2,-1,0,1,0,2,2,3,6,3,1,3,2,-1,1,2,0,1,-110,0,7,7,-1,0,-1,1,-1,-1,-1,1,1
KR_6744634949,420,5,68,2,13,4,7,3,5,6,1,3,4,1,1,3,2,0,1,1,0,4,5,1,4,5,1,0,2,-1,1,1,1,5,1
KR_6629159606,420,-4,-10,-36,-5,1,1,0,3,5,2,-1,0,1,-1,4,5,-7,0,7,0,-5,-15,2,5,7,0,0,-1,-1,1,-1,1,3,1
KR_6758009782,420,-2,-63,31,-3,2,3,1,1,4,3,-3,3,6,0,4,4,-3,1,4,-2,-5,-29,2,2,4,23,0,0,-1,1,0,-1,1,1
KR_6623877096,420,2,43,32,2,-1,1,2,4,5,1,-1,3,4,-1,1,2,1,1,0,0,-8,-120,-4,7,3,2,0,0,-1,1,1,-1,2,1
KR_6748288590,420,2,50,4,7,4,4,0,2,3,1,2,3,1,-2,0,2,1,5,4,0,2,-125,-2,6,4,0,0,1,-1,1,1,1,1,1
KR_6681249564,420,2,14,5,6,4,5,1,0,4,4,-3,1,4,4,7,3,1,4,3,-1,-6,-1,-1,6,5,4,0,1,1,1,1,-1,5,1
KR_6754581259,420,1,26,-4,5,0,1,1,5,7,2,1,1,0,-1,1,2,0,0,0,0,6,107,-2,6,4,3,0,1,-1,1,1,1,2,1
KR_6715312254,420,1,38,18,1,3,4,1,-1,1,2,-4,1,5,1,2,1,2,2,0,0,-1,38,3,3,6,-24,0,1,0,1,1,-1,0,1
KR_6726275777,420,3,48,3,1,5,5,0,-1,2,3,-2,0,2,0,2,2,-1,0,1,0,-4,0,1,2,3,0,0,1,1,-1,1,-1,2,1
KR_6761605746,420,3,27,15,4,2,2,0,-2,2,4,1,3,2,3,6,3,0,0,0,0,1,-6,-1,7,6,-1,0,0,-1,1,1,-1,3,1
KR_6726104337,420,-1,-11,11,1,-1,1,2,5,6,1,-3,2,5,5,8,3,-5,0,5,0,4,-36,-1,5,4,12,0,0,1,1,0,1,5,1
KR_6742042857,440,3,69,15,5,-2,0,2,1,1,0,1,2,1,-1,0,1,6,6,0,0,1,35,1,2,3,-6,0,1,-1,1,1,1,6,1
KR_6738986024,420,0,20,-18,2,3,4,1,1,5,4,-1,2,3,-1,1,2,0,1,1,0,-2,118,-2,4,2,-2,0,0,-1,0,0,1,2,1
KR_6669677783,420,4,17,13,1,-2,2,4,1,2,1,-3,1,4,2,3,1,3,3,0,0,3,105,-6,9,3,1,0,-1,1,-1,-1,-1,4,1
KR_6696349831,420,4,33,45,10,1,4,3,4,5,1,0,1,1,4,5,1,1,2,1,0,17,22,1,3,4,2,0,1,1,1,1,1,4,1
KR_6755067558,420,-1,63,-7,-6,7,8,1,2,5,3,0,5,5,-8,3,11,-7,2,9,0,-16,-35,7,3,10,-3,0,0,-1,-1,1,-1,2,1
KR_6411022647,420,6,30,56,4,-1,1,2,2,3,1,-3,1,4,5,7,2,1,1,0,0,-2,5,-3,3,0,0,0,1,1,1,1,1,2,1
KR_6657873163,420,-4,15,-36,-4,-1,1,2,-1,3,4,-1,3,4,0,2,2,-1,1,2,0,-6,-1,4,4,8,-5,0,0,-1,1,-1,1,1,1
KR_6724892128,420,2,-7,19,0,-1,1,2,-3,0,3,-1,2,3,3,4,1,2,2,0,0,-4,-3,-1,6,5,-2,0,0,1,-1,1,1,3,1
KR_6751025137,420,4,100,16,12,3,4,1,5,5,0,-1,3,4,5,5,0,0,0,0,0,11,6,-1,3,2,2,0,3,0,1,1,1,0,1
KR_6760020033,440,5,33,27,15,-1,1,2,1,1,0,4,4,0,7,9,2,4,4,0,2,16,-11,-1,4,3,4,0,2,0,1,1,1,0,1
KR_6759638283,420,5,125,0,13,2,2,0,4,7,3,0,2,2,2,3,1,5,5,0,0,6,0,-3,8,5,0,0,2,1,-1,1,1,1,1
KR_6504620308,420,3,58,17,7,3,3,0,0,4,4,-1,1,2,1,5,4,4,4,0,0,9,9,7,1,8,0,0,2,1,0,1,-1,2,1
KR_6761425268,420,1,36,24,5,3,4,1,2,2,0,-3,0,3,2,2,0,1,1,0,1,7,-6,3,2,5,6,0,0,-1,-1,0,1,2,1
KR_6751452187,420,0,8,-3,4,-1,1,2,1,3,2,-2,2,4,6,9,3,0,0,0,0,1,0,-1,7,6,-2,0,0,1,-1,1,1,2,1
KR_6744549322,420,3,-19,57,3,1,3,2,2,2,0,2,2,0,-2,0,2,0,0,0,0,4,-3,1,4,5,0,0,0,1,1,0,1,5,1
KR_6678757728,420,1,-22,10,5,-3,0,3,2,3,1,0,3,3,6,9,3,0,1,1,1,9,-4,-6,8,2,-2,0,1,1,-1,1,1,6,1
KR_6762249286,420,2,61,-23,7,5,6,1,2,3,1,3,3,0,-2,3,5,-1,1,2,0,4,-1,-2,6,4,1,0,0,1,1,1,1,1,1
KR_6616355073,420,3,64,0,11,3,5,2,-4,0,4,9,10,1,1,3,2,2,2,0,0,1,11,2,5,7,2,0,1,1,1,1,1,3,1
KR_6742829400,420,-1,2,-32,-3,1,2,1,-1,2,3,-2,1,3,-1,3,4,0,2,2,0,-5,-13,-5,8,3,7,0,1,-1,1,1,-1,6,1
KR_6717985679,420,1,37,-20,2,-2,2,4,1,3,2,0,4,4,3,4,1,0,0,0,0,6,-19,3,5,8,6,0,0,1,-1,0,1,3,1
KR_6684358485,440,2,44,-4,5,0,1,1,-1,1,2,3,4,1,3,4,1,0,0,0,0,-2,4,-3,8,5,-2,0,2,1,1,1,-1,4,1
KR_6751627867,420,-2,-80,-4,-3,-2,0,2,0,2,2,0,2,2,-2,2,4,1,3,2,0,-7,7,-1,4,3,-6,0,1,-1,1,-1,-1,4,1
KR_6762466704,420,4,24,4,7,2,3,1,2,5,3,4,8,4,-1,2,3,0,2,2,2,2,-18,-2,5,3,0,0,1,0,-1,1,1,0,1
KR_6404824471,420,4,40,19,5,1,1,0,-2,4,6,5,6,1,-1,0,1,2,2,0,0,3,2,2,4,6,-2,0,0,-1,1,0,1,6,1
KR_6752363010,420,-3,-3,8,-3,3,4,1,1,3,2,-4,0,4,0,2,2,-3,0,3,1,-5,4,4,4,8,0,0,-2,0,-1,-1,1,0,1
KR_6420826104,420,-2,-61,0,-1,0,3,3,0,2,2,-3,2,5,0,1,1,2,2,0,0,4,-5,0,3,3,-7,0,0,1,-1,-1,1,5,1
KR_6689763314,420,0,-13,18,-3,-5,0,5,1,2,1,2,2,0,-1,1,2,0,3,3,1,1,-9,-10,14,4,2,0,-1,1,-1,1,1,6,1
KR_6713307221,420,4,45,32,8,4,4,0,2,3,1,1,1,0,-4,1,5,5,5,0,0,8,-16,-5,7,2,2,0,1,1,1,1,1,5,1
KR_6738130933,440,-2,25,-20,-3,3,3,0,-1,3,4,2,3,1,-5,0,5,-2,0,2,0,-2,33,1,3,4,-1,0,0,-1,1,-1,1,4,1
KR_6639399567,420,0,40,3,-2,7,8,1,0,3,3,-7,1,8,-1,2,3,-1,1,2,0,-8,103,0,6,6,2,0,2,0,0,1,-1,0,1
KR_6748609709,420,0,-18,-28,2,-1,2,3,4,6,2,1,4,3,-2,2,4,0,3,3,-1,-1,-39,4,1,5,18,0,-1,-1,1,-1,-1,1,1
KR_6592067711,420,1,8,-12,7,2,3,1,3,5,2,-2,1,3,3,6,3,1,1,0,0,11,-10,3,6,9,2,0,1,1,-1,1,1,4,1
KR_6759537719,420,-3,4,-16,-12,3,3,0,-7,0,7,0,1,1,-6,0,6,-2,0,2,0,-16,-5,5,3,8,-5,0,0,1,1,1,-1,5,1
KR_6703091389,420,1,-7,43,-2,1,2,1,-7,2,9,6,6,0,-1,3,4,-1,2,3,2,-7,12,-2,10,8,6,0,0,1,1,1,1,2,1
KR_6759360119,420,4,41,19,4,-3,0,3,7,9,2,0,2,2,2,3,1,-2,1,3,0,-6,174,4,4,8,2,0,1,-1,1,1,-1,1,1
KR_6761399648,420,2,21,11,2,5,6,1,-1,0,1,-6,0,6,2,3,1,2,2,0,-1,1,312,0,6,6,4,0,0,1,-1,0,-1,6,1
KR_6759594046,420,2,-50,17,13,3,4,1,1,2,1,5,5,0,6,8,2,-2,0,2,0,13,11,2,5,7,-6,0,0,1,1,1,1,6,1
KR_6679531233,420,5,46,19,4,-1,0,1,0,2,2,5,5,0,0,0,0,0,0,0,0,2,18,-2,4,2,0,0,0,1,1,1,1,6,1
KR_6506067531,420,4,44,-19,15,1,2,1,7,8,1,3,4,1,3,4,1,1,1,0,1,24,55,0,7,7,7,0,1,1,-1,-1,1,1,1
KR_6752976842,420,4,-31,0,9,0,2,2,1,2,1,3,5,2,4,8,4,1,2,1,0,12,-3,-1,6,5,-1,0,1,1,-1,1,1,1,1
KR_6434697334,420,-1,-46,7,-4,1,1,0,0,3,3,5,7,2,-7,1,8,-3,2,5,0,-1,4,5,6,11,-7,0,-1,-1,1,-1,1,2,1
KR_6703428360,420,1,14,-4,0,-4,1,5,0,1,1,4,4,0,1,2,1,-1,1,2,0,6,2,3,3,6,1,0,-1,1,1,-1,1,2,1
KR_6750187958,420,0,9,28,-4,2,7,5,2,3,1,-3,2,5,-2,2,4,-3,0,3,1,-6,-14,-1,4,3,4,0,1,1,1,1,1,3,1
KR_6761839758,420,-2,95,-16,-4,0,0,0,-2,0,2,-5,0,5,3,3,0,0,0,0,0,-2,3,-1,5,4,1,0,1,1,-1,1,-1,1,1
KR_6706805298,420,2,103,-8,5,0,2,2,-2,2,4,1,4,3,3,4,1,3,5,2,0,5,-3,0,6,6,2,0,0,0,0,0,1,0,1
KR_6763214972,420,0,-5,5,1,-2,1,3,0,3,3,1,3,2,5,5,0,-3,0,3,0,-2,24,2,4,6,-2,0,0,-1,-1,0,1,4,1
KR_6749031160,420,6,59,32,10,4,4,0,0,5,5,4,4,0,2,4,2,0,0,0,0,2,4,1,2,3,3,0,1,0,1,1,-1,0,1
KR_6710345972,440,-1,80,31,-7,0,0,0,-4,0,4,-3,1,4,0,1,1,0,0,0,0,-5,-50,2,8,10,-3,0,1,1,1,1,-1,3,1
KR_6764243820,420,2,-36,21,4,-1,0,1,5,6,1,3,5,2,-3,0,3,0,0,0,0,7,8,4,1,5,-1,0,1,-1,-1,1,1,6,1
KR_6661470381,420,4,15,31,5,-2,1,3,-3,1,4,4,6,2,8,8,0,-2,0,2,0,6,31,3,2,5,-8,0,2,-1,1,1,1,2,1
KR_6722102866,440,1,-50,0,0,3,3,0,0,3,3,-1,2,3,1,5,4,-3,0,3,0,-9,-7,-5,7,2,7,0,-1,-1,0,-1,-1,4,1
KR_6653600758,420,9,117,16,17,7,8,1,3,4,1,2,3,1,6,6,0,-1,0,1,0,10,122,4,4,8,4,0,4,1,1,1,1,3,1
KR_6571269848,420,1,-41,-8,3,3,5,2,-4,0,4,-2,0,2,4,6,2,2,4,2,2,7,6,-1,5,4,-5,0,1,1,1,1,1,5,1
KR_6717078187,420,2,21,14,5,0,0,0,0,2,2,4,4,0,1,3,2,0,1,1,-1,1,6,5,2,7,2,0,2,-1,1,1,-1,6,1
KR_6751838554,420,3,-10,28,8,3,6,3,4,5,1,3,5,2,-1,5,6,-1,0,1,0,3,22,-2,5,3,-1,0,1,1,-1,1,-1,2,1
KR_6512702865,420,0,25,-8,-2,-2,1,3,1,5,4,0,1,1,-1,2,3,0,3,3,0,-2,-3,0,7,7,4,0,0,1,-1,0,-1,3,1
KR_6697746455,420,1,116,-6,0,5,6,1,-4,0,4,0,1,1,-1,5,6,0,2,2,0,-7,7,-1,5,4,3,0,3,-1,-1,1,1,3,1
KR_6654237437,440,2,50,12,5,-3,1,4,1,1,0,-2,1,3,4,6,2,5,6,1,0,-4,3,-1,3,2,0,0,2,-1,1,1,1,5,1
KR_6420748892,420,-1,19,-17,-3,-1,0,1,1,5,4,-2,2,4,-1,2,3,0,0,0,0,-7,-6,-2,7,5,-2,0,0,-1,-1,0,-1,1,1
KR_6704374465,440,0,4,16,1,-4,1,5,4,4,0,-2,3,5,1,2,1,2,2,0,0,8,117,3,3,6,-5,0,-1,1,-1,-1,1,1,1
KR_6633414628,420,3,19,13,5,0,0,0,-2,1,3,1,3,2,4,5,1,2,4,2,0,-6,-29,-1,6,5,-10,0,1,-1,0,1,1,6,1
KR_6759614231,420,3,61,48,4,4,4,0,0,3,3,4,6,2,-4,1,5,0,1,1,0,2,-6,2,3,5,-2,0,1,1,1,1,1,2,1
KR_6743980426,420,-2,-87,-1,-1,0,5,5,3,3,0,-5,0,5,1,1,0,0,1,1,0,0,-106,-2,6,4,-4,0,-2,0,-1,-1,-1,0,1
KR_6743541029,420,5,91,16,7,3,3,0,-2,1,3,0,1,1,5,6,1,1,1,0,0,5,1,5,3,8,1,0,0,1,-1,1,1,6,1
KR_6712303395,420,4,68,20,10,11,11,0,5,6,1,0,5,5,-5,1,6,-1,0,1,0,-2,9,6,2,8,1,0,1,1,1,1,1,2,1
KR_6669196311,420,3,-6,21,11,-2,1,3,12,12,0,3,4,1,-1,0,1,-1,1,2,0,19,17,2,5,7,-2,0,1,1,1,1,1,4,1
KR_6646359432,420,2,65,4,-3,0,4,4,-1,3,4,0,1,1,-1,0,1,-1,0,1,0,-4,-6,-3,7,4,6,0,0,1,-1,0,-1,4,1
KR_6756701326,420,1,4,16,2,-1,1,2,3,3,0,1,2,1,-5,6,11,4,4,0,0,-1,-1,-4,4,0,1,0,-1,-1,-1,-1,1,5,1
KR_6758781069,420,1,71,13,2,0,1,1,-2,1,3,1,1,0,5,7,2,-2,2,4,1,3,-7,-5,8,3,9,0,1,1,1,1,1,2,1
KR_6586837694,420,0,-41,-3,-2,-1,4,5,1,2,1,1,2,1,0,1,1,-3,0,3,0,4,-112,-2,5,3,0,0,-1,-1,1,-1,1,6,1
KR_6715490004,420,0,39,-20,-3,0,1,1,-4,1,5,-2,1,3,1,1,0,2,3,1,0,-6,-22,3,4,7,1,0,0,-1,-1,0,-1,5,1
KR_6761362047,440,-2,-43,-4,-5,-2,1,3,-4,1,5,1,4,3,0,5,5,0,0,0,0,-3,-4,-1,2,1,-1,0,0,1,-1,0,1,6,1
KR_6721864280,420,4,1,48,12,7,8,1,0,1,1,3,6,3,1,3,2,1,3,2,-1,7,-283,3,1,4,1,0,2,-1,1,1,-1,1,1
KR_6761883904,420,2,-9,36,2,-5,1,6,2,2,0,3,3,0,0,1,1,2,2,0,0,10,-117,-3,7,4,-12,0,-1,1,1,-1,1,4,1
KR_6730604493,420,1,-39,39,-2,0,3,3,3,3,0,0,0,0,-5,0,5,0,0,0,0,2,8,1,3,4,-4,0,-1,-1,1,-1,-1,5,1
KR_6756407470,420,0,-46,-17,-3,2,5,3,4,7,3,-3,2,5,-4,1,5,-2,0,2,0,-3,4,2,4,6,-2,0,0,-1,0,-1,1,5,1
KR_6760764282,420,2,18,-8,3,-2,1,3,0,2,2,4,5,1,2,3,1,-1,0,1,-1,8,1,8,1,9,4,0,0,1,1,0,-1,6,1
KR_6730290499,420,3,28,24,2,0,4,4,6,7,1,-2,0,2,-2,2,4,0,1,1,0,1,-2,-6,7,1,6,0,0,1,1,0,1,1,1
KR_6730913943,420,2,37,-11,8,0,0,0,3,6,3,2,4,2,1,4,3,2,2,0,0,18,21,0,5,5,5,0,1,1,-1,1,-1,3,1
KR_6505818858,420,2,24,-11,5,0,2,2,2,3,1,2,2,0,0,1,1,1,4,3,0,1,-52,-2,5,3,19,0,0,1,1,0,1,2,1
KR_6732973931,420,2,115,-11,12,7,9,2,5,6,1,2,2,0,-3,1,4,1,2,1,0,5,-3,3,1,4,1,0,2,1,1,1,-1,3,1
KR_6753816209,420,3,24,36,3,0,1,1,2,4,2,2,4,2,0,1,1,-1,0,1,0,-2,5,1,3,4,-3,0,2,-1,-1,1,1,5,1
KR_6679961601,420,5,66,-11,5,3,6,3,-2,1,3,-1,3,4,5,5,0,0,0,0,-1,-4,-24,-3,3,0,3,0,1,1,-1,1,-1,4,1
KR_6761743291,420,3,29,24,6,5,6,1,-3,2,5,2,3,1,3,6,3,-1,1,2,1,4,-1,3,3,6,3,0,0,0,1,1,1,0,1
KR_6755617453,420,0,34,-13,-5,-2,3,5,-1,1,2,-2,1,3,-1,4,5,1,1,0,0,-6,2,0,4,4,-2,0,1,1,1,1,-1,6,1
KR_6520227631,420,0,27,-12,-3,5,5,0,0,3,3,1,3,2,-5,1,6,-4,0,4,0,-9,-9,-3,7,4,6,0,0,-1,1,1,1,4,1
KR_6649365401,420,0,-1,-16,3,3,6,3,1,1,0,-1,4,5,0,1,1,0,0,0,0,3,264,-5,8,3,-1,0,1,-1,1,1,1,6,1
KR_6715517169,420,3,-15,-12,9,3,3,0,3,7,4,6,7,1,0,2,2,-3,0,3,0,10,11,5,5,10,-2,0,0,-1,-1,1,1,4,1
KR_6724611655,420,1,14,-4,-3,0,2,2,0,3,3,-3,0,3,0,1,1,0,0,0,-1,-5,-3,-4,6,2,-4,0,0,0,-1,0,-1,0,1
KR_6742922823,420,0,14,-40,5,4,6,2,0,4,4,-6,0,6,5,6,1,2,3,1,0,8,-8,-5,8,3,7,0,0,1,-1,1,1,5,1
KR_6759178457,420,4,87,44,12,1,2,1,0,7,7,3,4,1,5,7,2,3,4,1,0,11,-22,1,3,4,-2,0,1,1,-1,1,-1,1,1
KR_6658294068,420,1,15,-16,1,2,4,2,2,3,1,-3,1,4,-1,2,3,1,3,2,0,-1,-3,3,4,7,0,0,1,-1,1,1,1,4,1
KR_6758466195,420,-3,-15,-22,-4,-1,1,2,0,3,3,2,2,0,-4,0,4,-1,0,1,0,-6,6,-3,6,3,-27,0,0,-1,-1,0,1,1,1
KR_6760489709,420,1,47,-8,3,2,2,0,-1,2,3,1,3,2,0,2,2,1,1,0,0,2,1,3,3,6,2,0,0,1,1,0,1,6,1
KR_6716012864,420,-1,-4,-10,-6,-1,3,4,-1,3,4,-1,2,3,-1,2,3,-2,1,3,0,-2,-3,0,2,2,0,0,-1,-1,-1,-1,-1,1,1
KR_6658128083,420,1,14,16,4,2,2,0,-1,2,3,2,3,1,3,7,4,-2,0,2,1,7,-4,3,2,5,1,0,0,1,1,0,1,5,1
KR_6756289749,420,5,70,31,5,1,2,1,5,5,0,-3,2,5,0,2,2,2,3,1,0,0,27,5,2,7,5,0,0,1,-1,1,1,6,1
KR_6704264376,420,0,-47,-8,8,-1,4,5,5,5,0,6,8,2,0,1,1,-2,0,2,0,10,3,4,6,10,-1,0,-1,-1,1,-1,-1,5,1
KR_6710299448,420,-2,22,-8,3,2,3,1,1,3,2,4,6,2,-3,0,3,-1,0,1,0,4,-32,1,1,2,-1,0,1,1,1,1,-1,5,1
KR_6736007126,420,2,-6,12,6,5,5,0,5,7,2,2,5,3,-8,3,11,2,3,1,-2,-3,6,2,6,8,-4,0,1,0,1,1,-1,0,1
KR_6750107883,420,4,-9,4,14,1,2,1,2,3,1,5,8,3,6,6,0,0,0,0,2,26,6,1,5,6,5,0,0,1,-1,0,1,2,1
KR_6749155870,440,2,39,-4,8,1,3,2,3,3,0,-1,1,2,6,6,0,-1,1,2,-1,11,6,1,5,6,-1,0,0,1,-1,0,-1,4,1
KR_6760509138,420,3,34,31,6,1,2,1,0,2,2,-1,1,2,2,3,1,4,5,1,-1,1,10,0,4,4,-3,0,0,1,1,0,-1,4,1
KR_6586680146,420,-1,-91,-1,-5,-1,2,3,-2,3,5,-2,0,2,-1,3,4,1,1,0,1,-3,-4,-6,10,4,-5,0,-2,-1,-1,-1,1,4,1
KR_6700281171,420,5,-1,20,1,5,5,0,2,2,0,-1,2,3,-10,3,13,5,5,0,-2,-4,-14,-6,10,4,8,0,1,1,1,1,-1,2,1
KR_6591534714,420,8,-20,20,16,1,3,2,1,2,1,6,7,1,7,8,1,1,1,0,0,13,-16,-1,4,3,5,0,2,1,1,1,-1,5,1
KR_6717819114,420,1,33,-4,3,7,7,0,-6,5,11,0,2,2,0,3,3,2,5,3,0,-5,8,0,7,7,-2,0,0,1,1,1,1,5,1
KR_6751907358,420,5,5,-16,15,-1,1,2,2,2,0,3,6,3,10,11,1,1,1,0,1,22,4,1,3,4,7,0,1,1,1,1,1,5,1
KR_6692633883,420,2,20,0,6,2,2,0,3,3,0,2,3,1,0,1,1,-1,0,1,0,5,292,0,2,2,1,0,0,1,1,0,1,5,1
KR_6698086606,420,4,71,10,12,5,6,1,2,3,1,1,2,1,3,3,0,1,1,0,0,15,21,-2,6,4,2,0,1,-1,1,1,1,4,1
KR_6762362039,420,5,65,20,4,-1,1,2,-1,1,2,5,7,2,0,3,3,1,1,0,1,18,19,7,3,10,-2,0,1,1,0,1,1,6,1
KR_6761894857,420,2,46,-7,8,1,2,1,3,5,2,4,5,1,0,1,1,0,0,0,0,6,-7,0,4,4,4,0,0,0,0,1,-1,0,1
KR_6733684639,420,-2,37,-3,6,-2,1,3,3,4,1,-2,1,3,8,8,0,-1,1,2,0,7,2,2,4,6,5,0,-1,1,-1,1,1,6,1
KR_6737295402,420,0,-26,20,-2,1,4,3,4,7,3,-6,5,11,-2,6,8,1,2,1,-1,-10,1,1,5,6,-6,0,2,0,1,1,-1,0,1
KR_6740136614,420,1,-25,-21,0,-1,2,3,1,2,1,-3,2,5,5,5,0,-2,2,4,0,-1,-4,5,2,7,20,0,1,1,-1,1,1,3,1
KR_6723375897,420,3,-14,12,7,0,6,6,3,3,0,1,3,2,3,5,2,0,0,0,0,19,269,2,3,5,-7,0,0,1,1,1,1,4,1
KR_6723247840,420,1,-53,8,4,-4,0,4,0,1,1,7,7,0,1,5,4,0,2,2,0,5,-41,2,2,4,0,0,1,1,0,1,1,5,1
KR_6739365786,420,0,-31,3,-1,1,3,2,0,7,7,3,3,0,0,3,3,-5,0,5,0,8,-22,3,4,7,-1,0,0,1,-1,-1,-1,6,1
KR_6761995905,420,4,62,0,9,6,8,2,-2,2,4,1,4,3,5,7,2,-1,1,2,0,9,7,-2,4,2,1,0,1,-1,-1,1,1,1,1
KR_6734915745,420,2,36,-8,1,0,0,0,2,3,1,-2,2,4,2,2,0,-1,0,1,0,-1,6,-3,7,4,-5,0,-1,1,1,-1,1,2,1
KR_6632295976,420,-1,-11,20,3,3,3,0,-1,2,3,0,1,1,0,5,5,1,3,2,0,2,3,1,2,3,-1,0,0,1,1,0,1,2,1
KR_6635043173,420,-2,-13,-19,1,2,4,2,-1,0,1,0,1,1,1,1,0,-1,0,1,0,0,7,3,4,7,3,0,1,1,0,1,-1,5,1
KR_6752079285,440,-2,39,19,-9,-5,0,5,1,1,0,-2,2,4,-5,3,8,2,2,0,-1,-11,-10,-6,14,8,1,0,0,0,0,0,-1,0,1
KR_6714359401,420,1,-64,-7,8,0,3,3,3,3,0,4,5,1,-1,1,2,2,3,1,0,16,-138,-5,8,3,9,0,0,1,1,1,-1,4,1
KR_6761254409,420,-2,-45,-32,-3,0,2,2,0,0,0,2,7,5,-4,0,4,-1,0,1,0,-3,-11,0,5,5,4,0,-2,1,1,-1,-1,3,1
KR_6714246122,440,0,-59,-16,5,2,2,0,0,2,2,1,2,1,1,1,0,1,2,1,0,6,8,6,2,8,-7,0,0,1,1,0,1,2,1
KR_6749501842,420,1,15,20,0,-1,2,3,1,2,1,1,3,2,-1,2,3,0,0,0,1,3,-142,-1,7,6,-6,0,0,1,-1,0,1,1,1
KR_6215823715,420,1,43,7,0,1,2,1,-3,3,6,0,2,2,2,2,0,0,1,1,0,-3,-163,2,3,5,-3,0,1,1,-1,1,1,2,1
KR_6728813738,420,-1,16,36,0,2,4,2,8,11,3,-4,0,4,-6,0,6,0,1,1,0,-6,-5,1,5,6,0,0,0,1,-1,0,-1,5,1
KR_6744015830,420,1,70,8,1,1,3,2,0,3,3,-3,0,3,1,1,0,2,2,0,1,3,8,1,3,4,-3,0,1,1,1,1,1,5,1
KR_6749757006,440,1,29,-21,3,-2,3,5,2,2,0,2,3,1,2,3,1,-1,0,1,0,9,-6,-4,9,5,-7,0,0,-1,1,1,1,5,1
KR_6759090525,440,0,47,-4,0,0,1,1,1,3,2,1,3,2,0,7,7,-2,0,2,0,5,13,-1,10,9,-2,0,1,1,1,1,1,1,1
KR_6658219798,420,1,63,-36,5,-4,2,6,-1,4,5,2,3,1,5,8,3,3,3,0,1,7,5,3,2,5,2,0,0,-1,0,0,1,3,1
KR_6750807285,420,1,-12,-7,7,0,2,2,2,4,2,3,4,1,1,2,1,1,1,0,0,5,0,4,4,8,1,0,0,1,1,1,-1,6,1
KR_6597188004,420,7,119,44,14,4,4,0,3,5,2,1,2,1,4,4,0,2,2,0,0,13,15,-1,4,3,4,0,4,1,1,1,1,3,1
KR_6756440490,420,5,10,4,11,3,3,0,-1,1,2,2,2,0,5,5,0,2,2,0,0,11,5,-1,7,6,5,0,1,1,-1,1,1,4,1
KR_6706488070,420,1,-41,5,1,2,2,0,-1,3,4,2,3,1,-5,2,7,3,5,2,0,-1,-3,-2,6,4,3,0,0,-1,0,-1,-1,3,1
KR_6762984577,440,-2,9,-34,-11,-3,4,7,-3,1,4,-4,1,5,-1,2,3,0,0,0,-2,-16,44,-2,4,2,-17,0,1,1,1,1,-1,3,1
KR_6395053707,440,5,51,28,20,1,4,3,9,9,0,0,0,0,4,5,1,6,6,0,0,22,8,0,5,5,5,0,2,0,0,1,1,0,1
KR_6759891031,420,-1,-30,-4,-4,-2,1,3,-1,3,4,-3,1,4,2,2,0,0,0,0,0,-1,1,0,3,3,-6,0,0,-1,-1,-1,-1,6,1
KR_6763054178,420,-2,-34,-44,0,-3,0,3,3,4,1,1,1,0,0,0,0,-1,1,2,0,2,-1,0,4,4,-1,0,0,1,-1,1,1,1,1
KR_6037275214,420,2,36,-2,5,5,7,2,-2,0,2,2,6,4,0,1,1,0,0,0,0,-5,-27,-5,9,4,5,0,-1,-1,-1,-1,1,4,1
KR_6570806694,420,-1,84,12,-5,5,8,3,-7,0,7,-1,4,5,-2,1,3,0,1,1,1,-26,-38,-1,3,2,-4,0,0,-1,1,1,1,3,1
KR_6757818668,440,2,58,-16,6,2,3,1,2,3,1,2,5,3,-3,2,5,3,5,2,1,2,-53,0,5,5,7,0,1,1,1,1,1,1,1
KR_6655198103,420,3,108,-15,5,1,4,3,1,2,1,5,5,0,-3,1,4,1,2,1,0,-2,4,0,7,7,-3,0,0,-1,1,1,1,6,1
KR_6685284772,420,3,11,8,6,1,2,1,2,2,0,-3,1,4,2,2,0,4,4,0,0,6,2,3,4,7,1,0,0,1,1,0,1,3,1
KR_6761900405,420,4,79,16,3,-2,1,3,6,6,0,2,3,1,-2,1,3,-1,1,2,0,6,3,2,5,7,9,0,1,1,0,1,1,2,1
KR_6703288688,420,3,31,9,3,2,2,0,-3,3,6,4,5,1,1,3,2,-1,2,3,0,1,22,3,5,8,0,0,1,-1,1,1,-1,6,1
KR_6757994467,440,-1,17,-28,7,-2,0,2,-3,1,4,6,6,0,6,6,0,0,0,0,0,9,26,0,4,4,1,0,1,1,1,1,-1,6,1
KR_6629813014,420,5,36,8,12,2,3,1,5,6,1,1,2,1,1,4,3,3,3,0,0,22,-46,-3,5,2,7,0,0,1,-1,0,1,6,1
KR_6661734140,420,-1,15,-12,1,-1,2,3,-2,1,3,3,3,0,2,6,4,-1,0,1,0,-1,-2,6,1,7,-2,0,2,1,-1,1,-1,6,1
KR_6711353794,420,0,-1,9,1,4,5,1,2,4,2,-7,0,7,2,2,0,0,0,0,0,-6,0,-1,4,3,-2,0,-1,-1,-1,1,1,6,1
KR_6764776650,420,3,104,-26,7,5,5,0,1,2,1,1,1,0,0,0,0,0,0,0,0,2,38,-1,3,2,-21,0,2,-1,1,1,1,4,1
KR_6455053668,420,3,14,26,4,5,6,1,2,6,4,2,3,1,-4,2,6,-1,1,2,2,9,20,0,4,4,0,0,2,1,1,1,1,4,1
KR_6510923234,420,4,62,0,10,0,2,2,2,6,4,0,4,4,8,9,1,0,0,0,0,12,-5,1,5,6,-3,0,0,1,-1,1,1,4,1
KR_6699483071,420,1,35,-4,4,1,2,1,0,3,3,-4,1,5,4,5,1,3,3,0,1,10,-4,1,4,5,0,0,0,1,-1,0,1,2,1
KR_6723770994,420,2,69,-5,-2,0,1,1,-2,1,3,-1,0,1,2,5,3,-1,0,1,0,-5,0,-3,6,3,1,0,0,-1,1,0,-1,3,1
KR_6762268938,420,0,23,-12,-6,2,2,0,-2,2,4,1,2,1,-6,2,8,-1,0,1,0,-10,-3,3,2,5,0,0,0,-1,1,0,-1,5,1
KR_6753064669,420,0,13,34,0,1,2,1,1,5,4,-3,1,4,1,3,2,0,2,2,0,-1,-3,2,4,6,1,0,0,1,1,0,1,6,1
KR_6626393669,420,1,22,0,9,-2,3,5,2,3,1,3,4,1,5,9,4,1,1,0,0,15,-1,1,3,4,-2,0,0,-1,-1,-1,1,2,1
KR_6757508236,420,2,59,29,6,-1,2,3,3,4,1,2,5,3,2,4,2,0,2,2,1,0,-1,3,5,8,1,0,2,1,1,1,1,1,1
KR_6626680549,420,-3,-30,-23,-3,-1,1,2,1,3,2,-3,1,4,0,0,0,0,1,1,0,0,-4,2,3,5,2,0,0,-1,1,1,-1,6,1
KR_6705800389,420,3,141,10,15,4,5,1,3,3,0,4,6,2,8,9,1,-4,1,5,0,14,5,4,1,5,5,0,3,-1,1,1,1,6,1
KR_6759708580,420,1,-39,52,-5,-1,2,3,-7,1,8,-2,1,3,5,7,2,0,3,3,0,0,-6,-4,9,5,-2,0,-3,1,-1,-1,-1,3,1
KR_6761505035,420,2,50,-44,-1,5,5,0,-1,3,4,-3,2,5,-3,2,5,1,1,0,0,1,26,-1,4,3,3,0,1,-1,-1,1,1,5,1
KR_6749317302,420,-4,-20,-16,3,4,4,0,2,4,2,0,3,3,-1,1,2,-2,0,2,1,-1,-4,0,5,5,1,0,0,-1,1,0,1,2,1
KR_6679996114,420,5,77,7,12,-1,2,3,4,4,0,-1,2,3,9,9,0,1,1,0,0,14,0,2,2,4,2,0,1,1,1,1,1,2,1
KR_6715665134,420,2,13,12,7,2,3,1,-1,2,3,3,6,3,2,4,2,1,2,1,0,2,-1,0,4,4,-1,0,1,-1,1,1,1,1,1
KR_6764788672,420,0,-14,5,3,0,0,0,1,4,3,2,5,3,2,4,2,-2,0,2,0,4,7,1,4,5,0,0,0,1,-1,-1,-1,6,1
KR_6691281214,420,1,78,-25,1,1,1,0,-2,3,5,0,2,2,2,4,2,0,2,2,0,-1,-6,3,1,4,0,0,1,-1,1,1,-1,2,1
KR_6761630659,440,4,30,29,11,1,1,0,3,4,1,5,5,0,1,3,2,1,1,0,0,4,7,2,3,5,-1,0,0,1,1,0,1,5,1
KR_6655128606,420,2,-12,41,-1,-2,1,3,-3,2,5,4,5,1,-1,2,3,1,2,1,0,2,-2,3,4,7,7,0,1,-1,-1,1,-1,5,1
KR_6761086305,420,-1,3,-40,5,0,2,2,-2,2,4,4,6,2,3,5,2,0,2,2,0,10,368,0,3,3,-2,0,0,-1,1,0,-1,5,1
KR_6748573974,420,3,38,20,14,2,2,0,2,7,5,5,7,2,5,5,0,0,1,1,4,22,66,2,4,6,3,0,2,1,-1,1,1,3,1
KR_6731345002,420,-4,-1,-4,-5,-4,0,4,-2,4,6,-1,0,1,5,5,0,-3,0,3,0,3,3,3,2,5,-2,0,1,1,0,1,-1,5,1
KR_6512625531,420,-1,43,-33,2,0,0,0,-4,2,6,2,3,1,3,7,4,1,2,1,0,3,-12,6,2,8,-1,0,1,-1,1,1,-1,2,1
KR_6727384258,420,3,-30,24,10,-2,0,2,4,4,0,3,5,2,3,3,0,2,2,0,1,21,4,-2,8,6,2,0,2,1,1,1,1,4,1
KR_6666887476,420,4,110,4,4,-1,2,3,3,5,2,0,5,5,1,2,1,1,2,1,0,-9,-3,0,5,5,0,0,0,1,0,0,1,3,1
KR_6705832886,420,4,61,28,8,2,3,1,2,2,0,0,1,1,2,5,3,2,2,0,0,5,4,3,2,5,3,0,3,1,0,1,1,5,1
KR_6657238452,420,2,29,-12,5,-1,2,3,2,4,2,2,3,1,3,7,4,-1,1,2,0,5,17,1,4,5,6,0,0,1,1,-1,1,1,1
KR_6730761832,420,2,36,13,4,0,4,4,-1,1,2,-1,1,2,6,6,0,0,1,1,0,10,-2,2,5,7,2,0,0,-1,1,0,-1,3,1
KR_6728817773,420,3,41,14,12,0,0,0,1,3,2,4,4,0,7,7,0,0,0,0,1,13,-7,-10,11,1,10,0,-1,1,-1,-1,1,3,1
KR_6758925448,420,3,15,8,5,-2,2,4,-1,3,4,3,5,2,4,4,0,1,4,3,2,1,5,-1,5,4,5,0,2,1,-1,1,1,1,1
KR_6738501704,420,2,30,22,8,3,3,0,3,5,2,0,0,0,0,2,2,2,4,2,0,5,27,4,3,7,-1,0,1,1,-1,1,-1,1,1
KR_6500183720,420,3,90,-20,8,4,4,0,0,2,2,-1,2,3,-1,1,2,6,7,1,0,0,-1,1,4,5,0,0,1,-1,1,1,1,6,1
KR_6689170122,420,0,20,12,6,2,5,3,3,7,4,1,2,1,-1,1,2,1,3,2,0,8,7,0,1,1,0,0,0,1,1,1,-1,3,1
KR_6669439244,420,2,-37,36,2,4,5,1,2,5,3,-3,0,3,-1,0,1,0,1,1,0,6,-1,-2,6,4,5,0,1,1,1,1,1,5,1
KR_6757603186,440,-1,38,-11,2,-1,1,2,-1,4,5,6,6,0,-1,5,6,-1,0,1,0,1,9,1,2,3,-5,0,1,1,1,1,1,2,1
KR_6741114630,440,-5,-88,24,-7,-5,1,6,6,6,0,-4,1,5,-5,0,5,1,2,1,0,-4,-14,1,1,2,-2,0,-1,-1,0,-1,-1,5,1
KR_6723147344,420,-2,-15,-21,0,4,5,1,3,5,2,-2,1,3,-5,3,8,0,2,2,1,-5,17,0,3,3,-2,0,-1,0,1,1,1,0,1
KR_6710499796,440,8,36,19,16,6,7,1,7,8,1,1,3,2,-1,1,2,3,3,0,0,13,46,1,6,7,3,0,3,1,1,1,-1,6,1
KR_6762630533,420,-4,-71,-6,-7,-4,1,5,-1,3,4,-1,1,2,-1,1,2,0,1,1,0,-5,-6,-3,5,2,0,0,-3,1,-1,-1,-1,2,1
KR_6760225281,420,-3,-29,-45,1,0,2,2,5,7,2,-2,1,3,-1,4,5,-1,1,2,0,-1,4,1,7,8,-4,0,0,0,-1,0,-1,0,1
KR_6504844143,420,3,4,-24,10,-2,1,3,1,8,7,6,6,0,4,6,2,1,1,0,2,26,6,2,1,3,0,0,1,1,0,1,1,4,1
KR_6752739204,420,2,59,20,2,-3,0,3,-1,0,1,2,3,1,2,3,1,2,4,2,0,-4,-1,-4,7,3,0,0,1,-1,1,1,1,3,1
KR_6685405506,420,1,34,19,1,0,1,1,0,4,4,2,2,0,-1,2,3,0,2,2,0,-3,111,2,7,9,-1,0,0,-1,1,0,1,3,1
KR_6662396607,420,0,30,19,-5,0,1,1,-2,2,4,0,0,0,-3,0,3,0,0,0,0,-9,1,2,5,7,-1,0,0,1,1,0,-1,4,1
KR_6700076411,420,3,71,24,5,2,3,1,0,2,2,1,1,0,1,2,1,1,1,0,0,4,-2,-2,8,6,1,0,2,1,1,1,1,2,1
KR_6700458884,420,-2,-25,-9,-1,0,0,0,-2,3,5,-7,1,8,8,8,0,0,0,0,-1,-3,34,3,6,9,6,0,-1,1,-1,-1,-1,5,1
KR_6740378002,420,2,91,-4,7,0,1,1,-1,4,5,1,2,1,7,7,0,0,0,0,0,11,-1,1,5,6,8,0,1,1,-1,1,1,3,1
KR_6695440743,420,4,63,28,3,5,5,0,0,4,4,-2,2,4,0,6,6,0,0,0,0,3,2,2,8,10,0,0,2,1,0,1,1,6,1
KR_6708586827,420,1,-47,19,5,1,2,1,6,8,2,0,1,1,-3,1,4,1,1,0,0,3,9,1,4,5,-4,0,0,1,-1,0,-1,1,1
KR_6752927672,440,-1,51,20,-1,-3,1,4,2,4,2,1,2,1,-1,4,5,0,1,1,0,-3,-5,-5,7,2,4,0,-1,-1,1,-1,1,2,1
KR_6755773201,420,2,9,-25,2,-1,2,3,2,6,4,-2,3,5,4,4,0,-1,0,1,0,4,1,-4,6,2,4,0,0,0,-1,1,1,0,1
KR_6760504975,420,-1,-2,38,-1,4,5,1,-4,2,6,1,2,1,-1,3,4,-1,0,1,0,-10,-6,2,3,5,-1,0,2,-1,1,1,-1,3,1
KR_6708533002,420,-2,-10,0,-5,1,2,1,-5,0,5,4,4,0,-4,0,4,-1,1,2,0,-8,-15,-6,8,2,-1,0,0,-1,1,0,1,1,1
KR_6625495976,420,2,15,-15,4,2,4,2,3,4,1,5,6,1,-4,1,5,-2,1,3,1,-2,-7,-1,6,5,-5,0,0,-1,1,0,1,1,1
KR_6494400027,420,2,130,16,-2,0,2,2,-3,3,6,-3,2,5,4,4,0,0,0,0,0,-13,-15,-6,8,2,-28,0,3,-1,-1,1,1,3,1
KR_6759569094,420,6,20,19,13,4,5,1,2,4,2,1,2,1,3,4,1,3,3,0,0,9,-6,1,5,6,5,0,3,1,1,1,1,4,1
KR_6731782185,420,0,-3,1,8,1,1,0,2,5,3,4,5,1,0,2,2,1,4,3,3,14,15,-9,11,2,2,0,1,1,-1,1,1,5,1
KR_6748446360,420,-1,18,8,6,1,3,2,0,1,1,3,5,2,4,7,3,-2,0,2,0,1,0,1,5,6,3,0,1,1,-1,1,1,6,1
KR_6697433318,440,4,89,16,15,1,1,0,2,3,1,4,5,1,4,5,1,4,8,4,0,1,-2,-6,8,2,1,0,1,1,0,1,-1,1,1
KR_6749043482,420,1,61,25,6,4,6,2,-2,1,3,-4,4,8,7,7,0,1,5,4,0,5,-14,-3,5,2,3,0,0,1,1,1,1,2,1
KR_6624539300,440,4,37,20,9,3,6,3,6,7,1,1,3,2,-1,2,3,0,1,1,-1,-2,5,1,4,5,5,0,1,1,-1,1,-1,5,1
KR_6697910690,420,4,12,25,6,4,5,1,-5,0,5,-2,2,4,9,10,1,0,1,1,0,19,8,-3,5,2,1,0,1,-1,-1,1,-1,6,1
KR_6676904574,420,1,-3,32,1,1,1,0,-1,0,1,-3,1,4,0,2,2,4,5,1,0,-3,-6,-1,5,4,0,0,1,1,1,1,1,6,1
KR_6639177183,420,2,21,21,2,1,3,2,-6,1,7,3,7,4,5,8,3,-1,1,2,1,1,-17,-4,6,2,3,0,1,0,-1,1,1,0,1
KR_6602471742,420,4,71,28,7,9,9,0,0,2,2,3,5,2,-4,0,4,-1,0,1,0,3,10,0,3,3,-2,0,2,-1,1,1,1,3,1
KR_6761809792,420,-1,-15,-11,-1,0,2,2,3,3,0,-2,3,5,1,6,5,-3,0,3,0,-2,2,2,1,3,-1,0,0,-1,1,1,-1,5,1
KR_6669771561,420,3,25,-14,10,5,6,1,-2,3,5,2,3,1,3,4,1,2,3,1,0,6,-4,-1,5,4,-1,0,1,-1,1,1,1,4,1
KR_6545046417,420,0,-46,-25,1,-3,1,4,6,8,2,-2,0,2,1,4,3,-1,1,2,0,2,2,4,2,6,2,0,-1,1,1,-1,1,2,1
KR_6752241752,420,0,-3,14,-1,4,5,1,-4,1,5,-4,3,7,4,4,0,-1,0,1,0,0,2,3,3,6,-1,0,-1,-1,-1,-1,1,6,1
KR_6759311254,420,1,83,21,-3,4,4,0,-5,0,5,-3,1,4,2,5,3,-1,1,2,1,-6,-18,0,4,4,28,0,1,1,1,1,1,5,1
KR_6759376710,420,2,72,28,5,-2,1,3,0,2,2,5,6,1,2,3,1,0,3,3,0,-4,3,0,4,4,1,0,0,1,-1,0,1,1,1
KR_6612088382,420,-1,68,-12,-1,0,1,1,1,3,2,-1,0,1,-3,1,4,2,2,0,-1,0,26,5,4,9,-2,0,1,-1,1,1,-1,1,1
KR_6388067013,440,5,47,12,10,8,8,0,0,2,2,0,2,2,3,5,2,-1,1,2,-1,11,-11,-6,12,6,2,0,1,0,0,1,-1,0,1
KR_6697598557,420,4,8,36,5,-1,2,3,6,9,3,0,0,0,-1,6,7,1,1,0,0,14,14,-3,6,3,-2,0,-1,1,1,-1,1,1,1
KR_6696560758,420,4,-20,-1,13,6,6,0,2,2,0,2,2,0,3,4,1,0,0,0,0,24,21,3,5,8,0,0,0,1,1,1,1,6,1
KR_6759384811,420,-1,57,-4,-2,0,1,1,0,1,1,0,2,2,-1,1,2,-1,0,1,0,-3,-7,0,3,3,0,0,1,1,1,1,1,6,1
KR_6727971379,440,0,61,-14,4,2,5,3,0,1,1,-3,1,4,5,6,1,0,1,1,0,0,8,3,1,4,-3,0,1,-1,1,1,-1,2,1
KR_6691041601,420,2,-31,20,1,1,1,0,-2,1,3,-3,1,4,5,8,3,0,1,1,0,3,1,-4,8,4,-1,0,1,1,-1,1,-1,2,1
KR_6737858267,420,3,17,0,10,-4,0,4,5,7,2,3,4,1,6,9,3,0,1,1,0,30,-4,2,3,5,2,0,0,1,-1,1,-1,6,1
KR_6706846110,440,-6,-131,-41,-9,-6,5,11,-8,2,10,-2,0,2,8,10,2,-1,1,2,0,5,-39,1,3,4,-6,0,-4,-1,0,-1,-1,6,1
KR_6743742087,420,-1,-24,0,-1,0,4,4,-2,1,3,2,2,0,-1,3,4,0,0,0,1,2,1,-2,4,2,-2,0,0,-1,1,0,1,4,1
KR_6665462233,420,7,77,12,13,3,6,3,3,4,1,2,3,1,5,6,1,0,0,0,0,1,6,-2,5,3,-1,0,2,1,1,1,1,3,1
KR_6750223701,420,4,66,13,15,1,2,1,5,6,1,3,4,1,5,6,1,1,1,0,0,18,7,1,2,3,2,0,3,1,1,1,1,6,1
KR_6678524735,420,3,46,-3,3,3,6,3,1,6,5,1,1,0,-3,0,3,1,1,0,0,0,122,3,1,4,14,0,1,0,1,1,-1,0,1
KR_6744203224,420,6,63,49,15,-1,0,1,8,11,3,2,6,4,4,8,4,2,3,1,0,14,35,1,5,6,0,0,1,1,1,1,1,2,1
KR_6737736300,420,3,-27,12,7,-2,0,2,2,3,1,0,3,3,7,7,0,0,0,0,0,12,-6,-1,5,4,2,0,-1,-1,-1,1,-1,6,1
KR_6435680956,420,2,43,-4,3,-3,0,3,1,2,1,9,9,0,-4,2,6,0,2,2,0,1,38,1,1,2,-27,0,0,1,-1,0,1,2,1
KR_6668898649,440,1,37,-4,-2,1,2,1,-1,3,4,1,2,1,-1,3,4,-2,0,2,0,0,6,2,5,7,4,0,1,1,1,1,-1,6,1
KR_6746145657,420,4,23,7,8,2,3,1,4,6,2,1,3,2,1,6,5,0,2,2,0,10,5,-1,5,4,0,0,1,-1,1,1,-1,3,1
KR_6689609922,420,1,30,-11,-5,-3,2,5,-6,2,8,0,1,1,-1,1,2,5,5,0,-1,-10,-8,-6,8,2,0,0,0,-1,-1,-1,-1,2,1
KR_6727467039,440,2,67,40,5,-3,1,4,-2,1,3,3,4,1,6,9,3,1,3,2,0,4,-5,3,3,6,0,0,0,1,-1,1,-1,6,1
KR_6736465553,420,6,-14,-8,17,2,3,1,3,3,0,2,2,0,8,9,1,2,2,0,0,19,-31,3,1,4,17,0,3,1,1,1,1,6,1
KR_6761872007,420,2,60,12,-2,-3,0,3,1,1,0,-1,1,2,1,1,0,0,2,2,-1,-3,110,1,3,4,2,0,2,1,1,1,-1,4,1
KR_6757235768,420,0,48,-48,8,0,0,0,3,5,2,-1,3,4,4,5,1,2,3,1,0,13,23,-1,5,4,-3,0,0,1,-1,0,1,2,1
KR_6635341895,420,0,28,-4,6,-2,4,6,5,6,1,3,3,0,1,2,1,-1,0,1,0,11,-2,-2,5,3,1,0,0,-1,-1,1,1,2,1
KR_6571259485,420,7,69,4,13,1,2,1,3,4,1,3,3,0,4,5,1,2,3,1,0,17,10,2,3,5,1,0,1,1,1,1,-1,2,1
KR_6746023931,440,0,-27,-17,-1,3,3,0,0,2,2,-4,2,6,1,2,1,-1,0,1,0,2,-2,-3,7,4,1,0,-2,1,1,-1,1,2,1
KR_6721353971,420,8,130,-5,17,5,5,0,-3,1,4,1,2,1,15,15,0,-1,0,1,1,14,19,4,2,6,2,0,4,1,0,1,1,6,1
KR_6725319718,420,1,10,13,-1,-1,3,4,-1,2,3,4,4,0,-1,3,4,-2,1,3,0,-7,12,-4,8,4,-3,0,1,-1,-1,1,1,1,1
KR_6748898221,420,-1,-35,-47,-1,2,4,2,-4,0,4,0,2,2,-1,1,2,2,2,0,0,-6,-9,-4,6,2,-2,0,0,-1,1,-1,1,4,1
KR_6608417247,420,2,40,-22,7,1,4,3,0,3,3,1,2,1,5,7,2,0,0,0,0,13,2,2,3,5,0,0,-1,1,-1,-1,-1,2,1
KR_6758372235,420,3,23,-13,12,-4,0,4,2,7,5,4,8,4,10,13,3,0,0,0,0,13,7,10,1,11,0,0,1,1,-1,1,1,4,1
KR_6730430174,420,5,9,7,6,2,2,0,-1,1,2,-1,1,2,5,6,1,1,2,1,0,2,-1,0,5,5,0,0,1,1,-1,1,1,6,1
KR_6626384386,420,1,-38,28,-12,0,1,1,0,3,3,-5,1,6,-3,4,7,-4,0,4,0,-12,-7,-2,6,4,2,0,0,-1,1,-1,1,3,1
KR_6678155375,440,3,44,10,10,0,0,0,1,2,1,2,3,1,5,8,3,2,3,1,2,17,22,2,4,6,2,0,-1,-1,1,1,1,3,1
KR_6696279863,420,-2,-24,-20,0,-7,1,8,0,2,2,5,6,1,0,1,1,2,2,0,0,5,-107,4,2,6,-6,0,0,-1,1,0,1,3,1
KR_6458955222,420,4,45,40,1,1,2,1,3,6,3,4,5,1,-4,2,6,-3,0,3,0,2,-9,3,5,8,-2,0,0,-1,1,1,-1,2,1
KR_6709699573,420,1,31,8,6,1,3,2,5,5,0,-2,3,5,2,4,2,0,2,2,0,9,-31,3,4,7,31,0,1,1,1,1,-1,3,1
KR_6722441836,420,1,56,0,4,1,3,2,-1,2,3,-2,2,4,6,8,2,0,1,1,0,9,-9,0,4,4,3,0,1,-1,1,1,-1,4,1
KR_6737890694,420,0,48,-16,0,0,2,2,-2,2,4,0,1,1,4,4,0,-2,0,2,0,-4,-4,-3,6,3,-1,0,1,-1,-1,1,1,5,1
KR_6695626185,420,7,78,38,16,4,4,0,3,6,3,1,4,3,8,9,1,0,2,2,1,6,1,3,2,5,3,0,2,0,1,1,1,0,1
KR_6760706192,420,0,-17,18,2,2,3,1,-2,2,4,-1,4,5,3,4,1,0,0,0,0,3,1,-5,11,6,0,0,0,1,-1,-1,1,2,1
KR_6474454977,440,3,7,24,3,-1,0,1,0,5,5,1,4,3,2,4,2,1,1,0,0,5,-6,3,2,5,3,0,1,1,1,1,-1,4,1
KR_6748478985,420,4,96,-8,7,2,3,1,-1,0,1,-1,1,2,6,6,0,1,2,1,0,6,4,5,1,6,-1,0,1,0,-1,1,1,0,1
KR_6729463131,420,1,84,-6,-1,3,4,1,-6,2,8,1,3,2,-1,1,2,2,2,0,0,-12,43,0,5,5,-15,0,1,-1,1,1,1,5,1
KR_6724735807,420,0,-52,-12,-1,0,3,3,-1,3,4,0,1,1,1,2,1,-1,3,4,0,7,-8,-3,7,4,0,0,-1,0,0,-1,1,0,1
KR_6756592722,420,0,66,-5,5,0,1,1,1,1,0,5,7,2,0,1,1,-1,1,2,0,7,3,6,2,8,-4,0,1,1,-1,1,1,3,1
KR_6746317289,420,0,19,48,6,-4,0,4,3,9,6,3,5,2,4,4,0,0,2,2,3,13,16,0,7,7,-2,0,0,0,1,-1,1,0,1
KR_6633444624,420,-4,-43,-25,-4,-4,0,4,-2,1,3,2,5,3,0,1,1,0,0,0,0,0,-319,-1,2,1,0,0,-1,1,-1,-1,1,3,1
KR_6741066574,420,4,51,44,8,4,5,1,3,5,2,1,2,1,0,0,0,0,0,0,0,6,-3,0,2,2,-2,0,1,1,0,1,-1,5,1
KR_6747275963,420,1,2,-8,4,4,4,0,-2,0,2,1,2,1,5,6,1,-4,1,5,0,-5,-26,3,3,6,-1,0,0,-1,-1,1,-1,4,1
KR_6756958656,420,7,84,20,14,1,2,1,4,5,1,6,6,0,2,3,1,1,1,0,0,16,-7,0,3,3,-1,0,0,1,1,1,1,2,1
KR_6142636340,420,2,48,40,1,0,1,1,-1,1,2,-1,2,3,1,2,1,2,3,1,1,0,14,2,6,8,-2,0,2,1,1,1,1,5,1
KR_6650246396,420,1,10,-12,5,1,2,1,4,4,0,3,5,2,-1,4,5,-2,0,2,0,3,-3,-1,4,3,2,0,0,-1,1,0,1,4,1
KR_6632618870,420,2,70,24,-1,2,2,0,0,2,2,-4,1,5,1,5,4,0,1,1,0,-1,48,2,4,6,-22,0,0,1,1,-1,-1,5,1
KR_6672701305,420,3,-8,28,2,-3,1,4,2,3,1,0,1,1,1,2,1,2,2,0,0,6,-105,3,3,6,-4,0,-1,1,0,-1,-1,2,1
KR_6710732138,420,3,41,-7,12,6,7,1,-1,3,4,5,9,4,3,4,1,-1,4,5,1,13,-37,2,4,6,14,0,1,1,1,1,1,4,1
KR_6726978202,420,3,21,20,12,-1,0,1,5,7,2,5,5,0,0,0,0,3,4,1,0,9,4,-2,5,3,3,0,-1,-1,1,1,1,2,1
KR_6507685160,420,7,49,-9,20,6,8,2,5,7,2,5,6,1,3,5,2,1,3,2,1,26,3,7,1,8,-3,0,1,1,1,1,1,6,1
KR_6647158994,420,-1,48,-22,2,3,3,0,-2,3,5,-1,3,4,3,6,3,-1,2,3,1,8,12,0,4,4,-6,0,1,0,0,1,1,0,1
KR_6726841589,420,-3,-119,-20,-1,-1,1,2,2,3,1,1,4,3,-1,1,2,-2,0,2,0,3,-1,2,5,7,3,0,0,-1,0,0,-1,1,1
KR_6667599913,420,-1,-6,-8,1,-3,1,4,2,3,1,2,3,1,-1,0,1,1,1,0,0,5,-10,-4,7,3,3,0,-1,-1,-1,-1,-1,4,1
KR_6621463058,420,5,77,37,9,2,2,0,0,3,3,8,9,1,-1,2,3,0,3,3,0,-1,-20,4,2,6,-2,0,1,1,1,1,1,3,1
KR_6741355798,420,3,-17,32,6,3,4,1,2,3,1,1,4,3,1,1,0,-1,1,2,0,7,-1,-2,5,3,-1,0,-1,1,-1,-1,-1,5,1
KR_6702647849,420,0,10,-20,0,-1,0,1,2,4,2,-7,3,10,1,5,4,5,6,1,0,-1,2,0,3,3,-5,0,0,0,0,1,1,0,1
KR_6759501110,420,4,43,14,10,3,3,0,1,2,1,3,4,1,4,4,0,-1,0,1,0,6,17,6,3,9,-6,0,1,1,1,1,-1,1,1
KR_6675031202,420,0,25,8,3,-7,0,7,2,4,2,-2,2,4,7,7,0,3,4,1,0,10,13,-5,7,2,7,0,0,-1,1,1,1,1,1
KR_6750316781,420,1,-27,0,3,0,3,3,0,5,5,0,1,1,4,4,0,-1,0,1,4,10,14,2,4,6,-4,0,0,-1,0,0,1,2,1
KR_6738052326,420,4,63,8,8,3,4,1,0,4,4,1,2,1,0,1,1,4,4,0,0,3,6,4,4,8,-3,0,1,1,1,1,1,2,1
KR_6706096071,420,2,7,-12,7,6,6,0,0,0,0,0,1,1,2,3,1,-1,2,3,0,5,81,-8,10,2,3,0,1,-1,1,1,-1,1,1
KR_6673722164,420,3,57,12,5,3,3,0,-1,0,1,2,2,0,0,1,1,1,1,0,0,4,41,3,3,6,1,0,0,0,1,0,1,0,1
KR_6755713326,420,0,37,-3,3,1,1,0,1,2,1,-1,1,2,2,3,1,0,0,0,0,-4,18,6,3,9,-7,0,0,1,1,1,1,5,1
KR_6749498108,420,1,4,-12,4,-4,3,7,3,4,1,4,4,0,2,4,2,-1,1,2,0,12,0,3,3,6,4,0,-1,1,0,1,-1,3,1
KR_6642866154,420,1,11,-16,2,-1,2,3,1,4,3,0,2,2,2,2,0,0,3,3,0,7,0,3,4,7,0,0,0,-1,-1,-1,1,3,1
KR_6580152520,420,4,82,4,9,-2,0,2,7,7,0,9,10,1,-5,2,7,0,1,1,0,5,-64,-8,10,2,23,0,1,1,-1,1,1,4,1
KR_6705941185,420,2,80,42,1,-1,1,2,0,2,2,3,6,3,-2,2,4,1,4,3,0,-1,-2,-1,5,4,1,0,2,0,1,1,1,0,1
KR_6741919597,420,4,75,39,3,4,4,0,-3,2,5,3,3,0,0,1,1,-1,0,1,0,3,3,4,2,6,-2,0,1,1,1,1,1,6,1
KR_6703719238,440,1,18,6,10,2,5,3,-1,3,4,3,3,0,5,7,2,1,1,0,0,6,42,2,4,6,-25,0,0,1,1,0,1,3,1
KR_6662968337,420,5,106,-12,5,14,14,0,-5,2,7,-2,1,3,3,7,4,-5,0,5,0,-5,5,3,2,5,1,0,1,-1,1,1,-1,1,1
KR_6695881366,420,2,-53,12,3,3,5,2,-2,2,4,-2,1,3,3,4,1,1,2,1,-1,4,6,2,6,8,1,0,0,0,-1,-1,-1,0,1
KR_6755834316,440,0,65,-10,3,1,3,2,1,3,2,2,5,3,3,7,4,-4,0,4,-1,-4,-8,-2,6,4,0,0,0,1,-1,1,-1,5,1
KR_6741842288,420,1,23,4,5,4,5,1,0,4,4,3,4,1,-1,1,2,-1,2,3,0,-8,-2,-2,6,4,1,0,0,1,1,0,1,4,1
KR_6737703202,420,0,47,12,8,3,4,1,3,4,1,3,4,1,-1,0,1,0,0,0,0,4,9,4,2,6,2,0,1,1,1,1,1,2,1
KR_6763893635,420,3,24,48,4,1,4,3,1,3,2,5,5,0,-3,1,4,0,0,0,0,2,16,-1,6,5,-3,0,2,1,1,1,-1,1,1
KR_6747609254,420,3,65,27,7,-1,2,3,5,6,1,1,2,1,0,4,4,2,2,0,1,7,-10,-4,8,4,2,0,0,-1,1,0,1,5,1
KR_6751662280,420,2,30,-27,6,2,2,0,-1,2,3,-1,0,1,6,6,0,0,1,1,0,1,12,-4,4,0,-1,0,1,1,0,1,1,5,1
KR_6741706109,420,6,96,6,18,2,3,1,1,4,3,5,5,0,3,6,3,7,7,0,0,11,10,5,0,5,-2,0,3,1,1,1,1,6,1
KR_6621714862,420,2,30,0,9,3,3,0,4,4,0,-1,3,4,1,3,2,2,2,0,0,13,2,-1,5,4,-3,0,1,1,1,1,1,5,1
KR_6757843820,420,6,17,40,14,6,7,1,4,5,1,4,6,2,0,1,1,0,0,0,0,10,-8,0,7,7,3,0,1,1,-1,1,1,2,1
KR_6674365679,420,6,82,7,10,5,5,0,2,4,2,1,2,1,2,4,2,0,1,1,0,5,-123,-1,7,6,1,0,0,1,0,0,-1,6,1
KR_6763012710,420,1,-7,1,-3,2,3,1,-6,0,6,3,5,2,-3,1,4,1,2,1,0,-6,-14,3,1,4,-3,0,-1,-1,1,-1,1,6,1
KR_6747494330,440,5,54,4,13,1,6,5,0,0,0,2,2,0,-2,0,2,12,13,1,0,10,-2,-1,4,3,0,0,2,1,0,1,1,5,1
KR_6606292170,420,-4,-22,16,-5,-1,2,3,-5,2,7,3,3,0,-5,1,6,3,3,0,-1,-18,-15,-1,2,1,-1,0,0,1,-1,-1,-1,2,1
KR_6730264931,440,3,-10,12,-3,-2,3,5,0,2,2,2,3,1,-4,2,6,1,4,3,0,-9,41,-6,12,6,1,0,1,1,0,1,-1,1,1
KR_6494267956,420,0,33,0,-3,2,3,1,2,6,4,-3,0,3,-2,3,5,-2,0,2,0,-3,3,7,4,11,-7,0,0,1,1,-1,-1,4,1
KR_6670258459,420,5,36,19,10,0,1,1,6,10,4,1,2,1,3,5,2,0,0,0,0,10,-75,-2,4,2,-1,0,1,-1,0,1,1,4,1
KR_6750502989,440,3,35,32,8,-2,0,2,3,3,0,2,4,2,8,9,1,-3,1,4,0,3,-2,-2,6,4,4,0,2,0,1,1,1,0,1
KR_6586127048,420,1,82,4,3,2,4,2,-1,1,2,-1,0,1,3,6,3,0,0,0,0,-8,-22,-3,9,6,0,0,1,1,0,1,1,2,1
KR_6670298615,420,0,14,10,-3,-2,0,2,-2,1,3,3,4,1,-2,1,3,0,0,0,0,-8,18,-2,5,3,-2,0,0,0,-1,-1,-1,0,1
KR_6757695138,440,4,77,36,5,2,5,3,4,6,2,1,5,4,-2,2,4,0,0,0,0,-4,-24,-4,8,4,3,0,1,1,1,1,1,3,1
KR_6728558573,420,0,33,-5,3,2,2,0,2,3,1,4,5,1,-3,2,5,-2,1,3,0,-4,106,3,2,5,-1,0,0,0,1,0,1,0,1
KR_6759891629,440,2,41,7,6,0,3,3,2,3,1,2,3,1,0,0,0,2,2,0,0,1,3,1,3,4,0,0,0,1,1,0,-1,1,1
KR_6425223223,420,-2,-15,10,-5,2,2,0,3,4,1,-4,2,6,-4,2,6,-2,0,2,1,-7,-5,-3,4,1,3,-1,-2,1,-1,-1,1,5,1
KR_6659887335,420,0,10,-40,0,-2,3,5,-1,1,2,4,5,1,3,4,1,-4,0,4,0,8,-20,2,2,4,-1,0,-1,1,0,-1,-1,4,1
KR_6757808793,420,0,45,-15,0,-1,3,4,-3,3,6,2,3,1,0,2,2,2,2,0,0,7,4,-1,3,2,1,0,0,1,1,0,1,1,1
KR_6761640474,420,-3,-12,0,-4,3,4,1,-13,2,15,6,11,5,0,1,1,0,1,1,1,-9,16,1,3,4,-3,0,0,1,-1,-1,1,1,1
KR_6675774860,420,0,-20,24,-6,-2,2,4,0,2,2,-2,2,4,-6,2,8,4,4,0,1,-7,-9,2,6,8,1,0,-1,-1,1,1,-1,3,1
KR_6760905451,440,6,71,15,23,4,5,1,4,4,0,5,6,1,6,7,1,4,4,0,0,26,-7,1,3,4,10,0,3,1,1,1,1,1,1
KR_6739641750,420,-1,49,-20,-2,-1,3,4,3,5,2,-1,1,2,-4,0,4,1,2,1,0,0,-2,-5,8,3,1,0,1,0,1,1,-1,0,1
KR_6757041714,440,2,11,-12,4,1,3,2,1,3,2,-1,3,4,3,4,1,0,1,1,0,16,114,3,2,5,-6,0,0,1,-1,0,-1,6,1
KR_6763291287,420,1,73,-4,3,-5,0,5,-1,1,2,2,3,1,4,4,0,3,4,1,0,4,9,-1,5,4,3,0,0,1,-1,1,-1,4,1
KR_6762282783,420,5,-22,12,6,5,5,0,-1,1,2,1,4,3,-1,1,2,2,3,1,0,3,-5,-4,4,0,3,0,0,-1,1,0,1,4,1
KR_6674132934,420,-2,-6,16,-8,-3,0,3,-1,2,3,-1,1,2,1,3,2,-4,1,5,0,-5,47,3,2,5,-18,0,0,1,1,-1,1,3,1
KR_6753664003,420,2,-20,8,9,4,5,1,1,3,2,7,8,1,-5,1,6,2,2,0,-1,8,1,6,4,10,-2,0,1,1,1,1,-1,5,1
KR_6752209658,420,1,22,-11,7,-1,2,3,3,5,2,2,2,0,0,2,2,3,3,0,0,7,1,1,4,5,5,0,-1,1,1,-1,1,1,1
KR_6708192543,420,4,32,18,15,1,3,2,3,4,1,3,3,0,8,8,0,0,2,2,0,16,0,1,5,6,2,0,0,1,0,1,1,5,1
KR_6725654016,420,2,47,33,12,1,3,2,1,4,3,5,6,1,5,7,2,0,0,0,5,15,-1,2,6,8,3,0,1,1,1,1,1,4,1
KR_6637401855,420,1,0,4,8,-2,2,4,-3,2,5,7,7,0,1,4,3,5,5,0,0,1,1,1,7,8,3,0,2,1,0,1,1,2,1
KR_6761804054,420,7,45,-7,15,3,3,0,6,9,3,3,3,0,2,2,0,1,2,1,0,10,4,4,1,5,0,0,1,0,1,1,1,0,1
KR_6667039030,420,0,-2,-20,-2,0,1,1,-2,1,3,2,4,2,-1,1,2,-1,0,1,0,-6,-12,-5,7,2,5,0,0,1,1,0,-1,6,1
KR_6764064596,420,2,96,2,3,4,4,0,1,1,0,4,4,0,-5,1,6,-1,1,2,0,-6,4,-3,7,4,2,0,2,1,1,1,1,6,1
KR_6732417309,420,2,46,30,-4,0,1,1,4,4,0,-3,1,4,-3,0,3,-2,1,3,0,-3,45,-2,6,4,-5,0,1,0,1,1,1,0,1
KR_6652671776,420,2,34,-16,9,0,2,2,-4,0,4,15,16,1,0,5,5,-2,1,3,0,-4,-2,7,3,10,2,0,2,1,1,1,-1,6,1
KR_6760323215,420,1,20,25,-4,-4,0,4,-3,2,5,-4,2,6,7,9,2,0,3,3,-2,-7,44,-2,4,2,-41,0,1,-1,-1,-1,-1,5,1
KR_6763168044,420,0,41,8,-4,0,1,1,-2,0,2,-1,0,1,-1,2,3,0,1,1,0,-4,149,1,6,7,-29,0,0,-1,-1,0,-1,3,1
KR_6755428932,420,-1,-49,-22,0,-4,1,5,0,3,3,0,3,3,1,1,0,3,3,0,0,6,5,-2,7,5,3,0,0,0,-1,-1,-1,0,1
KR_6714316678,420,8,144,50,4,3,3,0,2,5,3,2,5,3,-3,2,5,0,0,0,0,-5,2,0,2,2,-1,0,3,-1,1,1,1,5,1
KR_6490093262,420,3,9,-4,8,3,4,1,6,8,2,-3,0,3,2,2,0,0,1,1,0,2,6,2,2,4,-1,0,1,1,-1,1,-1,5,1
KR_6763794086,420,-4,1,-21,-10,0,0,0,-2,3,5,-6,0,6,1,3,2,-3,0,3,-1,-9,-33,-2,4,2,5,0,0,-1,1,0,-1,4,1
KR_6672838327,420,1,36,-3,4,1,1,0,1,4,3,0,0,0,2,6,4,0,1,1,0,1,-141,1,3,4,0,0,0,1,1,0,1,4,1
KR_6754886951,420,3,41,16,1,0,2,2,6,7,1,-5,4,9,0,2,2,0,1,1,0,3,-5,-4,6,2,2,0,0,0,1,0,-1,0,1
KR_6759909600,420,1,49,-6,-1,-1,3,4,0,4,4,1,3,2,0,3,3,-1,0,1,0,-8,-4,-5,9,4,5,0,0,1,-1,-1,1,4,1
KR_6741074048,440,0,18,14,-2,0,1,1,-4,2,6,3,7,4,2,2,0,-3,1,4,0,3,2,-5,10,5,-2,0,0,1,-1,0,1,2,1
KR_6731314131,440,1,4,1,6,0,2,2,3,8,5,3,3,0,1,1,0,-1,1,2,0,0,-18,-3,6,3,-12,0,1,-1,1,1,1,6,1
KR_6695144518,420,1,-5,20,-1,-3,1,4,-3,2,5,3,4,1,-1,3,4,3,5,2,0,2,2,-2,5,3,-1,0,1,1,-1,-1,-1,3,1
KR_6761874898,440,8,52,16,17,2,2,0,5,7,2,3,3,0,5,7,2,2,2,0,1,13,0,0,4,4,-1,0,3,-1,1,1,1,5,1
KR_6639236045,420,4,31,48,1,-1,0,1,0,3,3,3,6,3,-1,4,5,0,2,2,0,-6,3,2,4,6,14,0,2,1,1,1,1,3,1
KR_6591551298,420,5,93,4,4,3,4,1,-2,2,4,3,4,1,1,2,1,-1,3,4,0,1,114,-5,10,5,5,0,1,0,1,1,-1,0,1
KR_6710195195,440,0,81,-4,-1,1,2,1,0,1,1,-2,0,2,-4,1,5,4,5,1,0,-2,-64,1,4,5,7,0,0,-1,1,1,1,3,1
KR_6763333550,420,0,22,-19,5,1,2,1,1,2,1,4,5,1,-2,2,4,1,4,3,0,2,-1,0,5,5,-3,0,-1,-1,-1,-1,-1,5,1
KR_6764345304,420,1,-5,-4,4,-1,1,2,5,6,1,1,3,2,-2,0,2,1,1,0,0,5,-8,1,3,4,-1,0,-2,1,-1,-1,1,5,1
KR_6716606290,420,3,90,-8,4,2,3,1,7,7,0,1,1,0,-4,1,5,-2,0,2,0,-1,328,-1,2,1,5,0,3,-1,1,1,-1,6,1
KR_6153747122,420,-3,45,-16,-1,-1,2,3,0,4,4,-2,0,2,1,1,0,1,1,0,0,-2,8,-4,9,5,4,0,-1,-1,1,-1,-1,5,1
KR_6744916011,420,5,27,45,11,0,2,2,6,7,1,1,2,1,4,4,0,0,0,0,0,9,43,0,3,3,-4,0,1,-1,1,1,1,2,1
KR_6750359991,420,3,107,9,3,3,3,0,-1,2,3,-2,0,2,2,3,1,1,1,0,0,5,7,4,1,5,-2,0,0,1,0,0,1,1,1
KR_6688822253,420,2,59,8,8,0,2,2,4,6,2,2,5,3,2,3,1,0,0,0,0,6,-21,1,2,3,0,0,1,1,1,1,1,2,1
KR_6729087523,420,6,49,39,16,2,2,0,1,5,4,6,8,2,1,2,1,6,7,1,3,18,138,3,3,6,0,0,2,-1,1,1,1,2,1
KR_6762322336,420,4,66,20,12,3,3,0,0,1,1,5,6,1,2,2,0,2,2,0,0,10,3,-1,5,4,5,0,2,1,1,1,1,3,1
KR_6579289916,420,3,-10,8,4,4,4,0,1,1,0,0,4,4,-1,2,3,0,2,2,0,-1,2,-1,8,7,-4,0,0,-1,0,0,-1,2,1
KR_6763736366,420,1,43,-18,-4,3,3,0,-2,2,4,-2,2,4,-1,3,4,-2,2,4,0,-8,13,0,3,3,1,0,1,1,1,1,-1,4,1
KR_6700107601,420,2,51,-9,6,-1,1,2,5,6,1,-1,1,2,2,2,0,1,1,0,0,10,0,5,3,8,4,0,1,1,0,1,-1,2,1
KR_6704560598,440,4,-2,32,9,-1,1,2,4,6,2,8,14,6,-2,0,2,0,0,0,0,11,15,1,5,6,-2,0,3,-1,1,1,-1,5,1
KR_6740202310,420,2,43,23,0,1,2,1,0,2,2,-5,1,6,3,4,1,1,2,1,0,-4,6,-3,6,3,2,0,1,0,0,1,-1,0,1
KR_6729069340,420,5,32,5,10,2,2,0,1,2,1,1,1,0,7,10,3,-1,0,1,-1,2,28,0,4,4,-1,0,0,1,1,1,-1,6,1
KR_6749725151,440,3,-8,4,13,7,7,0,-1,2,3,7,8,1,1,4,3,-1,0,1,0,11,1,1,6,7,3,0,0,1,0,0,1,2,1
KR_6596182770,420,1,12,12,3,-3,3,6,6,8,2,-1,2,3,0,3,3,1,1,0,0,6,15,9,2,11,-2,0,0,1,1,0,-1,3,1
KR_6658061796,420,3,81,17,6,2,2,0,-4,2,6,3,3,0,1,1,0,4,5,1,0,0,-6,3,2,5,-1,0,2,1,1,1,1,2,1
KR_6694077086,440,3,57,30,7,-2,1,3,2,5,3,2,4,2,4,7,3,1,1,0,2,13,-4,-3,7,4,3,0,2,0,-1,1,1,0,1
KR_6762736628,440,5,81,16,14,8,9,1,0,2,2,3,6,3,-1,2,3,4,6,2,0,12,7,6,3,9,4,0,2,-1,1,1,1,2,1
KR_6759951401,420,1,56,-10,4,5,6,1,-2,0,2,1,2,1,2,2,0,-2,0,2,0,0,-1,2,5,7,3,0,0,1,0,0,-1,6,1
KR_6664179560,420,1,18,-13,-1,1,1,0,2,4,2,-3,0,3,-2,2,4,1,3,2,-1,-2,8,8,4,12,-5,0,0,-1,-1,1,-1,2,1
KR_6741173252,420,0,61,8,1,-3,1,4,3,5,2,0,1,1,-2,0,2,3,3,0,0,-3,-19,-6,7,1,2,0,0,1,1,0,-1,1,1
KR_6757141531,420,0,-29,20,2,1,3,2,-3,0,3,4,6,2,0,1,1,0,0,0,0,-2,1,5,6,11,0,0,0,-1,1,0,1,2,1
KR_6761205709,420,1,48,-8,7,2,2,0,1,2,1,0,0,0,4,8,4,0,1,1,0,2,2,0,7,7,5,0,0,0,1,0,1,0,1
KR_6676945613,420,1,22,2,3,-1,2,3,1,1,0,0,0,0,3,4,1,0,2,2,0,6,9,4,3,7,-1,0,1,-1,1,1,-1,5,1
KR_6628958121,420,3,113,12,5,-1,2,3,-1,0,1,3,3,0,3,4,1,1,4,3,0,6,11,2,2,4,1,0,2,-1,1,1,1,4,1
KR_6755121478,420,4,28,-16,11,3,4,1,5,6,1,3,3,0,-2,4,6,2,4,2,0,10,17,1,2,3,-2,0,0,1,1,1,1,6,1
KR_6761204555,420,4,-67,16,13,0,3,3,5,5,0,6,7,1,3,6,3,-1,2,3,0,15,-3,1,4,5,-2,0,0,1,1,-1,1,4,1
KR_6698366801,420,4,55,0,11,3,3,0,4,4,0,4,5,1,0,2,2,0,1,1,0,1,2,3,2,5,3,0,1,1,1,1,1,1,1
KR_6638224121,440,3,51,8,2,0,1,1,4,5,1,-1,2,3,-2,1,3,1,1,0,0,2,2,0,6,6,-2,0,2,-1,1,1,-1,2,1
KR_6713778028,420,7,79,10,11,6,7,1,3,6,3,6,6,0,-4,1,5,0,1,1,1,3,-2,0,3,3,2,1,3,1,1,1,-1,1,1
KR_6714506705,420,5,-11,20,9,0,2,2,6,8,2,3,4,1,2,4,2,-2,1,3,0,10,-1,-3,9,6,3,0,2,1,1,1,1,5,1
KR_6749405983,420,5,60,-20,15,-1,2,3,7,9,2,-1,2,3,10,12,2,0,1,1,0,15,7,-3,7,4,4,0,1,0,1,1,-1,0,1
KR_6743472833,420,2,78,16,-2,-1,2,3,2,4,2,6,6,0,-5,1,6,-4,0,4,0,-1,30,5,0,5,0,0,1,0,1,1,1,0,1
KR_6751833906,420,6,112,-10,6,7,7,0,-1,1,2,1,4,3,0,4,4,-1,1,2,0,-1,-6,0,8,8,12,0,2,0,1,1,-1,0,1
KR_6745067056,440,-1,-55,3,-5,-1,4,5,1,1,0,2,3,1,-8,2,10,1,1,0,0,-6,113,-1,4,3,3,0,0,1,1,0,-1,6,1
KR_6704548152,440,2,26,16,11,5,5,0,-2,1,3,8,8,0,1,3,2,-1,2,3,0,6,2,5,1,6,-1,0,0,1,0,1,1,3,1
KR_6753976065,420,0,25,3,-1,3,3,0,-5,0,5,3,4,1,-3,3,6,1,1,0,0,-6,4,-6,9,3,2,0,0,1,1,0,-1,2,1
KR_6706578299,420,3,3,13,9,5,6,1,-4,3,7,2,4,2,6,6,0,0,1,1,0,10,9,1,4,5,-2,0,1,-1,1,1,-1,1,1
KR_6733013219,420,0,2,28,2,-2,1,3,3,3,0,3,3,0,-3,1,4,1,1,0,0,2,-2,-1,8,7,4,0,1,1,1,1,-1,1,1
KR_6748840794,420,3,110,9,7,3,4,1,1,4,3,0,3,3,2,5,3,1,2,1,0,4,-21,0,5,5,-5,0,2,-1,1,1,-1,6,1
KR_6747687524,440,1,52,34,12,-3,0,3,0,1,1,5,6,1,6,8,2,4,5,1,0,17,25,-1,7,6,5,0,1,1,1,1,1,6,1
KR_6750995728,440,1,-34,0,5,0,4,4,3,5,2,5,5,0,0,0,0,-3,0,3,0,4,27,-1,3,2,3,0,0,1,1,-1,1,3,1
KR_6702008548,420,0,-32,28,5,-3,2,5,0,4,4,7,7,0,0,2,2,1,1,0,0,2,8,2,1,3,-1,0,1,1,1,1,-1,5,1
KR_6717577128,420,1,-64,4,1,1,1,0,-3,1,4,3,3,0,-1,3,4,1,5,4,-1,9,2,-1,4,3,-2,0,0,1,-1,1,-1,1,1
KR_6728397265,440,2,86,8,3,-1,0,1,-2,2,4,3,5,2,0,3,3,3,3,0,1,-1,1,-3,6,3,6,0,1,1,1,1,1,6,1
KR_6641823584,420,12,109,59,16,4,4,0,8,9,1,3,3,0,2,4,2,-1,0,1,0,15,36,-5,7,2,1,0,4,1,1,1,1,5,1
KR_6757135072,420,3,7,0,10,2,3,1,0,2,2,4,4,0,3,3,0,1,1,0,0,8,3,5,2,7,1,0,0,1,0,1,1,4,1
KR_6658592354,440,4,76,28,8,4,5,1,0,2,2,3,5,2,1,4,3,0,1,1,1,3,-2,-2,7,5,-3,0,3,1,1,1,1,3,1
KR_6475101393,440,1,78,-8,7,-1,0,1,-1,4,5,4,7,3,1,4,3,4,4,0,1,11,10,1,5,6,-4,0,1,-1,-1,1,1,1,1
KR_6764052961,420,-1,-35,-24,-1,1,2,1,2,3,1,-7,1,8,4,5,1,-1,0,1,0,3,-48,4,2,6,15,0,-1,1,1,-1,-1,5,1
KR_6764402687,420,1,2,3,6,-2,1,3,1,2,1,1,2,1,6,6,0,0,1,1,0,16,-8,-3,7,4,3,0,0,-1,1,0,1,3,1
KR_6719394741,420,3,10,20,3,-1,1,2,1,7,6,1,2,1,2,6,4,0,1,1,0,0,116,2,3,5,3,0,1,1,1,1,-1,6,1
KR_6586552470,420,5,71,41,10,-1,2,3,6,6,0,4,5,1,0,3,3,1,4,3,0,8,1,-2,9,7,-2,0,0,1,1,0,1,4,1
KR_6522022627,420,3,59,18,3,-2,0,2,1,4,3,0,2,2,4,6,2,0,0,0,0,2,-44,-1,5,4,-8,0,1,1,1,1,-1,5,1
KR_6434019072,420,0,28,0,-2,-1,2,3,5,5,0,-3,1,4,-3,0,3,0,0,0,0,-1,4,2,4,6,-2,0,0,1,1,0,1,1,1
KR_6729326044,420,1,61,-3,6,2,2,0,0,3,3,1,5,4,1,4,3,2,2,0,1,3,343,-1,7,6,-1,0,2,-1,1,1,1,4,1
KR_6724521159,440,0,33,18,0,-2,1,3,5,5,0,-4,0,4,2,4,2,-1,0,1,0,4,-1,-4,7,3,2,0,0,1,-1,0,1,4,1
KR_6658161801,420,-2,-64,-4,-6,0,3,3,0,3,3,-4,0,4,-2,0,2,0,0,0,0,-8,3,3,3,6,-3,0,-1,1,1,1,-1,1,1
KR_6764144395,420,-2,-38,-16,-2,-1,0,1,-4,1,5,-2,1,3,4,6,2,1,3,2,0,-5,-2,-2,6,4,3,0,1,0,1,1,-1,0,1
KR_6630444994,420,5,51,-2,5,1,3,2,1,3,2,5,8,3,1,5,4,-3,0,3,-2,13,-8,4,4,8,1,0,0,-1,-1,1,-1,4,1
KR_6751838837,420,2,72,-12,5,0,1,1,0,5,5,0,1,1,4,6,2,1,3,2,0,6,7,0,4,4,0,0,0,1,1,0,1,1,1
KR_6703735676,420,1,4,-3,2,-3,3,6,-3,2,5,1,3,2,3,5,2,4,4,0,0,4,-10,-4,10,6,2,0,-1,1,-1,-1,-1,1,1
KR_6747214860,440,2,-45,10,3,-4,1,5,2,4,2,-1,3,4,6,6,0,0,0,0,-1,8,-13,-4,6,2,3,0,0,-1,0,0,-1,6,1
KR_6756244909,420,-2,-21,-1,-1,0,1,1,1,2,1,2,5,3,-5,4,9,1,1,0,0,-2,-34,-5,10,5,-1,0,-1,0,0,-1,1,0,1
KR_6724909608,420,4,65,17,12,2,2,0,1,4,3,6,6,0,4,8,4,-1,0,1,0,21,-6,-2,5,3,3,0,0,1,-1,0,1,3,1
KR_6627864042,440,3,72,15,9,-1,2,3,4,4,0,0,1,1,4,5,1,2,3,1,0,2,-17,-3,7,4,3,0,0,1,1,1,-1,3,1
KR_6750723344,420,2,41,0,4,4,4,0,0,2,2,1,5,4,-2,0,2,1,1,0,0,6,-32,-1,3,2,1,0,2,0,-1,1,-1,0,1
KR_6669161498,420,3,20,-8,6,2,3,1,0,5,5,0,0,0,3,5,2,1,1,0,0,9,-2,-1,5,4,4,0,0,-1,1,0,-1,3,1
KR_6752344426,420,1,12,-3,3,1,2,1,-1,5,6,2,4,2,3,6,3,-2,0,2,-2,-7,3,1,3,4,2,0,0,-1,1,0,-1,6,1
KR_6297638179,420,0,-11,-9,3,1,2,1,0,1,1,2,2,0,-1,2,3,1,3,2,0,7,-91,-2,4,2,2,0,-2,1,-1,-1,1,3,1
KR_6758220187,420,1,37,17,3,7,7,0,-5,0,5,-2,1,3,3,5,2,0,1,1,0,2,1,4,3,7,0,0,2,1,1,1,-1,5,1
KR_6750638700,420,0,28,-8,-5,3,3,0,-5,0,5,1,4,3,-3,1,4,-1,1,2,-1,-4,3,8,1,9,-1,0,-1,1,-1,-1,-1,5,1
KR_6763922562,420,1,47,-8,3,-1,2,3,3,5,2,-1,4,5,3,7,4,-1,0,1,0,7,122,-2,6,4,1,0,-1,-1,-1,-1,1,2,1
KR_6657177656,420,2,52,16,9,1,3,2,5,8,3,5,7,2,0,3,3,-2,0,2,0,3,-5,-2,8,6,4,0,1,0,1,1,1,0,1
KR_6758805451,420,3,31,19,9,3,4,1,-1,1,2,-4,1,5,9,12,3,2,3,1,0,9,-5,3,5,8,5,0,3,1,-1,1,1,4,1
KR_6761903274,440,0,22,-19,-9,-2,2,4,-4,2,6,2,2,0,-1,4,5,-4,0,4,0,-5,8,-3,6,3,5,0,1,1,-1,1,-1,1,1
KR_6745223363,420,-1,-23,4,2,-2,3,5,4,5,1,2,2,0,-3,1,4,1,1,0,-1,9,17,3,5,8,7,0,0,1,-1,1,-1,2,1
KR_6760824696,420,0,30,-1,9,2,2,0,5,5,0,2,3,1,0,4,4,0,1,1,0,2,-15,0,7,7,-2,0,0,1,1,0,1,6,1
KR_6764397066,420,0,-21,24,2,1,2,1,2,5,3,-4,0,4,3,5,2,0,0,0,0,5,11,-2,3,1,4,0,-1,1,-1,-1,1,2,1
KR_6724713932,440,1,76,-32,7,1,4,3,3,5,2,0,6,6,3,6,3,0,4,4,0,7,10,-2,5,3,1,0,1,1,1,1,1,5,1
KR_6752346513,420,3,-3,36,0,0,0,0,-3,2,5,-1,2,3,1,3,2,3,5,2,0,0,-261,0,3,3,9,0,1,1,-1,1,1,5,1
KR_6752611273,420,6,81,56,12,-1,1,2,4,7,3,5,5,0,1,1,0,3,3,0,0,17,26,-1,4,3,7,0,4,1,1,1,1,6,1
KR_6725204696,420,7,78,71,9,-1,0,1,0,2,2,1,2,1,10,12,2,-1,0,1,0,6,-322,1,4,5,8,0,1,1,1,1,1,5,1
KR_6688882720,420,2,25,14,2,-1,1,2,3,5,2,-3,1,4,2,3,1,1,1,0,0,2,9,4,2,6,0,0,0,1,-1,0,-1,5,1
KR_6715048349,420,0,-5,-4,4,1,2,1,1,1,0,1,3,2,1,3,2,0,0,0,0,3,4,-4,8,4,5,0,0,1,-1,0,1,4,1
KR_6761863771,420,7,120,-1,14,2,4,2,3,8,5,4,4,0,2,2,0,3,3,0,0,20,-1,-2,6,4,4,0,3,1,1,1,-1,2,1
KR_6520018486,420,2,41,31,8,1,4,3,2,3,1,3,6,3,3,8,5,-1,0,1,0,14,-12,4,3,7,-1,0,0,1,0,1,1,1,1
KR_6764226016,440,-1,-18,-19,3,4,4,0,-2,2,4,-2,0,2,2,3,1,1,3,2,0,7,-31,1,1,2,1,0,0,0,0,0,1,0,1
KR_6758806489,420,4,22,-8,15,0,5,5,1,1,0,8,8,0,3,3,0,3,3,0,0,11,1,3,3,6,0,0,3,1,1,1,-1,4,1
KR_6748470549,420,6,11,17,8,3,3,0,3,5,2,0,2,2,2,5,3,0,1,1,0,3,109,-7,12,5,6,0,1,-1,1,1,1,2,1
KR_6630318810,420,-1,-29,-15,-4,3,3,0,-4,1,5,4,7,3,-4,1,5,-3,0,3,0,-16,-9,1,5,6,0,0,1,1,1,1,1,2,1
KR_6752626294,420,4,66,-4,11,3,3,0,8,9,1,-2,3,5,2,2,0,0,1,1,0,14,1,2,4,6,1,0,0,1,-1,0,1,5,1
KR_6686164086,420,4,91,-5,8,-2,1,3,-2,0,2,4,4,0,7,7,0,1,2,1,0,2,15,1,4,5,9,0,0,1,0,1,1,4,1
KR_6754225393,440,0,54,-3,-7,0,3,3,-12,2,14,1,4,3,2,3,1,2,2,0,0,-9,-2,-1,4,3,2,0,0,0,1,1,1,0,1
KR_6730412456,420,0,-49,16,-7,4,4,0,-2,2,4,-4,1,5,-2,2,4,-3,0,3,0,-10,4,1,6,7,0,0,1,-1,-1,-1,-1,5,1
KR_6620031186,420,2,26,-4,5,-1,2,3,-2,1,3,2,4,2,6,6,0,0,1,1,0,2,-1,0,5,5,0,0,1,-1,-1,1,-1,3,1
KR_6653373268,420,4,116,-24,7,3,3,0,3,5,2,0,3,3,1,3,2,0,1,1,1,2,11,5,0,5,0,0,1,-1,-1,1,1,1,1
KR_6761801964,420,3,55,5,6,-1,0,1,7,7,0,-3,2,5,2,5,3,1,1,0,0,6,-15,-2,5,3,5,0,2,1,1,1,1,6,1
KR_6630407367,420,3,28,-4,5,7,7,0,2,5,3,-3,2,5,0,1,1,-1,1,2,0,3,14,2,5,7,2,0,1,1,1,1,-1,4,1
KR_6755614167,420,1,-3,18,-5,3,4,1,-2,1,3,-5,1,6,-2,3,5,1,2,1,0,-8,75,-4,7,3,-23,0,0,1,1,1,1,1,1
KR_6738483728,420,5,74,16,13,4,5,1,1,3,2,-1,1,2,6,8,2,3,3,0,0,2,8,-2,6,4,2,0,1,1,1,1,-1,2,1
KR_6399171173,420,5,108,25,9,-1,3,4,3,4,1,5,7,2,2,5,3,0,0,0,0,15,29,2,5,7,-9,0,2,1,-1,1,1,5,1
KR_6663630346,420,7,54,9,14,3,3,0,5,7,2,2,2,0,5,7,2,-1,0,1,0,13,8,-1,5,4,3,0,2,1,1,1,-1,2,1
KR_6616630482,420,0,-21,21,7,-2,0,2,1,3,2,6,9,3,2,3,1,0,0,0,-1,7,10,6,1,7,-1,0,1,1,-1,1,-1,5,1
KR_6759000797,440,5,95,0,15,3,4,1,3,4,1,5,5,0,4,5,1,0,1,1,0,14,-3,6,1,7,-2,0,1,1,1,1,1,5,1
KR_6747525852,420,1,-32,-7,7,5,5,0,0,6,6,1,1,0,0,4,4,1,1,0,1,5,-42,3,3,6,7,0,0,1,-1,0,1,4,1
KR_6737976592,440,2,-6,-24,4,0,2,2,-1,1,2,0,2,2,3,3,0,2,2,0,0,4,5,4,2,6,-4,0,0,0,1,-1,-1,0,1
KR_6637904372,420,3,90,-2,5,3,3,0,2,3,1,1,3,2,0,0,0,-1,0,1,0,6,11,1,3,4,4,0,2,1,-1,1,-1,5,1
KR_6545250081,420,3,-30,24,4,2,2,0,-4,2,6,3,4,1,0,1,1,3,3,0,0,6,5,4,6,10,-1,0,0,-1,1,0,1,6,1
KR_6750107141,440,-2,-87,4,-5,-2,1,3,-1,4,5,2,4,2,-2,1,3,-2,0,2,0,-6,177,-2,3,1,4,0,-1,1,-1,-1,1,3,1
KR_6666335679,420,2,60,25,4,0,1,1,1,2,1,-1,0,1,2,4,2,2,2,0,0,4,-6,5,2,7,1,0,1,1,1,1,1,5,1
KR_6710282582,440,0,41,-4,-10,2,3,1,0,2,2,0,2,2,-8,1,9,-4,0,4,-1,-17,-45,-1,7,6,0,0,2,-1,1,1,-1,1,1
KR_6689693858,440,1,61,-7,9,-1,1,2,3,4,1,0,2,2,2,3,1,5,7,2,2,16,42,1,5,6,4,0,1,1,1,1,1,1,1
KR_6738690310,420,0,34,-8,1,1,1,0,0,3,3,0,3,3,1,2,1,-1,1,2,0,0,-36,-2,3,1,16,0,2,0,1,1,1,0,1
KR_6750375619,420,0,-30,20,-1,-5,0,5,0,2,2,1,4,3,4,5,1,-1,0,1,0,0,57,-1,4,3,2,0,-1,-1,-1,-1,1,1,1
KR_6759935276,440,-1,17,24,2,-3,3,6,1,2,1,0,0,0,4,4,0,0,1,1,0,5,7,-2,3,1,1,0,0,1,1,0,1,5,1
KR_6700714918,420,1,43,4,1,1,2,1,-1,5,6,2,4,2,-1,1,2,0,1,1,-1,-5,7,6,2,8,3,0,1,-1,1,1,-1,4,1
KR_6735235958,420,-2,52,-12,-4,-1,1,2,-4,1,5,-1,1,2,1,3,2,1,2,1,0,-1,3,2,4,6,-1,0,-1,0,-1,-1,1,0,1
KR_6373574200,440,0,-24,9,-4,-2,1,3,3,5,2,0,0,0,-1,0,1,-4,0,4,0,1,0,0,0,0,-3,0,0,-1,1,0,1,2,1
KR_6648248313,420,2,6,9,8,1,3,2,1,3,2,6,7,1,0,0,0,0,0,0,0,11,101,-2,5,3,4,0,1,1,1,1,-1,1,1
KR_6735876397,420,0,18,16,-2,-1,1,2,-3,1,4,5,5,0,-4,1,5,1,1,0,-1,-8,-202,3,5,8,-4,0,0,1,-1,0,-1,1,1
KR_6757237566,420,0,-34,7,0,-4,0,4,1,4,3,5,5,0,-3,0,3,1,1,0,0,5,3,1,3,4,-2,0,-1,1,-1,-1,-1,2,1
KR_6739495572,420,0,-55,-40,2,-1,0,1,6,7,1,0,1,1,0,3,3,-3,0,3,1,-2,-17,-4,6,2,4,0,0,1,-1,-1,1,1,1
KR_6681465451,420,0,24,4,2,3,3,0,1,1,0,5,5,0,-5,3,8,-2,0,2,1,7,-47,4,2,6,0,0,0,1,-1,-1,1,1,1
KR_6737913325,420,2,60,14,0,3,4,1,-5,1,6,3,4,1,0,4,4,-1,0,1,0,-2,6,-5,8,3,7,0,1,1,1,1,1,6,1
KR_6682866006,420,4,80,1,0,2,3,1,0,1,1,0,0,0,0,0,0,-2,0,2,0,-1,3,4,2,6,4,0,0,-1,1,1,-1,6,1
KR_6747754760,440,3,58,0,8,3,3,0,1,2,1,1,1,0,-1,1,2,4,5,1,0,7,-1,-5,8,3,3,0,0,1,0,1,-1,2,1
KR_6730777586,420,-1,22,-2,-1,5,6,1,-2,2,4,0,2,2,-3,0,3,-1,1,2,0,-3,-6,4,3,7,-4,0,0,0,1,0,1,0,1
KR_6497821997,420,-1,-21,-3,-5,3,5,2,-5,2,7,0,2,2,-3,1,4,0,0,0,0,-14,-1,-6,8,2,-1,0,-1,1,-1,1,1,5,1
KR_6705833501,420,0,49,12,-1,5,5,0,0,3,3,-1,1,2,-2,1,3,-3,0,3,0,-12,-44,-6,9,3,1,0,0,0,-1,1,-1,0,1
KR_6686870034,420,5,59,16,11,2,4,2,2,3,1,-3,1,4,8,9,1,2,2,0,0,11,-64,-5,8,3,-18,0,0,1,1,0,1,6,1
KR_6758180311,420,4,3,0,12,3,4,1,-1,1,2,-1,2,3,7,8,1,4,4,0,0,10,-1,-2,3,1,3,0,0,1,-1,1,1,2,1
KR_6678589191,420,2,14,20,9,9,9,0,-2,0,2,3,5,2,-1,1,2,0,0,0,1,-1,-20,3,3,6,-2,0,1,1,1,1,1,6,1
KR_6646533548,420,-1,-15,21,-6,-1,0,1,2,2,0,2,3,1,-3,1,4,-6,0,6,-1,-8,103,-2,7,5,-1,0,1,-1,1,1,-1,4,1
KR_6742983084,420,0,-40,-8,7,-1,0,1,1,3,2,-2,2,4,8,8,0,1,2,1,-1,13,1,3,1,4,-1,0,0,1,0,1,-1,1,1
KR_6756262045,420,2,37,6,-3,0,1,1,1,4,3,-2,2,4,-2,1,3,0,1,1,0,-1,-4,0,7,7,1,0,0,0,-1,-1,1,0,1
KR_6757560460,440,5,61,5,12,2,3,1,4,5,1,5,7,2,1,7,6,0,0,0,2,20,-1,-5,7,2,2,0,2,1,-1,1,1,6,1
KR_6761250080,420,2,53,-5,7,1,2,1,0,3,3,2,3,1,4,5,1,0,1,1,0,8,-1,-5,5,0,-1,0,1,1,1,1,1,5,1
KR_6292866720,420,-3,22,-4,-1,0,2,2,1,6,5,0,3,3,0,4,4,-2,4,6,0,-4,-20,-4,6,2,2,0,0,1,-1,0,1,1,1
KR_6736922080,420,2,67,31,4,1,2,1,4,5,1,0,3,3,-2,1,3,1,2,1,0,3,30,0,6,6,-2,0,1,1,1,1,-1,4,1
KR_6755252717,440,9,51,-4,10,1,3,2,8,9,1,-1,1,2,1,1,0,1,1,0,0,16,-7,2,2,4,1,0,1,1,-1,1,-1,6,1
KR_6764147531,420,4,93,10,9,6,7,1,-2,2,4,2,4,2,2,2,0,1,2,1,0,12,51,-2,8,6,-23,0,2,1,-1,1,-1,4,1
KR_6722606854,420,7,76,34,14,6,6,0,1,3,2,6,8,2,2,4,2,-1,0,1,1,7,-7,-4,6,2,-1,0,3,1,1,1,1,2,1
KR_6753906183,420,1,94,-17,2,1,1,0,5,5,0,1,3,2,-5,0,5,0,0,0,0,-4,13,-2,8,6,2,0,1,-1,-1,1,1,2,1
KR_6707623994,420,1,-28,8,9,-2,0,2,3,3,0,3,3,0,4,6,2,1,2,1,0,12,-32,4,5,9,5,0,0,0,0,0,1,0,1
KR_6761742966,420,3,81,13,1,0,2,2,-1,0,1,0,6,6,2,4,2,0,2,2,0,-4,19,-1,6,5,1,0,2,1,-1,1,1,4,1
KR_6753862167,420,-1,6,18,4,-1,0,1,1,4,3,1,5,4,3,5,2,0,0,0,0,2,7,0,6,6,1,0,1,-1,1,1,1,5,1
KR_6628823525,420,8,56,0,15,3,3,0,4,5,1,1,2,1,4,4,0,3,4,1,1,16,0,1,2,3,4,0,0,1,1,1,1,4,1
KR_6758185370,420,3,39,8,11,1,4,3,8,8,0,-2,2,4,5,7,2,-1,0,1,-3,10,8,1,4,5,-1,0,3,1,-1,1,-1,6,1
KR_6740507277,420,4,79,8,6,0,4,4,-5,4,9,7,8,1,4,6,2,0,2,2,2,3,-9,-3,6,3,6,0,0,-1,1,1,1,2,1
KR_6762063086,420,4,61,-16,12,-1,3,4,2,4,2,4,4,0,7,7,0,0,0,0,0,11,27,4,3,7,1,0,2,1,1,1,1,6,1
KR_6756586346,420,4,60,10,2,-1,1,2,1,5,4,1,2,1,3,4,1,-2,0,2,0,3,2,0,4,4,2,0,2,1,1,1,1,5,1
KR_6596989525,420,0,17,20,-4,3,4,1,-4,4,8,2,5,3,-2,0,2,-3,0,3,0,-4,-7,3,4,7,-6,0,0,-1,1,1,-1,5,1
KR_6747105317,420,1,71,23,7,-1,0,1,2,2,0,6,6,0,0,0,0,0,0,0,0,6,8,2,4,6,2,0,0,1,1,0,1,6,1
KR_6678878078,420,4,-40,8,5,0,1,1,3,6,3,4,4,0,0,1,1,-2,0,2,0,3,1,2,3,5,-2,0,-1,0,-1,-1,1,0,1
KR_6737883380,420,6,43,28,8,4,4,0,1,1,0,0,3,3,4,6,2,-1,1,2,-1,0,8,3,2,5,1,0,0,1,1,1,-1,5,1
KR_6700437694,420,2,3,-3,9,4,5,1,2,5,3,0,1,1,2,5,3,1,1,0,0,4,-7,4,2,6,1,0,0,1,1,1,1,4,1
KR_6609359686,420,0,44,-11,-1,0,1,1,-1,0,1,0,1,1,0,2,2,0,0,0,1,-2,-43,-1,8,7,31,0,1,1,-1,1,1,1,1
KR_6615611516,420,-3,-15,16,-7,2,3,1,-2,5,7,-4,0,4,-3,3,6,0,4,4,1,0,-11,-4,9,5,1,0,-3,-1,1,-1,1,6,1
KR_6752434893,420,1,-38,4,11,1,1,0,3,5,2,5,6,1,3,3,0,-1,1,2,0,13,3,4,4,8,-3,0,0,1,1,0,-1,5,1
KR_6658377949,420,3,68,1,5,2,2,0,2,3,1,1,2,1,0,7,7,0,0,0,-1,6,-5,-6,8,2,1,0,0,1,1,0,-1,4,1
KR_6726195049,440,1,-44,-16,4,3,6,3,1,1,0,0,0,0,1,3,2,-1,0,1,0,6,-26,-2,3,1,38,0,0,1,0,0,1,5,1
KR_6630235982,420,2,19,-23,7,2,2,0,-1,2,3,3,3,0,2,5,3,1,1,0,0,7,-176,0,5,5,-1,0,0,1,-1,1,1,5,1
KR_6719238205,420,3,129,7,4,1,1,0,2,3,1,1,3,2,0,3,3,0,1,1,0,0,6,-3,8,5,4,0,2,-1,1,1,1,6,1
KR_6733416243,440,3,101,12,0,-1,3,4,-1,2,3,2,4,2,0,0,0,0,0,0,0,2,-6,-1,4,3,0,0,1,-1,1,1,-1,6,1
KR_6756476637,440,3,70,16,3,-4,1,5,0,4,4,12,13,1,-6,3,9,1,2,1,0,8,-7,-3,5,2,4,0,1,-1,1,1,-1,4,1
KR_6660012734,440,-5,-84,-40,-7,1,4,3,0,0,0,-4,1,5,-1,3,4,-3,3,6,0,-5,-5,0,4,4,3,0,-2,-1,0,-1,-1,3,1
KR_6760890092,440,1,-23,8,3,1,2,1,-2,7,9,1,2,1,4,6,2,-1,1,2,0,8,-8,-3,8,5,0,0,1,0,0,1,1,0,1
KR_6678115039,420,4,24,-4,5,-1,3,4,2,5,3,1,4,3,1,2,1,2,2,0,0,2,-2,2,2,4,4,0,0,1,-1,1,-1,1,1
KR_6744897131,420,-1,-49,12,5,0,2,2,4,5,1,-1,1,2,0,2,2,2,2,0,1,11,-3,1,3,4,2,0,1,1,1,1,1,4,1
KR_6680967200,420,7,92,15,14,1,3,2,1,3,2,7,7,0,4,5,1,1,3,2,0,3,-114,1,8,9,6,0,3,1,1,1,1,3,1
KR_6704494507,440,1,85,-7,8,2,3,1,2,4,2,1,4,3,2,3,1,1,3,2,0,-3,2,4,1,5,0,0,1,0,1,1,1,0,1
KR_6740543218,440,0,-10,-16,1,-4,1,5,-1,1,2,1,1,0,3,3,0,2,2,0,0,6,-5,0,6,6,3,0,0,0,1,0,1,0,1
KR_6761960242,420,4,19,28,13,-2,2,4,7,8,1,0,1,1,4,4,0,4,4,0,0,18,45,1,2,3,1,0,4,1,1,1,1,2,1
KR_6674013923,420,2,30,37,5,0,1,1,3,5,2,2,2,0,0,3,3,0,1,1,0,1,8,3,4,7,1,0,1,1,1,1,1,6,1
KR_6608074490,420,0,-11,-30,-4,-6,0,6,-3,1,4,1,2,1,3,5,2,1,1,0,0,-6,319,0,6,6,0,0,0,1,-1,-1,-1,5,1
KR_6744177414,420,-1,11,0,-2,1,2,1,0,0,0,-4,1,5,-2,1,3,3,6,3,0,1,-6,-4,7,3,1,0,2,-1,-1,1,-1,2,1
KR_6748962699,420,3,37,4,10,0,1,1,2,3,1,3,4,1,5,6,1,0,0,0,0,11,-187,3,3,6,3,0,1,1,1,1,1,2,1
KR_6715545904,420,3,34,-19,2,2,3,1,1,2,1,0,4,4,0,3,3,-1,0,1,2,0,29,1,4,5,-20,0,1,1,-1,1,1,1,1
KR_6754686933,420,4,18,24,3,-3,0,3,4,4,0,4,4,0,-3,1,4,1,1,0,0,7,-12,0,6,6,7,0,0,1,1,0,1,4,1
KR_6762358975,420,-1,-7,9,-7,-2,3,5,0,4,4,1,4,3,-6,0,6,0,2,2,-1,-5,1,4,4,8,1,0,0,1,1,0,-1,4,1
KR_6761534035,420,3,-1,52,-1,-2,1,3,0,0,0,4,4,0,-3,0,3,0,1,1,0,0,11,-1,3,2,0,0,0,1,1,1,-1,3,1
KR_6724856273,420,4,25,-4,21,1,2,1,6,6,0,3,5,2,12,12,0,-1,1,2,0,25,2,4,3,7,0,0,2,1,1,1,1,2,1
KR_6764615465,420,-2,69,-52,-8,3,4,1,-1,1,2,-2,0,2,-2,1,3,-6,1,7,0,-7,4,5,2,7,-3,0,0,-1,1,-1,1,4,1
KR_6743625754,420,7,67,5,14,2,4,2,4,8,4,1,2,1,8,8,0,-1,0,1,0,17,2,-1,3,2,3,0,1,1,-1,1,-1,2,1
KR_6733649375,420,5,106,31,5,3,3,0,-4,1,5,-1,4,5,8,8,0,-1,1,2,3,-1,-13,-2,6,4,-2,0,3,1,1,1,1,3,1
KR_6759267390,440,4,65,11,4,0,4,4,0,0,0,5,7,2,-1,0,1,0,0,0,-1,2,6,1,3,4,-2,0,1,1,1,1,-1,5,1
KR_6694336085,440,4,16,30,4,-2,2,4,3,6,3,1,2,1,4,5,1,-2,3,5,-1,3,0,-1,4,3,-1,0,0,1,-1,-1,-1,6,1
KR_6760491906,420,3,35,-6,4,6,6,0,0,5,5,1,3,2,0,2,2,-3,1,4,0,7,9,0,4,4,-3,0,1,0,-1,1,-1,0,1
KR_6728364173,420,0,-35,-14,3,4,4,0,0,1,1,-1,2,3,0,3,3,0,0,0,0,2,-18,-2,6,4,2,0,0,-1,1,1,1,5,1
KR_6604759675,420,1,34,-40,7,4,6,2,-5,1,6,0,0,0,4,4,0,4,4,0,0,6,9,3,2,5,-2,0,2,0,1,1,1,0,1
KR_6737180817,420,3,30,35,3,3,3,0,0,3,3,2,3,1,-2,1,3,0,0,0,0,-5,1,-3,8,5,-2,0,1,1,1,1,-1,3,1
KR_6762265548,420,-1,-21,30,-1,0,4,4,-1,3,4,2,4,2,-3,6,9,1,2,1,0,1,-4,1,5,6,1,0,-1,1,1,-1,1,5,1
KR_6712662389,420,3,40,8,2,-2,0,2,-2,2,4,3,4,1,1,1,0,2,2,0,0,-1,-18,3,2,5,1,0,1,-1,1,1,1,2,1
KR_6668896199,420,3,19,36,10,6,6,0,2,4,2,4,10,6,-4,0,4,2,2,0,0,-2,16,5,3,8,-3,0,1,1,1,1,1,2,1
KR_6755484759,420,3,18,-6,2,2,2,0,1,3,2,3,3,0,0,1,1,-4,1,5,0,2,2,0,6,6,0,0,0,-1,-1,0,-1,3,1
KR_6686777244,420,0,-48,24,-5,-3,0,3,-2,1,3,2,5,3,-3,2,5,1,2,1,0,1,12,-1,4,3,3,0,0,0,1,-1,-1,0,1
KR_6642847651,420,-1,13,11,-3,-1,1,2,0,1,1,1,5,4,-2,0,2,-1,2,3,0,2,12,0,4,4,-4,0,0,1,1,0,-1,3,1
KR_6680750681,420,3,85,15,3,1,3,2,4,6,2,-5,1,6,3,4,1,0,0,0,0,7,-1,2,4,6,0,0,1,1,-1,1,1,3,1
KR_6741998879,420,-3,-10,-17,2,3,5,2,-1,1,2,-1,2,3,1,2,1,0,0,0,0,6,48,-1,4,3,-20,0,0,-1,-1,-1,1,2,1
KR_6563027496,420,5,64,36,10,6,7,1,1,4,3,1,1,0,2,3,1,0,0,0,0,7,8,1,4,5,4,0,2,1,1,1,-1,1,1
KR_6756361085,420,5,-1,31,8,0,2,2,-1,1,2,6,6,0,2,3,1,1,2,1,0,7,119,-3,5,2,-2,0,1,1,1,1,1,4,1
KR_6739550218,440,1,32,18,2,-1,2,3,0,3,3,0,5,5,1,4,3,2,2,0,0,3,-21,4,1,5,-1,0,1,0,1,1,1,0,1
KR_6764522321,420,0,45,-27,3,2,2,0,1,1,0,1,2,1,-1,1,2,0,0,0,1,2,44,-2,6,4,-24,0,0,0,-1,1,1,0,1
KR_6761343727,420,4,38,28,10,-2,1,3,5,6,1,1,2,1,5,5,0,1,1,0,0,15,1,2,4,6,-2,0,0,1,-1,1,1,2,1
KR_6763391594,420,-3,23,7,-6,1,5,4,-3,3,6,1,3,2,-6,0,6,1,2,1,0,-13,-2,1,4,5,3,0,0,-1,-1,1,1,5,1
KR_6684497621,420,-1,0,-1,3,-1,4,5,9,12,3,0,3,3,-3,0,3,-2,0,2,1,14,3,1,4,5,-2,0,1,-1,1,1,1,5,1
KR_6593961529,440,-1,9,4,0,0,3,3,-4,0,4,3,3,0,1,3,2,0,1,1,0,2,-8,-1,7,6,5,0,0,1,-1,0,1,5,1
KR_6728599321,420,1,-24,-23,9,2,3,1,7,8,1,-1,1,2,2,2,0,-1,0,1,0,9,-9,5,3,8,8,0,1,-1,-1,1,1,5,1
KR_6691107427,420,1,3,14,9,3,4,1,7,7,0,-2,2,4,1,2,1,0,0,0,0,9,29,5,2,7,0,0,2,1,1,1,1,4,1
KR_6576416043,420,0,43,-14,6,0,3,3,-4,3,7,8,12,4,3,4,1,-1,1,2,-1,-5,-1,-2,4,2,0,0,1,-1,1,1,-1,5,1
KR_6660491983,420,5,26,17,11,0,0,0,4,4,0,2,3,1,2,5,3,3,3,0,0,14,-2,1,3,4,2,0,0,1,-1,0,-1,4,1
KR_6712198192,420,2,-6,15,1,3,5,2,-1,2,3,1,1,0,-2,0,2,0,1,1,1,3,2,-1,6,5,-1,0,0,1,-1,0,1,5,1
KR_6703750611,420,-3,-51,-3,-2,-3,3,6,-1,2,3,-2,1,3,3,4,1,1,2,1,0,-2,2,2,2,4,-5,0,0,-1,-1,-1,1,5,1
KR_6657710136,420,6,87,70,18,6,7,1,1,3,2,6,6,0,5,5,0,0,1,1,3,24,7,6,0,6,2,0,3,1,1,1,-1,2,1
KR_6628748475,420,3,84,-3,10,-4,0,4,1,2,1,3,3,0,8,10,2,2,2,0,0,13,2,-1,9,8,4,0,1,-1,-1,1,-1,4,1
KR_6752604470,420,2,34,5,12,0,3,3,2,4,2,3,3,0,5,6,1,2,2,0,1,11,0,-1,6,5,-8,0,1,-1,-1,1,1,4,1
KR_6714635769,420,4,68,8,18,3,4,1,1,3,2,7,9,2,7,8,1,0,1,1,0,9,-38,4,1,5,15,0,0,0,1,1,1,0,1
KR_6752571576,420,1,75,14,5,2,2,0,1,2,1,0,2,2,1,2,1,1,2,1,0,6,40,-1,7,6,3,0,0,1,1,0,-1,2,1
KR_6711166005,420,8,97,67,26,3,3,0,3,6,3,14,16,2,5,8,3,1,1,0,0,16,-46,-3,6,3,6,0,2,1,1,1,1,1,1
KR_6740872938,440,6,26,27,7,-2,0,2,3,3,0,1,2,1,8,8,0,-3,1,4,0,10,2,1,7,8,10,0,2,-1,-1,1,-1,1,1
KR_6663070996,420,0,-6,4,-3,-3,0,3,1,3,2,-3,2,5,0,1,1,2,2,0,0,2,4,0,6,6,2,0,0,1,-1,1,-1,1,1
KR_6751983006,440,4,41,28,6,1,4,3,1,1,0,4,4,0,1,1,0,-1,1,2,0,9,-3,-5,11,6,5,0,3,1,0,1,1,4,1
KR_6761199015,420,2,26,14,-1,-2,0,2,-3,0,3,1,2,1,3,3,0,0,0,0,0,-3,-7,0,3,3,-2,0,0,1,-1,1,-1,1,1
KR_6759318969,420,4,73,12,6,0,0,0,0,4,4,0,5,5,0,2,2,6,6,0,0,5,-221,-6,6,0,6,0,2,-1,0,1,1,4,1
KR_6627435755,420,1,46,-8,3,1,2,1,1,3,2,-1,0,1,2,4,2,0,2,2,0,0,-103,-5,6,1,-1,0,0,-1,1,1,1,6,1
KR_6557005927,420,0,24,-14,4,0,3,3,3,4,1,-1,3,4,1,2,1,1,2,1,0,6,7,2,7,9,-2,0,1,1,1,1,-1,6,1
KR_6672063813,420,5,47,14,8,4,4,0,-1,1,2,-1,3,4,3,3,0,3,3,0,1,2,-4,-2,5,3,3,0,2,-1,1,1,1,1,1
KR_6750774467,420,2,14,0,10,4,5,1,-1,3,4,0,2,2,7,7,0,0,0,0,0,5,-4,1,6,7,1,0,1,1,-1,1,-1,6,1
KR_6622873911,420,1,2,19,2,-1,1,2,0,1,1,-1,2,3,3,7,4,1,1,0,0,5,-34,-1,6,5,6,0,1,1,1,1,-1,6,1
KR_6756060067,420,5,82,62,5,-1,1,2,1,2,1,1,2,1,3,6,3,1,2,1,0,5,-7,-2,7,5,1,0,2,1,1,1,-1,6,1
KR_6694886914,420,3,16,7,5,0,3,3,1,2,1,1,2,1,2,3,1,1,1,0,0,6,-3,-1,5,4,2,0,1,1,1,1,1,4,1
KR_6741785531,440,1,-13,-14,1,5,5,0,2,2,0,-3,1,4,0,1,1,-3,1,4,0,3,-139,0,4,4,2,0,1,-1,1,1,-1,4,1
KR_6742098412,420,0,-40,-12,7,2,2,0,-1,2,3,2,2,0,5,5,0,-1,0,1,0,9,-1,-1,6,5,-4,0,-1,-1,-1,-1,1,4,1
KR_6714558398,420,1,73,16,2,-3,1,4,-3,1,4,1,4,3,5,7,2,2,2,0,0,4,1,-1,3,2,2,0,0,1,-1,-1,1,4,1
KR_6751144417,440,0,19,-16,2,-4,0,4,4,5,1,2,5,3,4,9,5,-4,0,4,0,5,-11,2,2,4,1,0,-1,1,-1,-1,1,1,1
KR_6758036214,420,0,19,-4,1,5,5,0,1,2,1,2,2,0,-6,0,6,-1,0,1,0,-6,2,7,2,9,5,0,-1,-1,1,-1,1,6,1
KR_6560063381,420,3,79,11,8,-1,3,4,6,6,0,-1,1,2,3,6,3,1,1,0,0,5,-27,-1,5,4,0,0,0,-1,1,1,1,3,1
KR_6720212354,420,0,10,-12,-4,3,4,1,0,3,3,-4,0,4,-1,1,2,-2,0,2,0,-11,12,3,3,6,-4,0,-1,1,-1,-1,1,1,1
KR_6724836100,420,0,16,27,-4,3,4,1,0,5,5,-4,3,7,-1,1,2,-2,1,3,0,-3,2,1,4,5,-3,0,1,1,-1,1,-1,1,1
KR_6754233281,420,0,-29,-7,-6,0,2,2,3,5,2,0,2,2,-6,3,9,-3,1,4,0,-12,47,0,4,4,-19,0,1,1,0,1,-1,1,1
KR_6751787317,420,2,6,13,7,1,2,1,5,6,1,1,1,0,0,0,0,0,0,0,0,8,-13,0,4,4,5,0,0,1,1,0,1,3,1
KR_6388012763,440,-5,-111,-7,-3,5,9,4,1,2,1,-3,2,5,0,2,2,-6,0,6,0,7,-2,2,4,6,-3,0,-2,0,1,-1,-1,0,1
KR_6714521609,420,5,54,41,8,3,4,1,0,1,1,3,8,5,0,3,3,2,3,1,0,3,-2,-6,7,1,0,0,1,1,1,1,1,6,1
KR_6763779266,420,1,-8,7,-10,-1,1,2,0,2,2,-2,0,2,-4,0,4,-3,1,4,0,-6,-470,0,4,4,-2,0,-1,-1,-1,-1,-1,2,1
KR_6627170287,420,0,-59,12,1,-1,4,5,3,4,1,3,3,0,-3,0,3,-1,0,1,0,2,-7,0,4,4,0,0,0,-1,1,1,-1,6,1
KR_6666028441,420,8,104,21,17,4,4,0,2,3,1,4,5,1,6,7,1,1,1,0,2,19,4,7,1,8,4,0,3,1,1,1,1,6,1
KR_6743216550,420,-1,33,0,-6,0,3,3,-8,1,9,-1,2,3,1,4,3,2,2,0,-1,-8,-30,-4,6,2,-1,0,0,-1,0,1,-1,1,1
KR_6494412049,420,1,-16,14,-1,-1,2,3,1,6,5,0,1,1,1,3,2,-2,3,5,-1,-3,-17,1,5,6,-5,0,0,-1,1,0,-1,4,1
KR_6724925303,420,1,-22,12,4,-2,2,4,1,5,4,0,3,3,2,5,3,3,3,0,-1,-3,-1,0,4,4,3,0,-1,1,-1,-1,-1,1,1
KR_6761954669,420,3,-6,32,-1,-4,0,4,-1,2,3,1,2,1,1,2,1,2,2,0,0,4,19,-7,8,1,8,0,1,-1,-1,1,-1,1,1
KR_6713133198,420,2,-15,21,12,-1,0,1,5,5,0,5,6,1,3,4,1,0,3,3,1,14,11,2,0,2,-2,0,-1,-1,1,-1,1,5,1
KR_6606620441,420,-2,-13,15,-5,1,1,0,0,2,2,-3,0,3,-7,1,8,4,4,0,-1,1,-38,-4,5,1,1,0,-1,-1,1,1,-1,3,1
KR_6761510174,420,-1,50,4,5,3,5,2,2,3,1,-2,3,5,3,3,0,-1,0,1,1,7,-4,2,4,6,2,0,0,1,-1,0,1,5,1
KR_6723683388,420,-4,-47,-5,-7,0,0,0,-2,2,4,-2,2,4,0,4,4,-3,0,3,1,-3,-7,-3,5,2,-2,0,-2,-1,1,-1,1,1,1
KR_6705668419,420,1,-7,0,3,0,2,2,1,4,3,1,3,2,-2,3,5,3,3,0,-1,7,36,1,4,5,-4,0,1,1,1,1,-1,1,1
KR_6761465151,420,3,22,-5,10,3,5,2,0,2,2,2,5,3,6,9,3,-1,0,1,1,11,2,0,7,7,2,0,1,1,0,1,1,4,1
KR_6753047460,420,1,50,4,2,0,2,2,-2,0,2,3,4,1,1,4,3,0,0,0,-1,0,52,-7,10,3,0,0,1,1,-1,1,-1,4,1
KR_6761757799,420,3,7,8,-3,-1,2,3,-1,2,3,-2,2,4,0,5,5,1,1,0,-1,1,-4,-1,2,1,0,0,0,-1,1,-1,-1,4,1
KR_6730568537,420,1,8,19,1,0,1,1,0,2,2,-1,1,2,2,3,1,0,0,0,0,4,-7,-4,7,3,5,0,0,-1,-1,0,1,1,1
KR_6756276157,420,1,23,20,2,-1,3,4,3,4,1,-6,1,7,3,3,0,3,6,3,0,2,114,-3,7,4,1,0,0,0,1,-1,-1,0,1
KR_6696732802,420,7,62,26,11,2,3,1,4,6,2,4,6,2,1,1,0,0,1,1,0,12,-32,-6,7,1,2,0,1,1,1,1,-1,2,1
KR_6730376244,440,5,35,48,11,1,1,0,0,1,1,2,3,1,5,9,4,3,4,1,0,11,4,3,4,7,-2,0,3,1,1,1,1,5,1
KR_6602365026,420,-1,23,-16,2,-2,0,2,0,2,2,2,3,1,1,1,0,1,2,1,0,3,35,-4,8,4,-23,0,-1,-1,-1,-1,1,1,1
KR_6730395081,420,1,33,8,0,2,2,0,1,2,1,-3,3,6,0,0,0,0,2,2,0,5,11,3,4,7,-1,0,2,1,1,1,-1,1,1
KR_6763349641,420,4,10,4,6,4,4,0,-1,2,3,-3,1,4,5,7,2,1,1,0,1,10,-87,0,4,4,-1,0,1,1,1,1,1,4,1
KR_6640966229,420,-1,18,4,0,1,1,0,3,6,3,1,3,2,-3,1,4,-2,2,4,2,5,21,3,4,7,1,0,0,0,1,1,1,0,1
KR_6606648556,420,1,17,32,2,-1,1,2,-2,1,3,-1,4,5,7,8,1,-1,0,1,0,1,25,3,2,5,-16,0,0,1,0,1,1,2,1
KR_6748972989,440,-1,-3,24,0,4,5,1,2,2,0,-2,1,3,-2,3,5,-2,0,2,0,-5,-6,4,4,8,0,0,1,-1,1,1,-1,2,1
KR_6758793186,420,3,47,-12,9,3,5,2,0,1,1,6,7,1,0,0,0,0,4,4,1,5,-2,-1,4,3,-2,0,0,1,0,1,1,5,1
KR_6633328490,420,-1,-5,20,2,4,5,1,0,3,3,2,3,1,-4,3,7,0,0,0,1,-7,5,-1,4,3,-5,0,-1,1,1,1,1,3,1
KR_6688205199,420,4,19,21,2,1,3,2,5,6,1,-8,3,11,4,5,1,0,2,2,0,4,4,0,5,5,-1,0,1,-1,1,1,1,4,1
KR_6735932802,420,1,19,8,8,1,4,3,-1,3,4,7,8,1,1,2,1,0,0,0,0,5,0,1,1,2,0,0,0,0,0,-1,1,0,1
KR_6708928725,440,3,7,24,7,2,3,1,2,3,1,1,3,2,1,3,2,1,1,0,1,7,16,0,0,0,1,0,3,1,1,1,1,4,1
KR_6728063329,420,2,2,-4,-3,1,4,3,2,4,2,1,2,1,-5,1,6,-2,0,2,0,-8,2,-2,5,3,0,0,1,-1,1,1,-1,4,1
KR_6632472604,420,1,-3,-8,8,3,5,2,-1,2,3,-2,2,4,8,9,1,0,2,2,0,11,-3,0,6,6,6,0,3,1,1,1,1,6,1
KR_6760192676,420,-1,-36,-12,-6,4,5,1,2,3,1,-7,0,7,-4,0,4,-1,2,3,-1,-5,-26,7,1,8,-7,0,0,0,1,1,-1,0,1
KR_6759776876,420,1,10,-20,6,1,3,2,0,1,1,0,1,1,6,9,3,-1,1,2,0,11,0,1,3,4,6,0,0,1,0,0,1,3,1
KR_6505701209,420,4,55,31,7,2,4,2,3,3,0,-3,0,3,2,2,0,3,3,0,0,1,-6,-1,4,3,-1,1,5,1,1,1,1,2,1
KR_6763478195,420,2,12,4,10,1,1,0,2,2,0,0,1,1,5,9,4,2,2,0,0,6,-5,4,1,5,-2,0,1,-1,1,1,1,5,1
KR_6655253570,420,2,9,14,10,3,3,0,6,6,0,0,1,1,0,4,4,1,2,1,0,12,2,-2,6,4,-3,0,0,-1,1,0,1,2,1
KR_6566390368,420,3,2,9,11,7,7,0,3,4,1,0,3,3,-3,2,5,4,5,1,1,13,-2,0,5,5,0,0,2,1,-1,1,1,3,1
KR_6714133414,420,6,49,11,12,0,3,3,6,7,1,8,9,1,-2,0,2,0,2,2,0,8,3,-5,8,3,4,0,1,1,1,1,1,6,1
KR_6764729324,420,0,22,16,1,-2,0,2,-1,2,3,3,3,0,1,4,3,0,0,0,0,6,-5,-2,9,7,4,0,0,-1,1,1,1,3,1
KR_6695831158,420,3,54,-16,10,6,7,1,4,4,0,2,4,2,-2,1,3,0,0,0,0,6,-4,1,4,5,4,0,0,1,1,1,-1,2,1
KR_6756613135,420,-4,-77,-24,-10,-3,2,5,0,3,3,-1,3,4,-6,1,7,0,2,2,0,-11,-2,-5,5,0,3,0,-2,-1,1,-1,-1,4,1
KR_6764254602,420,5,38,-15,9,5,5,0,5,7,2,0,0,0,-1,4,5,0,1,1,1,10,2,0,7,7,1,0,0,1,1,1,1,3,1
KR_6627105731,420,0,19,14,-1,3,4,1,-6,1,7,2,4,2,2,5,3,-2,0,2,-1,0,-4,1,4,5,1,0,-1,-1,-1,1,-1,3,1
KR_6758705278,420,1,47,8,-3,3,4,1,-4,0,4,0,4,4,0,1,1,-2,0,2,0,-7,32,-2,4,2,-4,0,-1,-1,1,-1,-1,3,1
KR_6712258312,420,6,100,22,8,6,6,0,-3,3,6,0,3,3,4,5,1,1,2,1,0,3,-4,-4,7,3,3,0,2,-1,-1,1,1,6,1
KR_6588246724,420,6,127,35,5,2,2,0,1,2,1,2,2,0,0,2,2,0,0,0,0,1,-9,2,2,4,2,0,2,1,1,1,1,2,1
KR_6558573038,420,1,-3,26,-3,3,4,1,0,4,4,-2,0,2,-4,1,5,0,0,0,0,-2,-24,-2,8,6,-2,0,0,-1,1,0,-1,6,1
KR_6688529164,440,-2,-60,-16,2,-1,2,3,3,3,0,3,4,1,0,3,3,-3,2,5,0,9,-3,6,3,9,0,0,0,1,1,-1,1,3,1
KR_6764482006,420,1,8,9,-2,-1,1,2,0,3,3,0,2,2,1,3,2,-2,0,2,-2,-9,338,-1,5,4,1,0,0,1,-1,0,-1,6,1
KR_6752423118,420,1,126,13,4,0,1,1,1,3,2,3,4,1,0,3,3,0,1,1,1,0,-5,-1,6,5,5,0,3,1,1,1,1,1,1
KR_6627399982,420,4,95,11,8,2,2,0,0,3,3,1,3,2,2,6,4,3,3,0,-1,6,14,8,4,12,-1,0,2,1,1,1,-1,5,1
KR_6758499165,440,2,-11,-12,5,10,11,1,-2,0,2,-2,2,4,-3,1,4,2,2,0,0,0,29,-4,6,2,-1,0,0,-1,-1,-1,1,5,1
KR_6734637232,420,0,63,-44,-1,1,2,1,-2,0,2,2,3,1,-2,0,2,0,0,0,0,-8,-11,-5,6,1,4,0,0,-1,1,0,-1,4,1
KR_6746129290,440,3,43,14,8,2,4,2,1,3,2,5,5,0,4,6,2,-4,6,10,0,2,-6,-5,6,1,4,0,0,0,0,0,1,0,1
KR_6729762259,420,-3,2,24,-8,-1,1,2,-6,1,7,-2,0,2,1,3,2,0,0,0,0,-7,11,3,5,8,-1,0,1,1,0,1,1,6,1
KR_6721331144,420,2,41,22,0,1,4,3,0,4,4,-2,1,3,0,2,2,1,2,1,0,2,2,0,4,4,0,0,0,0,-1,-1,-1,0,1
KR_6733544137,420,7,92,4,6,3,3,0,1,4,3,1,4,3,0,1,1,1,2,1,0,8,-1,-3,8,5,1,0,1,0,-1,1,-1,0,1
KR_6717156129,420,0,46,-12,2,2,3,1,-3,0,3,3,3,0,-3,1,4,3,3,0,0,1,-1,-2,6,4,-3,0,0,-1,-1,0,-1,4,1
KR_6701315241,440,4,46,32,13,-1,0,1,6,6,0,6,7,1,-1,2,3,3,3,0,2,16,-4,6,7,13,-3,0,1,1,1,1,1,6,1
KR_6692040101,420,6,72,16,5,3,4,1,-1,2,3,-1,1,2,4,6,2,0,0,0,0,4,-14,-1,6,5,0,0,2,1,1,1,1,5,1
KR_6724851815,420,1,-9,9,1,1,3,2,-4,2,6,2,4,2,1,2,1,1,1,0,0,2,301,-1,3,2,0,0,0,1,0,0,-1,3,1
KR_6735971602,420,4,53,0,8,4,5,1,2,2,0,1,3,2,0,3,3,1,2,1,1,4,11,6,4,10,-3,0,2,1,1,1,1,4,1
KR_6649243827,420,4,7,-11,7,2,3,1,5,8,3,0,1,1,0,2,2,0,1,1,0,6,8,7,1,8,3,0,0,1,1,1,-1,1,1
KR_6753138931,420,-1,10,7,5,3,8,5,-4,3,7,2,6,4,0,5,5,4,4,0,2,2,-114,3,0,3,3,0,0,1,1,1,1,4,1
KR_6630496682,420,4,36,23,12,-1,1,2,7,8,1,1,1,0,1,4,3,4,6,2,0,15,5,2,2,4,0,0,1,1,-1,1,1,4,1
KR_6750254991,420,0,21,-15,-1,1,3,2,0,3,3,-8,1,9,5,7,2,1,3,2,0,-2,59,-3,5,2,-26,0,2,-1,-1,1,-1,6,1
KR_6761943506,420,1,15,-1,4,3,3,0,-2,2,4,0,4,4,3,6,3,0,0,0,0,2,-11,2,2,4,0,0,1,-1,1,1,-1,4,1
KR_6631706628,420,2,5,22,-2,2,4,2,1,1,0,-5,3,8,0,0,0,0,0,0,0,-6,2,0,4,4,-5,0,0,-1,-1,0,1,2,1
KR_6730253514,440,1,-33,-25,3,4,7,3,-3,2,5,0,1,1,1,1,0,1,2,1,0,-4,-24,0,3,3,4,0,0,0,-1,1,1,0,1
KR_6599537580,420,3,64,18,4,2,3,1,-1,0,1,1,1,0,2,2,0,0,0,0,0,0,3,3,2,5,2,0,0,1,1,0,1,5,1
KR_6761769864,420,0,-43,8,-1,0,0,0,-3,3,6,-1,0,1,3,5,2,0,0,0,0,-1,5,4,7,11,-1,0,-1,1,0,-1,-1,2,1
KR_6745628197,420,3,64,21,10,-3,0,3,1,2,1,0,4,4,12,13,1,0,1,1,1,8,-4,4,1,5,2,0,2,1,1,1,1,2,1
KR_6764070938,420,1,-31,4,6,3,4,1,0,3,3,4,5,1,1,3,2,-2,0,2,0,8,382,-1,2,1,2,0,0,-1,1,1,1,1,1
KR_6730298761,420,2,12,-4,7,-1,0,1,3,5,2,3,3,0,0,2,2,2,2,0,-1,6,-1,2,3,5,0,0,0,-1,0,1,-1,3,1
KR_6640998866,420,-1,0,-8,-1,-5,0,5,2,4,2,-2,2,4,6,7,1,-2,1,3,0,6,7,1,4,5,0,0,0,-1,1,1,1,4,1
KR_6757599038,420,1,43,-28,-1,-1,2,3,4,6,2,-3,1,4,-2,1,3,1,2,1,0,1,-19,-1,7,6,2,0,0,0,1,1,-1,0,1
KR_6758201203,420,3,72,-20,8,5,5,0,1,4,3,1,3,2,1,3,2,0,0,0,0,3,12,3,2,5,-2,0,2,0,1,1,-1,0,1
KR_6626088968,420,1,-8,28,3,1,1,0,2,4,2,0,0,0,-2,1,3,2,3,1,0,2,23,0,5,5,-5,0,1,0,0,1,1,0,1
KR_6710713127,420,3,80,31,5,-2,3,5,-1,2,3,4,5,1,2,3,1,2,4,2,0,8,28,-1,4,3,0,0,3,0,0,1,1,0,1
KR_6760134575,420,2,80,3,11,2,5,3,3,4,1,8,8,0,0,2,2,-2,2,4,0,15,-1,-3,5,2,5,0,2,-1,1,1,1,1,1
KR_6724646300,440,3,82,0,8,0,0,0,1,2,1,0,0,0,6,6,0,1,1,0,0,7,4,2,3,5,5,0,3,0,1,1,1,0,1
KR_6732107408,420,0,-8,4,4,-4,0,4,3,6,3,1,4,3,3,4,1,1,2,1,0,8,-2,0,6,6,1,0,-1,-1,-1,-1,1,4,1
KR_6763623496,420,-2,25,-39,-3,-5,0,5,-1,1,2,3,4,1,0,2,2,0,1,1,0,-6,1,5,7,12,2,0,0,1,-1,1,1,2,1
KR_6530431360,420,2,-4,33,2,1,2,1,-5,0,5,7,9,2,-1,1,2,0,1,1,0,-6,-7,-2,7,5,0,0,1,1,1,1,-1,2,1
KR_6733251926,420,4,58,56,7,2,3,1,2,2,0,-1,0,1,4,4,0,0,0,0,0,5,-1,3,1,4,0,0,0,1,1,0,1,2,1
KR_6764555058,420,1,37,27,0,-1,1,2,2,2,0,1,4,3,0,2,2,-2,0,2,0,3,8,-2,5,3,8,0,1,-1,1,1,-1,2,1
KR_6521734190,420,0,-18,-11,0,-2,4,6,0,5,5,2,4,2,1,4,3,-1,0,1,0,1,48,3,3,6,-12,0,0,1,-1,-1,1,2,1
KR_6706892166,420,0,-48,-1,2,0,0,0,-1,2,3,3,4,1,0,3,3,0,1,1,0,0,10,3,5,8,-6,0,1,0,-1,1,-1,0,1
KR_6759135257,440,1,26,-35,-2,-4,3,7,3,4,1,1,4,3,0,7,7,-2,1,3,0,3,0,6,5,11,3,0,0,-1,-1,-1,1,5,1
KR_6731054450,420,5,52,-20,9,2,3,1,4,4,0,0,3,3,3,4,1,0,1,1,0,11,24,-1,4,3,1,0,1,1,1,1,1,5,1
KR_6738529622,420,-1,63,-16,-1,-1,1,2,3,5,2,0,0,0,-3,0,3,0,0,0,0,0,8,0,5,5,2,0,-1,1,-1,-1,-1,4,1
KR_6742597224,420,-2,33,-9,-2,0,2,2,1,2,1,-1,1,2,-3,2,5,1,1,0,0,-7,9,0,5,5,-5,0,0,1,1,0,-1,3,1
KR_6759072305,440,-5,-75,-18,-11,2,4,2,-4,0,4,-2,1,3,-6,0,6,-1,0,1,0,-11,9,-2,6,4,-15,0,0,0,-1,1,1,0,1
KR_6623685271,420,-2,-7,3,-2,-2,2,4,-4,0,4,0,2,2,3,5,2,1,2,1,1,-9,186,-4,8,4,-4,0,1,1,0,1,1,2,1
KR_6668999071,440,5,46,25,10,0,1,1,-2,0,2,1,1,0,7,7,0,4,5,1,0,15,23,-1,5,4,-1,0,2,1,1,1,1,2,1
KR_6757012522,420,5,38,26,10,5,5,0,2,5,3,0,1,1,2,6,4,1,5,4,1,9,-17,3,2,5,-2,0,2,0,-1,1,-1,0,1
KR_6680083944,420,-5,-22,-12,-6,-3,1,4,-2,1,3,2,3,1,-3,2,5,0,2,2,0,2,15,-5,8,3,-2,0,0,-1,0,0,1,2,1
KR_6732728222,420,1,-10,-26,2,6,6,0,3,6,3,-2,1,3,-6,0,6,1,1,0,0,4,3,2,1,3,0,0,0,1,1,0,1,1,1
KR_6760761585,420,1,-11,4,7,6,6,0,-1,2,3,-3,2,5,6,8,2,-1,1,2,0,4,7,3,2,5,-1,0,1,1,1,1,1,1,1
KR_6732418144,420,5,93,-21,12,7,8,1,0,3,3,1,2,1,4,4,0,0,0,0,0,5,7,4,3,7,3,0,0,1,-1,1,1,1,1
KR_6741118153,440,2,-22,-16,11,4,5,1,1,3,2,0,5,5,-2,1,3,8,10,2,-1,0,9,8,0,8,-5,0,1,1,-1,1,-1,3,1
KR_6759490016,420,3,41,-2,12,4,6,2,-5,2,7,4,6,2,4,4,0,5,5,0,4,19,6,5,3,8,0,0,1,0,1,1,1,0,1
KR_6728692210,420,-1,-15,-6,-8,-1,0,1,2,5,3,-5,0,5,-1,3,4,-3,0,3,0,1,-9,0,7,7,2,0,-1,1,-1,-1,-1,3,1
KR_6654267561,420,4,35,-20,11,0,2,2,2,3,1,-2,0,2,3,4,1,8,8,0,-1,12,5,-1,6,5,1,0,1,0,-1,1,-1,0,1
KR_6338959707,440,-2,41,-11,-1,3,3,0,2,3,1,-3,2,5,-1,4,5,-2,0,2,0,6,-6,3,4,7,-6,0,0,1,0,1,1,6,1
KR_6759368641,420,2,60,0,10,0,3,3,2,2,0,5,7,2,0,1,1,3,4,1,0,8,10,0,4,4,-1,0,2,1,-1,1,-1,3,1
KR_6549132016,420,4,45,-4,8,2,3,1,-3,4,7,2,3,1,6,6,0,1,1,0,0,9,8,1,3,4,-1,0,2,1,-1,1,1,5,1
KR_6728721048,420,6,64,52,18,0,3,3,3,4,1,5,6,1,9,10,1,1,3,2,0,17,0,11,1,12,2,0,2,1,1,1,1,6,1
KR_6741984708,440,0,-68,40,4,3,3,0,0,1,1,1,3,2,-3,1,4,3,3,0,1,3,-2,2,2,4,3,0,0,0,1,0,1,0,1
KR_6713723100,420,0,25,-49,1,4,6,2,-3,1,4,0,2,2,0,3,3,0,4,4,1,-3,-15,-5,7,2,6,0,0,0,-1,-1,-1,0,1
KR_6591914704,420,3,75,21,3,2,2,0,-2,0,2,0,2,2,3,6,3,0,1,1,0,-1,98,0,6,6,-1,0,1,1,1,1,1,2,1
KR_6706540572,420,3,54,-12,0,1,3,2,1,4,3,4,4,0,-4,2,6,-2,0,2,1,-15,0,-1,5,4,0,0,1,-1,1,1,1,6,1
KR_6757786979,420,4,8,17,1,0,2,2,0,1,1,2,2,0,-2,2,4,1,3,2,0,2,50,-2,7,5,-22,0,0,1,-1,0,-1,3,1
KR_6715019649,440,6,132,6,15,4,5,1,3,7,4,-1,1,2,5,5,0,4,5,1,0,19,25,0,3,3,1,0,3,1,1,1,1,5,1
KR_6749853572,420,-2,-1,-16,-6,2,5,3,-1,1,2,2,3,1,-3,1,4,-6,1,7,0,-9,5,0,4,4,0,0,-1,1,-1,-1,1,1,1
KR_6660156855,440,4,83,43,-2,3,3,0,-1,0,1,-3,2,5,-1,1,2,0,1,1,0,-3,5,-4,6,2,-4,0,2,-1,1,1,-1,4,1
KR_6736664208,420,1,-16,12,6,1,5,4,1,5,4,-1,1,2,1,1,0,4,4,0,-1,10,-89,-1,5,4,0,0,0,1,-1,-1,-1,5,1
KR_6748443315,420,3,37,16,3,0,4,4,-1,2,3,0,1,1,2,5,3,2,3,1,0,9,9,1,5,6,5,0,1,1,-1,1,1,1,1
KR_6682073090,440,-2,-39,-8,1,-3,1,4,6,7,1,1,4,3,-2,5,7,-1,2,3,3,7,3,-3,5,2,1,0,-1,-1,0,-1,1,6,1
KR_6663867588,420,0,43,0,0,0,3,3,4,6,2,-3,1,4,-1,0,1,0,0,0,0,1,-5,0,3,3,1,0,1,-1,-1,1,-1,3,1
KR_6730428954,420,1,-30,-12,-1,0,3,3,1,3,2,1,2,1,-1,2,3,-2,1,3,0,-2,-35,-2,4,2,17,0,0,1,1,-1,1,2,1
KR_6738166545,420,1,-36,2,5,-1,0,1,2,3,1,-1,0,1,0,2,2,5,6,1,-1,8,4,2,3,5,-4,0,0,1,-1,0,-1,3,1
KR_6677704615,420,1,38,-17,1,-4,1,5,4,6,2,-2,4,6,3,4,1,0,0,0,-1,7,14,9,3,12,-1,0,0,1,0,1,-1,5,1
KR_6680308413,420,-1,20,-5,3,-6,1,7,1,2,1,4,5,1,4,7,3,0,2,2,0,6,11,4,3,7,2,0,0,1,0,0,1,2,1
KR_6694229062,420,4,28,12,8,4,4,0,3,6,3,2,2,0,0,4,4,-1,1,2,0,2,38,2,4,6,1,0,0,1,1,1,1,1,1
KR_6764445258,420,3,69,24,5,1,1,0,5,6,1,-1,2,3,1,1,0,-1,0,1,0,-3,-2,-1,4,3,-1,0,1,1,-1,1,1,4,1
KR_6561607405,420,0,2,-3,2,3,3,0,-1,2,3,3,3,0,-2,1,3,-1,1,2,0,-3,-34,2,5,7,2,0,0,1,1,1,1,6,1
KR_6764487385,420,-1,5,-7,-3,-4,1,5,5,6,1,3,6,3,-7,1,8,0,4,4,0,0,6,6,0,6,-2,0,-1,-1,0,-1,-1,1,1
KR_6452471625,440,2,12,18,6,-1,1,2,2,4,2,1,3,2,4,4,0,0,1,1,0,6,-160,1,5,6,-1,0,-1,1,1,1,-1,1,1
KR_6744287495,420,3,-10,24,3,-2,3,5,1,4,3,-1,2,3,0,1,1,5,5,0,0,5,325,1,6,7,3,0,0,1,1,0,-1,4,1
KR_6606122056,420,1,65,29,3,3,5,2,2,5,3,-3,1,4,1,3,2,0,1,1,0,1,5,2,1,3,-2,0,0,-1,1,1,1,5,1
KR_6764366900,420,3,45,12,12,1,2,1,2,3,1,3,4,1,6,6,0,0,4,4,-1,8,14,1,5,6,3,0,0,1,1,1,-1,4,1
KR_6514585862,420,0,6,4,1,1,3,2,0,3,3,-2,1,3,1,7,6,1,1,0,0,-3,-1,1,7,8,1,0,1,1,0,1,-1,5,1
KR_6764602712,420,4,17,38,2,3,4,1,-1,1,2,-1,1,2,1,3,2,0,0,0,0,-1,2,-2,8,6,-3,0,1,-1,1,1,1,5,1
KR_6644103453,420,1,-74,-16,3,-2,2,4,0,4,4,3,5,2,2,5,3,0,1,1,0,3,-14,-4,10,6,2,0,0,0,1,0,1,0,1
KR_6742889172,420,6,95,23,7,3,4,1,1,3,2,3,3,0,-1,3,4,1,3,2,0,5,6,-2,5,3,1,0,1,-1,1,1,1,2,1
KR_6715371753,420,-2,47,-15,3,-1,1,2,1,2,1,-1,1,2,3,6,3,1,2,1,0,-1,-1,0,4,4,-3,0,1,-1,1,1,1,3,1
KR_6500213470,420,1,-8,-18,5,2,4,2,3,3,0,2,2,0,-1,2,3,-1,2,3,0,5,241,5,1,6,0,0,2,1,1,1,1,3,1
KR_6658267023,420,2,-5,15,5,-1,1,2,4,6,2,1,1,0,1,2,1,0,1,1,1,5,18,4,4,8,1,0,1,1,1,1,1,4,1
KR_6760955720,440,4,78,28,7,3,4,1,0,5,5,5,5,0,0,3,3,-1,3,4,0,7,3,4,3,7,2,0,0,-1,1,0,-1,2,1
KR_6715869008,420,3,66,8,5,-3,3,6,4,4,0,-1,1,2,5,6,1,0,2,2,-1,5,-3,3,5,8,2,0,1,1,-1,1,-1,4,1
KR_6674419384,420,2,24,13,4,1,2,1,3,7,4,-1,2,3,2,5,3,-1,0,1,0,0,10,2,2,4,-1,0,0,1,0,0,1,4,1
KR_6746891770,420,0,48,-12,-1,3,5,2,3,4,1,-5,1,6,2,2,0,-4,0,4,0,3,-2,6,3,9,1,0,0,1,-1,0,1,3,1
KR_6644707884,440,2,26,-20,3,0,3,3,1,5,4,1,1,0,2,6,4,-1,0,1,0,2,3,2,5,7,1,0,1,-1,1,1,-1,5,1
KR_6745949243,420,4,4,10,8,2,3,1,1,6,5,2,3,1,2,3,1,1,1,0,0,4,144,1,3,4,-2,0,1,-1,1,1,1,1,1
KR_6764334717,420,0,7,-3,0,-6,1,7,4,6,2,3,4,1,-1,2,3,0,0,0,0,-4,4,-2,5,3,-4,0,0,0,-1,0,1,0,1
KR_6452373525,440,1,29,-8,10,2,5,3,2,2,0,-1,4,5,6,6,0,1,2,1,0,12,-2,-1,4,3,-1,0,1,-1,-1,1,1,4,1
KR_6497271767,440,0,30,20,-2,1,1,0,2,3,1,-5,1,6,2,2,0,-2,1,3,0,0,-6,-2,8,6,-2,0,0,1,1,0,-1,6,1
KR_6708877872,440,7,71,16,8,2,4,2,1,2,1,3,5,2,0,4,4,2,2,0,0,7,1,1,1,2,4,0,3,-1,1,1,-1,3,1
KR_6753431792,420,0,-61,12,4,3,3,0,-3,2,5,-2,3,5,6,8,2,0,1,1,-2,10,-11,4,3,7,-6,0,0,1,1,0,1,2,1
KR_6216467987,420,3,2,17,4,-2,0,2,1,3,2,1,3,2,3,5,2,1,2,1,0,6,35,-3,7,4,-3,0,0,1,0,0,-1,4,1
KR_6639013774,420,0,69,15,0,4,4,0,5,9,4,-3,3,6,-3,4,7,-3,1,4,1,8,-7,-2,6,4,4,0,1,1,0,1,1,1,1
KR_6754811469,420,1,28,16,-4,-5,0,5,-5,3,8,5,7,2,1,5,4,0,2,2,0,-2,-6,1,5,6,-2,0,0,-1,-1,0,-1,4,1
KR_6740285840,420,1,47,13,3,-2,0,2,-1,1,2,2,4,2,3,6,3,1,2,1,0,2,-8,2,4,6,-3,0,-1,1,-1,-1,1,4,1
KR_6707113324,420,1,43,0,1,1,1,0,-1,0,1,6,6,0,2,4,2,-7,0,7,-1,-4,0,-6,7,1,4,0,1,-1,1,1,-1,3,1
KR_6749959606,420,0,-53,12,-3,-3,0,3,2,3,1,-2,2,4,-1,3,4,1,1,0,0,3,-2,0,5,5,-5,0,-1,1,1,-1,-1,1,1
KR_6746250740,420,2,-74,31,3,-1,2,3,4,5,1,3,7,4,-1,2,3,-2,0,2,0,-4,-3,-1,7,6,3,0,-1,1,1,-1,1,2,1
KR_6628043527,420,6,134,32,14,2,2,0,3,3,0,6,7,1,4,4,0,-1,0,1,0,7,-6,-2,6,4,4,0,3,1,-1,1,1,1,1
KR_6654788021,420,-1,34,16,-1,0,0,0,-1,1,2,-3,1,4,4,6,2,-1,2,3,0,6,8,2,2,4,1,0,0,1,-1,0,1,6,1
KR_6747821145,440,-1,8,14,1,4,6,2,1,2,1,0,2,2,-2,0,2,-2,0,2,0,-5,-2,-6,8,2,-1,0,0,-1,0,0,1,2,1
KR_6748932975,420,1,37,4,7,1,1,0,-3,0,3,4,4,0,4,6,2,1,2,1,0,2,10,5,5,10,1,0,1,1,1,1,1,3,1
KR_6577065522,420,-1,-93,-7,1,1,4,3,2,3,1,-1,1,2,-2,0,2,1,2,1,0,2,7,-2,5,3,2,0,0,1,1,0,-1,2,1
KR_6497814344,420,0,-46,15,8,3,3,0,-4,2,6,9,10,1,1,5,4,-1,2,3,1,11,-5,-2,8,6,3,0,1,1,-1,1,1,3,1
KR_6731636246,440,2,54,-8,6,3,4,1,6,9,3,0,1,1,1,2,1,-4,1,5,0,-3,42,1,5,6,-1,0,0,-1,1,0,1,4,1
KR_6546272784,420,-2,-57,-14,0,2,3,1,-1,1,2,-3,0,3,-1,0,1,3,4,1,0,2,-21,4,4,8,-5,0,0,-1,1,0,1,6,1
KR_6748315815,420,3,49,-11,8,6,9,3,-7,2,9,3,4,1,6,8,2,0,1,1,0,0,315,0,5,5,2,0,2,1,1,1,1,2,1
KR_6652871934,420,4,101,24,5,0,3,3,1,2,1,2,5,3,3,3,0,-1,1,2,-1,5,0,-1,5,4,-1,0,1,-1,1,1,-1,1,1
KR_6730646599,420,3,2,11,10,-1,1,2,4,6,2,2,3,1,7,7,0,-2,0,2,0,9,-1,1,1,2,1,0,1,-1,1,1,1,1,1
KR_6727262941,440,4,-8,43,0,2,3,1,3,3,0,1,1,0,-3,1,4,-3,1,4,0,-5,43,-3,7,4,2,0,-1,-1,1,1,-1,6,1
KR_6758847394,420,3,41,49,4,4,4,0,0,1,1,3,3,0,-3,2,5,0,1,1,1,0,-1,3,4,7,0,0,0,1,1,1,1,3,1
KR_6734801008,420,-1,73,-18,1,2,2,0,-4,0,4,1,1,0,4,6,2,-2,2,4,0,-3,-6,0,4,4,1,0,1,0,1,1,1,0,1
KR_6737871014,440,-3,-2,-28,4,0,0,0,0,1,1,-1,3,4,6,8,2,-1,2,3,0,11,10,4,3,7,-5,0,0,1,-1,1,1,2,1
KR_6673977350,420,3,79,-9,5,0,1,1,-2,0,2,2,5,3,6,7,1,-1,0,1,1,3,5,4,2,6,3,0,0,1,1,0,1,1,1
KR_6653666758,420,8,133,12,17,4,4,0,6,6,0,3,3,0,4,4,0,0,0,0,0,16,12,6,2,8,-2,0,0,1,1,1,1,6,1
KR_6747753150,420,0,22,4,5,-2,0,2,3,5,2,-1,3,4,4,7,3,1,3,2,0,11,-46,1,5,6,23,0,1,1,-1,1,1,3,1
KR_6764271851,420,3,11,-24,9,2,3,1,5,6,1,-1,0,1,5,8,3,-2,0,2,-1,5,5,1,5,6,-3,0,1,-1,1,1,-1,3,1
KR_6744165131,440,1,22,-44,6,0,1,1,8,8,0,3,3,0,-5,0,5,0,1,1,0,5,-17,1,5,6,1,0,1,0,1,1,1,0,1
KR_6727776020,440,5,-14,16,6,4,4,0,1,2,1,1,2,1,-1,2,3,1,1,0,0,-1,-22,-3,6,3,5,0,0,1,-1,0,1,3,1
KR_6696371301,420,1,-8,15,-1,-2,0,2,1,1,0,-3,0,3,1,4,3,2,3,1,0,-4,-15,4,3,7,4,0,1,1,-1,1,-1,5,1
KR_6764713926,440,2,6,46,2,0,2,2,0,1,1,2,3,1,2,2,0,-2,1,3,0,4,-9,2,3,5,-4,0,1,-1,1,1,-1,1,1
KR_6729788237,440,-1,-34,-28,-6,-1,2,3,-1,1,2,2,3,1,-6,1,7,0,3,3,-4,-15,-3,-1,5,4,-2,0,0,-1,1,0,-1,6,1
KR_6664160245,420,3,48,28,12,-3,0,3,-3,2,5,14,14,0,3,3,0,1,1,0,0,12,6,1,1,2,-1,0,2,-1,1,1,-1,5,1
KR_6633370659,420,0,-26,-20,5,2,5,3,-2,0,2,6,6,0,-4,0,4,3,4,1,0,8,2,6,5,11,-4,0,1,1,1,-1,-1,2,1
KR_6736762575,420,2,14,5,7,0,1,1,-1,3,4,-1,3,4,7,8,1,2,4,2,1,9,5,6,4,10,2,0,1,1,-1,1,1,6,1
KR_6759995321,420,-1,-46,-17,-3,-1,2,3,0,0,0,0,2,2,0,1,1,-2,2,4,0,-2,7,3,5,8,-3,0,0,-1,-1,0,-1,5,1
KR_6759912358,420,2,58,19,4,0,1,1,2,3,1,3,3,0,-1,5,6,0,1,1,0,7,-7,5,4,9,0,0,1,1,1,1,1,3,1
KR_6759956602,420,2,58,-8,6,3,3,0,4,5,1,-1,2,3,-1,1,2,1,1,0,0,1,-114,5,6,11,1,0,0,-1,1,-1,1,4,1
KR_6744194946,420,2,93,0,4,1,1,0,2,10,8,4,5,1,-1,3,4,-2,0,2,0,1,8,4,2,6,0,0,1,1,-1,1,-1,1,1
KR_6759598008,420,4,86,7,11,4,5,1,-4,1,5,2,3,1,6,6,0,3,3,0,0,7,-16,1,3,4,3,0,1,-1,1,1,-1,2,1
KR_6720421063,420,-1,-27,23,-3,-5,0,5,2,3,1,5,5,0,-4,4,8,-1,1,2,-3,-11,-108,1,3,4,3,0,-1,1,-1,-1,-1,3,1
KR_6577059715,420,3,22,-2,9,1,1,0,3,3,0,4,6,2,2,5,3,-1,0,1,0,10,-34,-1,2,1,9,0,1,1,1,1,1,4,1
KR_6754661275,420,3,6,38,3,5,5,0,-5,0,5,2,2,0,1,2,1,0,0,0,0,1,9,-5,7,2,-2,0,0,1,1,0,1,3,1
KR_6764213643,420,4,129,-12,8,1,4,3,3,3,0,1,1,0,2,4,2,1,1,0,0,7,0,-5,8,3,-1,0,2,1,1,1,1,4,1
KR_6761706487,420,3,-3,8,12,0,1,1,8,9,1,4,7,3,1,3,2,-1,0,1,0,10,-2,4,2,6,-2,0,0,1,1,1,-1,3,1
KR_6762252881,420,0,6,-8,0,0,1,1,-1,0,1,-1,1,2,0,1,1,2,2,0,0,7,23,0,4,4,-1,0,0,-1,1,0,-1,6,1
KR_6494316053,420,2,-45,58,-7,3,4,1,-4,1,5,-2,1,3,-4,4,8,0,1,1,0,-8,11,0,6,6,-2,0,-2,1,0,-1,1,3,1
KR_6752982102,420,-1,-11,8,2,0,2,2,-4,1,5,0,0,0,3,4,1,3,4,1,0,0,6,-3,8,5,1,0,0,0,1,1,1,0,1
KR_6744094003,440,-2,19,36,-6,2,4,2,-2,2,4,-1,1,2,-5,2,7,0,2,2,0,-7,-8,-5,6,1,6,0,1,1,-1,-1,1,6,1
KR_6404802129,420,0,19,-8,-5,-4,1,5,4,4,0,0,0,0,-5,0,5,0,0,0,0,-8,1,-2,6,4,-3,0,1,1,-1,1,1,2,1
KR_6704196059,420,3,39,-28,4,1,3,2,-1,2,3,3,3,0,1,3,2,0,3,3,-2,2,35,-4,6,2,-11,0,0,1,1,-1,-1,2,1
KR_6632744555,420,3,26,17,4,5,5,0,2,5,3,0,0,0,-1,3,4,-2,1,3,0,-6,3,0,4,4,-1,0,2,1,1,1,1,2,1
KR_6762410470,420,-2,-15,-12,-5,0,1,1,-1,2,3,-3,2,5,-1,1,2,0,1,1,0,-9,-7,0,6,6,2,0,-1,-1,-1,-1,1,5,1
KR_6665940298,420,2,63,4,2,1,2,1,-1,2,3,2,3,1,-2,2,4,2,2,0,0,3,7,0,5,5,-1,0,0,0,0,0,1,0,1
KR_6663868418,420,5,66,0,3,3,3,0,-2,1,3,-2,0,2,3,3,0,1,1,0,0,-2,-4,0,5,5,0,0,1,1,-1,1,-1,1,1
KR_6761170226,420,2,0,0,8,-2,1,3,4,8,4,-1,1,2,8,8,0,-1,0,1,0,12,-21,0,3,3,4,0,0,1,0,1,-1,1,1
KR_6707710276,420,-1,13,4,-4,0,0,0,-2,0,2,3,3,0,-4,0,4,-1,2,3,0,-3,-16,1,3,4,0,0,-1,0,-1,-1,-1,0,1
KR_6662338212,420,5,104,38,8,2,4,2,5,7,2,3,4,1,-2,2,4,0,0,0,0,5,-3,5,7,12,-2,0,1,1,1,1,-1,6,1
KR_6606440325,420,3,-24,21,2,-7,1,8,0,3,3,0,0,0,7,8,1,2,5,3,0,15,-1,0,2,2,4,0,0,1,1,1,-1,1,1
KR_6292596310,420,4,32,7,12,1,4,3,1,4,3,2,4,2,8,9,1,0,1,1,1,8,-14,-3,5,2,-1,0,1,-1,-1,1,1,3,1
KR_6546794377,420,5,59,67,10,-2,0,2,3,3,0,7,8,1,2,5,3,0,1,1,1,8,16,9,2,11,0,0,1,1,-1,1,1,1,1
KR_6669191588,440,0,-2,16,5,-1,2,3,-1,3,4,4,4,0,3,4,1,0,0,0,0,11,-5,-1,4,3,7,0,-1,1,-1,-1,1,2,1
KR_6732359773,420,2,53,8,-1,2,2,0,0,2,2,-3,1,4,-1,1,2,1,1,0,0,1,-1,5,2,7,1,0,1,1,1,1,-1,2,1
KR_6731574431,440,3,43,28,12,-2,3,5,4,8,4,-3,1,4,4,5,1,9,9,0,3,10,5,1,5,6,1,0,2,1,1,1,1,5,1
KR_6722808633,420,7,128,35,9,5,6,1,0,1,1,1,6,5,4,4,0,-1,0,1,0,-8,0,-1,6,5,-2,0,3,1,1,1,1,2,1
KR_6742279992,420,1,-25,-1,-2,2,3,1,-4,1,5,2,2,0,-4,1,5,2,2,0,0,-3,22,2,3,5,-5,0,-1,-1,-1,-1,-1,6,1
KR_6755124071,420,0,37,35,3,-1,0,1,2,3,1,2,7,5,0,2,2,0,0,0,0,0,-7,-2,5,3,0,0,0,1,0,0,1,3,1
KR_6632682590,420,1,34,14,2,-2,0,2,3,6,3,4,4,0,-3,2,5,0,1,1,0,1,-10,0,6,6,0,0,0,-1,0,0,1,1,1
KR_6678716099,420,1,15,2,7,2,3,1,5,8,3,-1,2,3,0,4,4,1,1,0,0,9,-13,-3,7,4,1,0,0,-1,1,1,-1,1,1
KR_6756474947,420,1,78,-4,3,1,2,1,2,4,2,0,1,1,2,4,2,-2,0,2,0,-1,12,4,4,8,4,0,2,1,1,1,1,6,1
KR_6668573302,420,9,103,35,21,2,3,1,11,13,2,8,8,0,-1,2,3,1,1,0,0,13,11,-2,3,1,3,0,3,1,1,1,1,1,1
KR_6588816738,420,1,-25,-6,6,-1,0,1,1,1,0,-1,0,1,4,7,3,3,4,1,0,7,-46,-6,10,4,27,0,1,1,1,1,1,6,1
KR_6757621606,420,4,43,22,5,-2,0,2,1,4,3,2,4,2,-1,2,3,5,5,0,-1,-3,-4,-6,10,4,6,0,0,0,1,0,-1,0,1
KR_6741293249,420,4,130,-8,9,4,4,0,0,2,2,1,4,3,5,8,3,-1,1,2,2,10,4,-2,8,6,4,0,0,1,-1,0,1,4,1
KR_6464802080,420,0,5,5,-2,-2,0,2,0,2,2,-1,2,3,1,1,0,0,1,1,0,-2,27,-6,8,2,7,0,0,-1,-1,1,-1,4,1
KR_6597270547,420,2,-26,-4,1,3,4,1,0,3,3,3,3,0,-5,0,5,0,0,0,-1,-2,6,0,6,6,4,0,0,0,0,0,-1,0,1
KR_6506384024,420,7,70,51,11,2,2,0,5,7,2,-1,2,3,1,2,1,4,5,1,1,7,21,-2,4,2,-4,0,2,1,0,1,1,5,1
KR_6686646815,420,4,105,-23,11,8,10,2,-2,1,3,2,5,3,2,2,0,1,2,1,0,-1,8,2,3,5,1,0,1,1,1,1,1,1,1
KR_6760556057,420,-2,42,-11,-5,-1,0,1,0,4,4,-4,2,6,-1,1,2,1,2,1,0,-5,0,3,3,6,-1,0,0,1,1,0,1,3,1
KR_6643004905,420,0,36,34,-1,0,1,1,6,8,2,-7,2,9,3,5,2,-3,1,4,-2,-2,-10,-1,5,4,3,0,1,-1,1,1,-1,4,1
KR_6757561695,420,5,45,16,10,2,2,0,5,7,2,4,6,2,-2,1,3,1,3,2,-1,12,36,-1,5,4,-17,0,0,-1,-1,0,-1,6,1
KR_6717340825,420,-1,1,-28,-2,-1,0,1,0,1,1,1,3,2,-2,1,3,0,0,0,0,-2,2,-3,4,1,1,0,0,1,-1,-1,-1,5,1
KR_6571100479,420,0,47,16,-1,1,3,2,-1,3,4,-4,1,5,2,2,0,1,1,0,0,3,6,-3,6,3,-4,0,0,1,-1,1,-1,6,1
KR_6568953109,420,1,-30,3,-3,-2,1,3,-5,0,5,-2,2,4,5,5,0,1,2,1,0,-2,37,2,4,6,-23,0,0,1,-1,-1,1,3,1
KR_6693475813,420,4,98,13,4,2,2,0,2,8,6,-1,0,1,0,3,3,1,1,0,0,2,-63,-2,4,2,-2,0,1,-1,-1,1,1,6,1
KR_6750079017,420,2,-78,24,7,-1,1,2,1,2,1,3,7,4,0,1,1,4,5,1,0,3,27,0,3,3,0,0,0,1,1,1,-1,1,1
KR_6378208122,420,3,51,0,8,-2,0,2,3,3,0,-1,1,2,6,6,0,2,2,0,0,11,7,-2,9,7,-1,0,1,-1,-1,1,1,6,1
KR_6729873502,420,4,81,28,7,5,6,1,2,6,4,-2,2,4,4,6,2,-2,2,4,0,0,53,1,5,6,-17,0,1,1,1,1,-1,5,1
KR_6624589059,420,2,-4,36,5,-1,1,2,-1,4,5,3,6,3,4,6,2,0,0,0,1,5,-10,-3,7,4,2,0,1,-1,-1,-1,1,6,1
KR_6459213276,420,8,75,45,7,2,2,0,4,4,0,2,4,2,-6,0,6,5,5,0,0,10,-1,2,5,7,3,0,1,1,1,1,1,1,1
KR_6663966590,420,-1,-40,-20,4,3,3,0,-3,2,5,2,2,0,1,2,1,1,1,0,0,-3,2,1,1,2,0,0,-2,-1,-1,-1,1,6,1
KR_6763106971,420,3,57,8,10,2,2,0,-1,1,2,6,6,0,-1,1,2,4,5,1,0,8,0,-1,5,4,0,0,1,-1,1,1,1,4,1
KR_6608463671,420,3,73,-13,12,4,4,0,7,8,1,1,3,2,0,4,4,0,2,2,0,17,-2,3,5,8,5,0,1,1,1,1,1,2,1
KR_6748459582,420,0,-16,-8,1,4,4,0,2,4,2,-1,3,4,-3,1,4,-1,1,2,-1,0,-7,0,6,6,0,0,0,-1,1,1,-1,3,1
KR_6695394422,420,-1,-99,23,0,-1,1,2,-2,1,3,-2,3,5,-2,1,3,7,8,1,1,-3,-6,0,5,5,3,0,0,1,1,-1,1,1,1
KR_6764501685,440,1,46,17,0,7,10,3,0,2,2,3,7,4,-8,1,9,-2,0,2,-1,-7,-24,4,4,8,3,0,2,0,-1,-1,1,0,1
KR_6712148354,420,-2,-29,12,-6,-3,0,3,2,6,4,-4,0,4,-1,2,3,0,0,0,0,-2,-11,-1,5,4,0,0,-1,1,1,-1,-1,4,1
KR_6734814243,420,-1,-44,-33,2,4,4,0,-2,4,6,-5,0,5,5,5,0,0,1,1,0,-2,-8,0,4,4,0,0,1,-1,1,1,1,3,1
KR_6731348988,420,4,-1,40,8,5,6,1,5,7,2,1,3,2,-3,3,6,0,0,0,1,4,7,4,5,9,1,0,1,1,1,1,1,1,1
KR_6761122490,420,0,-10,-6,3,4,4,0,-3,3,6,3,4,1,-2,5,7,1,3,2,0,-1,106,2,2,4,0,0,1,0,1,1,1,0,1
KR_6761994319,420,-1,3,-40,-1,2,3,1,-1,2,3,-6,2,8,4,7,3,0,1,1,1,3,-19,1,1,2,1,0,0,-1,0,0,1,6,1
KR_6759779396,420,2,40,18,3,4,4,0,-1,2,3,2,4,2,-3,2,5,1,2,1,0,-9,6,4,1,5,-3,0,0,1,1,1,1,2,1
KR_6726770325,420,-2,10,27,-6,-5,2,7,-4,2,6,-2,2,4,3,4,1,2,2,0,-1,-7,-2,2,3,5,-2,0,0,0,1,-1,-1,0,1
KR_6750707995,420,-1,5,-24,7,2,2,0,-1,3,4,1,4,3,4,6,2,1,1,0,0,4,4,-5,9,4,-3,0,2,1,1,1,1,1,1
KR_6736867732,420,3,62,47,3,3,5,2,1,3,2,-1,2,3,0,2,2,0,0,0,0,-5,0,-1,4,3,-2,0,2,1,-1,1,1,2,1
KR_6589824931,420,2,-3,23,5,-2,2,4,2,8,6,0,2,2,4,4,0,1,2,1,0,3,-1,-1,5,4,3,0,1,1,1,-1,1,2,1
KR_6629254325,420,0,17,-13,-4,1,2,1,1,3,2,-1,2,3,-1,1,2,-4,0,4,0,-7,4,5,3,8,-5,0,-1,-1,1,-1,-1,3,1
KR_6692525917,420,1,50,-30,-3,2,2,0,0,2,2,-5,1,6,1,4,3,-1,0,1,0,-10,4,1,7,8,-3,0,1,1,1,1,1,2,1
KR_6761131210,420,1,66,-3,2,0,3,3,-1,0,1,-4,2,6,5,7,2,2,2,0,0,3,21,-1,2,1,0,0,1,1,1,1,1,4,1
KR_6741276535,420,1,49,25,-1,5,5,0,4,4,0,0,2,2,-7,0,7,-3,0,3,2,-4,-4,-5,8,3,-6,0,0,-1,1,1,1,5,1
KR_6735558230,420,2,-24,-34,5,1,1,0,-1,1,2,0,1,1,5,7,2,0,1,1,0,9,7,5,4,9,-3,0,0,1,-1,-1,-1,4,1
KR_6763497062,420,4,92,23,11,7,7,0,4,6,2,0,2,2,-1,5,6,1,1,0,1,7,0,-3,7,4,4,0,3,-1,0,1,1,1,1
KR_6729868475,420,0,4,20,-4,-3,0,3,0,3,3,-2,0,2,0,5,5,1,2,1,0,0,0,0,4,4,-2,0,0,1,1,-1,1,4,1
KR_6620769698,420,-2,14,-36,-5,0,3,3,-5,2,7,1,3,2,-1,1,2,0,1,1,0,-2,-46,-1,3,2,-3,0,-2,-1,-1,-1,-1,5,1
KR_6724786925,420,8,109,66,12,8,9,1,3,3,0,2,3,1,0,0,0,-1,1,2,0,6,-11,3,0,3,0,0,3,1,-1,1,1,1,1
KR_6753755867,420,-2,-38,-34,-4,-11,2,13,-1,2,3,1,1,0,5,5,0,2,2,0,0,5,249,1,2,3,-3,0,-1,1,-1,-1,-1,3,1
KR_6747191614,420,0,9,27,0,1,2,1,3,9,6,1,2,1,-5,1,6,0,1,1,0,-2,0,-3,5,2,-1,0,0,-1,-1,0,-1,4,1
KR_6764428050,420,0,-3,-32,-1,4,5,1,-5,1,6,-1,4,5,1,2,1,0,1,1,0,-2,-10,-2,5,3,0,0,1,-1,1,1,-1,5,1
KR_6759965060,420,1,3,8,0,0,1,1,2,3,1,1,5,4,-3,1,4,0,0,0,0,5,-19,0,5,5,-2,0,0,-1,1,0,1,5,1
KR_6606325707,420,1,7,8,6,3,3,0,2,6,4,-4,1,5,1,2,1,4,4,0,0,4,-53,2,5,7,-17,0,2,-1,1,1,-1,2,1
KR_6750519683,420,3,2,-16,3,1,3,2,0,2,2,4,5,1,-1,1,2,-1,0,1,0,5,2,-3,9,6,-4,0,1,0,-1,1,1,0,1
KR_6649823566,420,1,-48,-15,7,0,1,1,3,6,3,-1,0,1,3,5,2,2,2,0,0,16,1,3,4,7,0,0,0,0,1,-1,1,0,1
KR_6398035521,420,5,31,-8,16,-1,1,2,5,6,1,4,5,1,5,5,0,3,3,0,0,20,3,4,4,8,-2,0,2,-1,1,1,1,6,1
KR_6644823176,420,2,7,-3,4,5,6,1,0,1,1,1,2,1,-3,1,4,1,3,2,1,-1,8,0,5,5,-1,0,0,0,1,0,1,0,1
KR_6636494054,420,2,58,-23,4,1,1,0,-1,0,1,1,2,1,2,2,0,1,2,1,0,2,-3,-2,6,4,3,0,1,-1,-1,1,1,2,1
KR_6764662755,420,0,-19,6,-3,0,3,3,-2,0,2,3,7,4,-6,0,6,2,3,1,0,-4,-13,-8,10,2,5,0,0,1,1,1,1,2,1
KR_6697284965,420,3,53,32,-1,0,2,2,0,3,3,1,2,1,-2,1,3,0,1,1,0,0,-1,-3,5,2,-1,0,0,-1,-1,-1,-1,1,1
KR_6719164084,420,3,66,36,-1,-4,1,5,0,4,4,3,7,4,2,6,4,-2,0,2,-4,4,-2,2,4,6,0,0,2,-1,1,1,-1,5,1
KR_6033267839,420,-2,52,-41,-2,-2,0,2,1,5,4,0,2,2,-1,5,6,0,2,2,3,9,11,-1,4,3,-2,0,-1,-1,-1,-1,1,5,1
KR_6760619675,420,2,-31,-8,2,-2,2,4,8,10,2,-5,1,6,2,4,2,-1,0,1,-1,13,8,-3,4,1,2,0,0,0,-1,1,-1,0,1
KR_6751137956,420,-1,-7,0,0,0,4,4,0,2,2,-1,0,1,1,2,1,0,1,1,0,3,0,0,2,2,1,0,0,-1,-1,-1,-1,1,1
KR_6399112163,420,-1,5,-24,-1,3,3,0,2,4,2,0,3,3,-1,0,1,-5,1,6,0,-7,2,-1,5,4,1,0,0,1,1,1,1,2,1
KR_6348928657,420,1,-25,-19,2,0,1,1,2,2,0,3,4,1,-4,2,6,1,2,1,-2,-7,-4,0,2,2,1,0,0,1,0,-1,-1,3,1
KR_6679825265,420,3,-6,14,0,0,3,3,1,3,2,-2,1,3,2,4,2,-1,0,1,0,-1,8,3,3,6,-5,0,0,0,1,1,-1,0,1
KR_6704627557,440,5,-10,40,15,1,3,2,6,6,0,5,7,2,-2,1,3,5,6,1,0,22,-6,-3,5,2,5,0,0,1,1,0,1,4,1
KR_6730369966,420,1,43,-1,1,-1,1,2,-1,1,2,1,1,0,1,3,2,1,1,0,0,-2,2,7,3,10,2,0,1,1,1,1,-1,6,1
KR_6661134252,420,1,5,-12,1,5,5,0,1,4,3,-1,2,3,-4,0,4,0,0,0,0,-4,4,0,8,8,2,0,1,1,1,1,-1,6,1
KR_6727566044,420,4,84,-4,9,2,3,1,1,3,2,1,2,1,4,5,1,1,1,0,0,9,2,-3,7,4,6,0,1,1,0,1,1,5,1
KR_6721930629,420,0,-1,-10,1,-1,3,4,-4,0,4,3,3,0,3,3,0,0,0,0,0,-3,-79,-2,5,3,3,0,0,1,-1,-1,-1,4,1
KR_6647243535,420,1,6,4,7,-2,1,3,-5,2,7,8,8,0,0,4,4,6,8,2,0,8,-4,3,3,6,0,0,-1,1,1,-1,1,4,1
KR_6760387343,420,1,9,53,0,-3,0,3,2,8,6,2,5,3,-2,2,4,1,4,3,0,-12,8,2,7,9,3,0,-1,1,1,-1,-1,5,1
KR_6658503373,420,0,-30,-28,0,6,7,1,2,4,2,-2,2,4,0,4,4,-6,0,6,0,-1,-4,-1,7,6,7,0,1,-1,-1,1,1,5,1
KR_6759783829,440,1,-12,-20,9,3,5,2,4,4,0,2,2,0,1,2,1,-1,1,2,0,10,9,2,1,3,-5,0,1,-1,1,1,1,1,1
KR_6734897852,420,3,-52,20,6,4,4,0,-2,2,4,3,3,0,0,3,3,1,1,0,1,7,-31,1,7,8,-1,0,0,1,-1,0,1,2,1
KR_6703962119,440,5,92,12,12,3,4,1,2,4,2,2,3,1,4,4,0,1,1,0,0,12,6,0,5,5,4,0,2,1,-1,1,1,1,1
KR_6759681577,440,1,17,-5,9,3,3,0,0,1,1,4,4,0,3,3,0,-1,1,2,0,9,0,-2,3,1,-2,0,0,1,1,0,1,4,1
KR_6745073628,420,-2,-45,-10,0,0,2,2,2,5,3,0,7,7,-1,1,2,-1,0,1,0,3,5,4,1,5,0,0,1,-1,1,1,-1,6,1
KR_6634370915,420,0,-55,-4,-1,0,3,3,-3,2,5,-3,2,5,2,4,2,3,3,0,0,2,60,-3,5,2,-2,0,0,-1,-1,0,-1,3,1
KR_6715609966,420,0,-29,-27,-4,2,2,0,2,3,1,-5,1,6,-3,2,5,0,2,2,0,2,-59,-4,8,4,22,0,1,-1,1,1,-1,5,1
KR_6730691727,420,3,13,0,9,2,2,0,5,6,1,3,3,0,0,1,1,-1,0,1,0,11,19,2,3,5,0,0,1,1,1,1,1,6,1
KR_6749293585,420,-1,-1,-29,1,2,4,2,-4,5,9,0,3,3,0,1,1,3,3,0,0,-8,232,1,3,4,-3,0,0,-1,-1,0,-1,4,1
KR_6759395327,440,0,-23,21,1,-4,1,5,1,2,1,3,4,1,3,4,1,-2,0,2,0,7,2,0,2,2,2,0,-2,1,1,-1,-1,1,1
KR_6577790486,420,3,-16,0,9,-1,1,2,5,7,2,-1,1,2,5,6,1,1,1,0,0,21,-7,-1,6,5,2,0,1,1,1,1,1,1,1
KR_6752912718,420,2,51,14,9,2,3,1,4,5,1,0,3,3,2,3,1,1,2,1,0,6,4,1,4,5,-6,0,1,1,1,1,1,2,1
KR_6756010971,420,-1,3,-8,7,0,3,3,5,5,0,3,5,2,-1,1,2,0,0,0,2,4,11,-5,9,4,-4,0,-1,-1,-1,-1,1,4,1
KR_6721787962,420,4,-23,38,5,-1,0,1,-2,4,6,-1,4,5,3,4,1,6,6,0,0,-3,-10,-8,13,5,-1,0,0,-1,-1,1,1,2,1
KR_6688272097,420,0,11,-7,2,2,4,2,3,3,0,1,1,0,-3,1,4,-1,0,1,0,0,5,2,4,6,4,0,2,1,1,1,-1,2,1
KR_6399216106,420,-1,20,-2,5,-2,0,2,1,5,4,5,5,0,-3,3,6,4,4,0,0,3,-18,-4,8,4,-1,0,-2,1,-1,-1,1,6,1
KR_6763913906,420,-1,-13,-3,-2,2,2,0,1,1,0,1,4,3,-1,1,2,-5,0,5,-2,-6,21,-1,4,3,-1,0,0,-1,1,0,-1,1,1
KR_6757842865,420,4,25,4,7,6,6,0,1,2,1,-2,0,2,-1,3,4,3,3,0,0,1,1,3,2,5,1,0,1,1,1,1,1,4,1
KR_6716105051,420,3,54,43,6,-3,1,4,-1,3,4,10,10,0,-1,4,5,1,2,1,0,3,2,2,5,7,5,0,1,1,-1,1,-1,6,1
KR_6663855386,420,5,105,21,13,3,3,0,4,7,3,-1,0,1,5,6,1,2,3,1,1,7,-2,0,7,7,1,0,0,1,-1,1,1,2,1
KR_6740008328,420,1,37,0,-3,0,2,2,-6,2,8,-2,2,4,3,6,3,2,2,0,0,-4,-2,-2,6,4,2,0,-1,1,-1,-1,-1,6,1
KR_6743270115,420,1,23,32,-3,0,1,1,-4,1,5,6,7,1,-2,2,4,-3,2,5,0,-2,-1,2,6,8,2,0,1,1,1,1,-1,6,1
KR_6703075809,420,5,-16,31,13,2,5,3,7,9,2,2,3,1,2,2,0,0,1,1,3,11,-119,2,2,4,4,0,0,1,1,1,1,2,1
KR_6634922352,420,3,0,12,10,3,4,1,6,8,2,-2,0,2,1,5,4,2,4,2,0,10,-15,4,4,8,-3,0,2,1,1,1,-1,6,1
KR_6754367219,420,2,15,6,10,6,6,0,1,1,0,0,2,2,2,5,3,1,1,0,0,9,3,5,0,5,-2,0,0,0,1,0,1,0,1
KR_6670610783,420,-1,0,-2,-9,0,4,4,-1,1,2,-6,0,6,0,2,2,-2,0,2,0,-14,10,0,9,9,-4,0,0,1,0,-1,-1,4,1
KR_6720131637,420,6,89,5,16,2,2,0,0,2,2,5,6,1,6,6,0,3,3,0,0,8,3,1,3,4,3,0,1,-1,-1,1,1,1,1
KR_6729363870,420,0,-32,19,4,2,3,1,-1,0,1,1,6,5,1,3,2,1,1,0,0,4,4,-3,7,4,1,0,0,1,-1,0,-1,6,1
KR_6752214459,420,0,-36,-16,0,0,1,1,-2,3,5,2,10,8,0,2,2,0,1,1,-2,-3,-265,-1,4,3,2,0,-3,1,-1,-1,1,5,1
KR_6764760859,420,-2,-54,-23,-3,0,1,1,1,2,1,0,1,1,-3,0,3,-1,0,1,0,-10,-2,-1,7,6,-1,0,0,-1,1,-1,-1,1,1
KR_6709460061,420,6,21,23,10,3,3,0,0,5,5,-1,1,2,7,10,3,1,1,0,0,0,-18,0,5,5,29,0,0,1,1,1,-1,3,1
KR_6731329905,420,4,84,-1,8,8,8,0,-1,2,3,-2,2,4,2,2,0,1,2,1,1,8,55,-1,4,3,-18,0,3,-1,1,1,1,4,1
KR_6692455076,420,3,59,17,8,3,3,0,1,1,0,3,6,3,-1,1,2,2,2,0,0,-1,2,0,5,5,0,0,0,1,1,0,1,2,1
KR_6594073415,440,-1,-21,17,-1,-1,2,3,-4,1,5,1,1,0,4,6,2,-1,0,1,0,-5,-3,2,4,6,-2,0,1,-1,1,1,-1,5,1
KR_6745789681,420,2,-4,24,5,3,4,1,1,2,1,0,2,2,1,5,4,0,1,1,1,8,23,-3,6,3,1,0,-1,-1,-1,-1,1,6,1
KR_6661045176,420,0,-2,-8,-3,-2,0,2,4,5,1,-4,0,4,-1,2,3,0,1,1,0,-3,-11,-1,6,5,-1,0,0,-1,-1,0,-1,2,1
KR_6748560895,420,3,8,9,9,-1,3,4,1,2,1,4,7,3,4,7,3,1,3,2,-1,7,9,2,5,7,-4,0,1,-1,1,1,1,5,1
KR_6702036632,420,0,17,21,-2,-3,1,4,1,2,1,-1,1,2,3,8,5,-2,1,3,0,-1,33,0,4,4,0,0,1,1,-1,-1,-1,4,1
KR_6665983622,420,0,-30,-2,-2,0,3,3,1,1,0,-2,0,2,1,5,4,-2,1,3,0,-2,-46,-6,9,3,29,0,0,-1,1,0,1,1,1
KR_6682940702,420,2,48,43,9,-1,1,2,2,5,3,7,7,0,2,3,1,-1,0,1,0,7,0,-1,6,5,4,0,0,1,-1,1,-1,4,1
KR_6505928743,420,0,-81,7,-6,2,3,1,2,5,3,-2,1,3,-8,0,8,0,0,0,0,-10,7,3,2,5,0,0,-1,0,1,-1,-1,0,1
KR_6752659568,420,0,43,-7,3,-3,0,3,2,4,2,2,4,2,2,3,1,0,0,0,-1,-1,-9,-7,8,1,1,0,-1,1,-1,-1,-1,4,1
KR_6747333967,420,4,22,0,11,0,1,1,-1,2,3,6,9,3,2,5,3,4,4,0,0,11,-108,1,6,7,-1,0,0,0,1,1,1,0,1
KR_6571499241,420,0,20,-19,0,1,3,2,-2,3,5,0,3,3,-1,3,4,2,5,3,2,-3,-7,-7,9,2,2,0,1,-1,-1,1,1,3,1
KR_6744763624,420,-2,73,-8,3,0,0,0,2,3,1,4,6,2,0,1,1,-3,0,3,0,-1,19,0,2,2,1,0,1,-1,1,1,1,1,1
KR_6762689265,440,2,22,-16,8,-2,0,2,9,13,4,1,1,0,-2,3,5,2,3,1,0,11,-6,-2,7,5,-6,0,0,1,-1,0,-1,3,1
KR_6763274943,420,-1,-17,28,-5,-3,2,5,-2,2,4,-2,1,3,1,3,2,1,2,1,0,0,-267,2,1,3,-1,0,0,-1,1,1,-1,2,1
KR_6762596319,420,5,83,20,14,2,6,4,4,7,3,2,6,4,3,3,0,3,3,0,0,3,4,2,2,4,2,0,2,1,0,1,1,6,1
KR_6612001071,420,7,82,12,16,3,4,1,3,4,1,6,7,1,4,4,0,0,1,1,0,11,-12,3,5,8,-1,0,2,1,1,1,-1,6,1
KR_6628145131,420,0,-36,16,1,-1,1,2,0,1,1,0,2,2,2,2,0,0,0,0,0,3,-20,0,2,2,0,0,0,1,1,0,-1,6,1
KR_6667738751,420,2,25,-50,4,6,6,0,-3,4,7,-1,1,2,5,6,1,-3,1,4,0,5,-9,1,6,7,0,0,1,-1,1,1,1,2,1
KR_6763607358,420,7,130,4,9,1,4,3,5,5,0,0,2,2,2,2,0,1,1,0,0,7,136,-1,2,1,-1,0,0,0,-1,0,1,0,1
KR_6682936867,420,0,-4,-5,-2,-4,1,5,3,4,1,-3,0,3,1,2,1,1,2,1,0,2,11,-3,6,3,-6,0,0,1,1,0,-1,5,1
KR_6758527243,420,0,5,-32,4,3,4,1,0,1,1,2,2,0,-1,1,2,0,2,2,0,1,191,-3,5,2,2,0,-1,-1,1,-1,1,1,1
KR_6754401920,420,2,25,-12,8,2,2,0,1,4,3,-4,1,5,11,12,1,-2,3,5,2,7,12,6,0,6,-5,0,1,1,0,1,1,3,1
KR_6680123881,420,-1,2,20,0,3,4,1,1,2,1,0,1,1,-3,5,8,-1,1,2,-1,-7,-4,1,3,4,2,0,1,-1,1,1,-1,3,1
KR_6707266236,420,0,-16,-12,4,-2,1,3,2,3,1,0,2,2,1,4,3,3,5,2,-2,3,-360,-2,5,3,4,0,0,1,-1,0,-1,2,1
KR_6748349504,420,-3,-38,9,-6,-5,1,6,-2,3,5,5,6,1,-4,1,5,0,0,0,-1,-5,-1,1,5,6,2,0,-1,-1,-1,-1,-1,1,1
KR_6741146141,420,3,37,24,4,2,5,3,1,3,2,3,3,0,-2,1,3,0,0,0,0,-4,6,0,5,5,-2,0,2,-1,1,1,1,5,1
KR_6659676569,420,7,51,25,11,2,3,1,-2,3,5,1,2,1,5,6,1,5,5,0,0,9,3,1,2,3,5,0,4,1,1,1,1,5,1
KR_6746319533,420,6,74,32,11,0,3,3,4,4,0,1,1,0,6,6,0,0,0,0,0,11,109,-2,5,3,0,0,1,-1,1,1,1,5,1
KR_6762452915,420,1,27,-20,7,-3,2,5,5,7,2,3,4,1,2,3,1,0,0,0,0,10,19,5,3,8,2,0,0,1,0,0,1,6,1
KR_6760075102,440,2,38,14,-1,-1,3,4,0,1,1,-3,1,4,-2,0,2,5,5,0,0,-10,51,-1,3,2,-20,0,2,-1,1,1,1,6,1
KR_6721959019,420,2,30,19,2,-1,2,3,-4,2,6,2,3,1,5,5,0,0,1,1,0,4,4,3,3,6,0,0,0,1,-1,0,1,6,1
KR_6657487292,420,0,-3,4,1,1,1,0,1,6,5,0,1,1,0,1,1,-1,0,1,0,-1,7,3,4,7,-1,0,1,-1,1,1,1,2,1
KR_5680929916,420,0,89,30,-5,-1,0,1,-3,1,4,2,3,1,-6,1,7,3,3,0,1,-7,3,1,7,8,2,0,1,-1,1,1,1,5,1
KR_6631691904,420,1,-22,12,3,3,4,1,0,3,3,4,5,1,-4,3,7,0,2,2,0,-7,6,2,3,5,-1,0,1,1,-1,-1,1,4,1
KR_6763687111,420,-1,-32,4,-3,0,4,4,-1,2,3,0,2,2,1,2,1,-3,0,3,0,2,-3,1,2,3,0,0,-1,1,1,-1,-1,1,1
KR_6760988912,420,-1,46,-56,6,1,2,1,-2,1,3,2,2,0,6,7,1,-1,0,1,0,8,16,5,3,8,1,0,2,1,-1,1,1,6,1
KR_6758350298,420,0,3,-20,-2,0,2,2,0,0,0,-2,2,4,1,3,2,-1,1,2,0,3,6,4,6,10,-6,0,1,-1,1,1,1,6,1
KR_6740769170,420,1,59,-9,-2,2,5,3,0,3,3,-3,0,3,1,5,4,-2,0,2,0,-4,-26,-5,9,4,-1,0,1,-1,-1,1,1,1,1
KR_6763598827,420,1,-2,48,5,-4,0,4,-1,3,4,0,0,0,7,9,2,3,4,1,0,6,-8,-5,7,2,3,0,-2,1,-1,-1,1,6,1
KR_6694476239,420,2,23,42,8,4,4,0,-1,3,4,2,2,0,0,1,1,3,3,0,1,5,-3,0,2,2,2,0,3,1,0,1,1,2,1
KR_6647730946,420,-1,5,4,-5,-1,0,1,-2,3,5,0,1,1,-3,0,3,1,1,0,0,-5,31,-3,5,2,-1,0,0,-1,-1,0,1,5,1
KR_6758265557,420,4,89,12,7,2,4,2,-1,1,2,1,1,0,2,4,2,3,4,1,0,3,-30,-3,4,1,9,0,0,0,1,0,-1,0,1
KR_6744772377,420,0,9,-16,-6,-1,1,2,-5,1,6,0,2,2,0,4,4,0,1,1,0,-10,0,2,5,7,-2,0,0,-1,1,0,-1,3,1
KR_6740261914,420,-2,45,11,0,1,1,0,1,3,2,-1,3,4,-1,1,2,0,2,2,0,-3,-1,-2,4,2,2,0,1,0,1,1,1,0,1
KR_6686378189,420,2,78,6,4,-4,2,6,0,5,5,8,9,1,0,6,6,0,0,0,4,10,-4,6,4,10,-1,0,1,1,0,1,1,3,1
KR_6735622594,420,2,100,9,4,0,1,1,5,6,1,2,3,1,0,2,2,-3,0,3,0,-7,-10,2,7,9,5,0,1,-1,1,1,-1,6,1
KR_6710224890,420,4,15,16,7,3,3,0,1,5,4,3,3,0,0,2,2,0,0,0,0,6,3,3,3,6,5,0,0,1,1,1,1,3,1
KR_6757557422,420,0,-30,33,-4,-1,1,2,-9,1,10,3,4,1,2,3,1,1,2,1,0,-7,-21,2,4,6,1,0,0,1,-1,0,1,3,1
KR_6648813612,420,1,-49,4,0,-1,0,1,0,1,1,-3,2,5,1,3,2,3,5,2,0,-4,209,0,3,3,5,0,-2,1,-1,1,1,5,1
KR_6609842624,420,3,-8,-3,5,4,4,0,3,5,2,-3,0,3,0,1,1,1,2,1,1,6,16,2,3,5,2,0,0,1,1,0,1,1,1
KR_6676362228,420,2,3,19,2,0,2,2,-2,1,3,4,4,0,3,5,2,-3,0,3,0,7,-3,-2,9,7,1,0,-1,1,-1,1,-1,5,1
KR_6744160468,420,0,24,14,0,3,3,0,-2,2,4,-3,1,4,3,6,3,-1,3,4,0,2,9,5,1,6,-4,0,0,1,1,0,1,1,1
KR_6569824615,420,-2,-77,-31,-7,-2,3,5,0,3,3,-5,1,6,1,6,5,-1,1,2,0,-5,48,3,4,7,1,0,-1,1,-1,-1,-1,2,1
KR_6715627187,420,4,46,24,7,3,4,1,1,2,1,0,4,4,4,5,1,-1,0,1,0,1,1,2,2,4,-3,0,2,1,1,1,1,5,1
KR_6534916599,440,3,21,37,5,0,2,2,-1,2,3,0,1,1,5,5,0,1,3,2,0,-2,19,-2,6,4,1,0,0,1,1,1,1,2,1
KR_6684048883,420,-4,-114,-13,-13,-1,2,3,-1,3,4,-2,2,4,-8,1,9,-1,0,1,-1,-9,-4,-5,9,4,0,0,-1,1,0,-1,-1,3,1
KR_6619411690,420,-2,-62,-12,-3,4,6,2,-3,0,3,-1,1,2,-2,4,6,-1,1,2,0,-2,-4,1,4,5,-1,0,0,-1,1,-1,1,1,1
KR_6665866307,420,2,41,9,5,2,4,2,-1,3,4,2,3,1,3,3,0,-1,1,2,0,1,-2,1,6,7,2,0,1,1,0,1,-1,1,1
KR_6662513950,420,-1,-1,-10,5,-1,1,2,-1,3,4,4,4,0,2,7,5,1,2,1,0,4,-8,0,7,7,2,0,-1,1,-1,-1,-1,2,1
KR_6720278912,420,-3,3,-13,-6,1,2,1,-3,1,4,-7,1,8,2,2,0,1,1,0,0,-1,-2,-1,5,4,1,0,0,0,0,1,1,0,1
KR_6727667960,420,0,-3,-13,-3,-3,0,3,-2,8,10,3,3,0,-2,1,3,1,2,1,0,-2,-7,5,4,9,1,0,0,0,-1,0,-1,0,1
KR_6741721977,420,4,38,-10,3,2,2,0,-2,0,2,4,6,2,0,0,0,-1,0,1,-1,-6,-8,-2,5,3,0,0,0,1,-1,0,-1,2,1
KR_6644830269,420,2,36,23,6,1,1,0,5,5,0,2,2,0,1,3,2,-3,0,3,0,9,-39,0,3,3,0,0,1,1,-1,1,1,1,1
KR_6603854645,420,3,50,11,2,3,3,0,2,3,1,0,5,5,-2,0,2,-1,3,4,-1,0,2,-1,4,3,-1,0,0,1,0,0,-1,6,1
KR_6692875224,420,7,99,13,11,3,4,1,2,6,4,2,2,0,3,5,2,1,1,0,1,18,253,0,3,3,4,0,6,1,1,1,1,1,1
KR_6763805682,420,4,47,0,4,3,3,0,3,3,0,0,1,1,-1,4,5,-1,0,1,0,-1,9,-1,5,4,0,0,1,-1,1,1,1,4,1
KR_6677451435,420,-1,-2,7,2,2,3,1,0,1,1,-1,3,4,1,2,1,0,1,1,0,-1,-23,0,6,6,5,0,1,1,-1,1,1,2,1
KR_6752038777,440,4,1,23,12,3,4,1,1,3,2,3,3,0,4,6,2,1,2,1,0,3,-19,4,1,5,-1,0,1,1,1,1,1,5,1
KR_6693731210,440,7,80,55,15,4,4,0,3,4,1,5,6,1,2,2,0,1,1,0,0,7,8,-3,5,2,0,0,1,1,-1,1,1,5,1
KR_6685375498,420,4,55,-8,10,4,4,0,5,7,2,0,3,3,2,3,1,-1,0,1,-1,7,4,5,4,9,-1,0,1,1,1,1,-1,4,1
KR_6761682518,420,2,-47,-8,-2,-2,2,4,-2,1,3,-2,0,2,4,5,1,0,1,1,0,-2,-12,-7,10,3,3,0,0,1,-1,-1,-1,4,1
KR_6756308444,420,0,21,-12,6,0,1,1,0,5,5,1,2,1,4,6,2,1,2,1,0,2,1,0,6,6,1,0,0,1,0,1,1,1,1
KR_6692053190,420,1,58,5,2,0,1,1,1,3,2,1,3,2,1,7,6,-1,0,1,0,0,214,1,5,6,-2,0,1,1,-1,1,-1,2,1
KR_6757141779,420,4,53,17,2,-4,1,5,-2,1,3,3,6,3,-2,3,5,7,7,0,0,11,5,-3,9,6,-7,0,1,1,-1,1,1,6,1
KR_6627699691,420,0,-24,-4,6,-1,3,4,4,5,1,-1,0,1,3,4,1,1,1,0,0,10,-51,-2,3,1,19,0,0,-1,1,0,1,3,1
KR_6760984264,420,3,-8,28,9,-3,1,4,2,5,3,1,3,2,10,10,0,-1,1,2,0,9,6,-3,7,4,4,0,0,0,1,1,1,0,1
KR_6669480746,420,-1,48,-40,2,-3,0,3,-2,1,3,4,5,1,5,8,3,-2,0,2,-1,-2,90,-6,13,7,10,0,0,-1,-1,0,-1,6,1
KR_6714270441,420,1,19,20,4,-4,1,5,7,9,2,1,2,1,0,1,1,0,0,0,0,6,-13,2,2,4,5,0,1,1,0,1,1,5,1
KR_6746633516,420,3,45,0,18,3,5,2,1,4,3,-1,3,4,12,15,3,3,3,0,1,18,0,5,2,7,3,0,3,-1,1,1,1,3,1
KR_6761678917,420,2,29,-23,7,1,2,1,2,6,4,0,1,1,4,4,0,0,1,1,0,12,-7,-3,10,7,7,0,1,1,-1,1,1,2,1
KR_6490720903,420,3,88,-42,4,0,1,1,0,5,5,2,3,1,2,2,0,0,1,1,-2,1,-1,-1,4,3,2,0,1,-1,1,1,-1,1,1
KR_6757834645,420,2,64,32,-2,-6,0,6,4,4,0,0,2,2,0,2,2,0,0,0,1,7,-5,1,4,5,1,0,-1,1,-1,-1,1,4,1
KR_6683439246,420,1,-4,-24,4,2,3,1,-1,1,2,0,0,0,2,3,1,1,3,2,2,5,-90,5,3,8,1,0,1,1,1,1,1,4,1
KR_6727339544,420,6,-2,-12,13,-1,1,2,6,6,0,-2,1,3,10,10,0,0,0,0,0,21,2,7,4,11,4,0,1,1,1,1,-1,2,1
KR_6750502252,420,2,-2,20,4,-1,2,3,8,8,0,-1,3,4,-1,1,2,-1,1,2,0,12,3,1,4,5,0,0,1,1,-1,1,1,6,1
KR_6586711708,420,1,92,-4,-1,1,2,1,-4,2,6,-4,1,5,7,9,2,-1,0,1,0,-4,4,5,5,10,-1,0,1,1,1,1,-1,6,1
KR_6756353442,420,1,18,-4,5,-2,2,4,0,4,4,1,1,0,4,8,4,2,3,1,4,13,-70,-2,4,2,20,0,0,-1,-1,1,1,6,1
KR_6633534416,420,0,1,5,2,-1,3,4,-1,1,2,1,3,2,2,5,3,1,2,1,0,3,20,5,1,6,-3,0,1,0,1,1,1,0,1
KR_6708625022,420,1,36,41,7,0,1,1,0,4,4,5,6,1,4,8,4,-2,1,3,0,0,-6,0,6,6,-1,0,0,-1,0,0,1,5,1
KR_6745913203,420,0,4,-15,-2,3,3,0,0,4,4,-4,1,5,-2,1,3,1,3,2,-1,-2,4,-2,6,4,-2,0,1,-1,0,1,-1,4,1
KR_6651354084,420,3,37,-20,7,-2,0,2,3,4,1,2,3,1,4,5,1,0,1,1,0,9,-18,-2,4,2,3,0,-1,1,-1,-1,1,1,1
KR_6692897309,420,2,76,3,3,5,6,1,0,4,4,0,1,1,-2,3,5,0,0,0,0,-3,-1,-3,6,3,1,0,1,-1,1,1,1,2,1
KR_6629055353,420,1,1,16,7,3,3,0,1,2,1,1,1,0,2,2,0,0,0,0,0,7,193,1,5,6,4,0,1,-1,1,1,1,4,1
KR_6737998694,420,0,1,20,-3,-1,1,2,-1,4,5,-2,0,2,3,6,3,-2,0,2,0,-5,2,1,3,4,1,0,0,1,-1,0,1,3,1
KR_6749448305,420,4,40,4,11,1,2,1,1,1,0,5,6,1,1,5,4,3,3,0,0,12,3,3,1,4,-1,0,-1,1,-1,-1,1,4,1
KR_6759918490,420,1,-25,0,2,0,1,1,5,6,1,-1,1,2,0,3,3,-2,1,3,0,4,-1,-2,10,8,1,0,-1,1,-1,-1,1,5,1
KR_6739045069,420,-1,63,-28,0,0,4,4,-4,2,6,6,6,0,2,6,4,-4,0,4,0,-7,-17,-3,7,4,5,0,0,-1,1,1,1,1,1
KR_6696428165,420,4,52,56,7,2,3,1,-1,2,3,1,3,2,5,6,1,0,1,1,0,7,15,-1,6,5,-4,0,0,1,1,0,1,1,1
KR_6759585538,440,-5,-124,-8,-6,-6,0,6,3,4,1,-1,1,2,1,2,1,-3,0,3,0,7,-1,2,2,4,2,0,-2,1,-1,-1,-1,3,1
KR_6703768513,420,2,-15,27,2,0,3,3,1,2,1,3,4,1,-2,0,2,0,0,0,0,2,126,-1,5,4,6,0,0,1,-1,-1,1,1,1
KR_6712509374,420,0,-66,20,1,2,2,0,2,3,1,-1,1,2,-1,3,4,-1,0,1,0,7,5,1,4,5,0,0,0,1,1,0,-1,1,1
KR_6749744869,420,0,60,-8,-6,-2,1,3,0,0,0,2,3,1,-3,1,4,-3,0,3,0,-6,119,1,4,5,2,0,-1,-1,1,-1,1,3,1
KR_6760811759,420,3,0,4,6,2,2,0,4,6,2,6,9,3,-3,1,4,-3,2,5,0,-3,2,1,1,2,1,0,0,-1,1,-1,1,5,1
KR_6629664205,420,0,-27,-4,3,1,3,2,3,3,0,-2,1,3,1,3,2,0,1,1,0,7,19,2,5,7,0,0,-1,1,1,-1,1,5,1
KR_6727958254,420,4,-2,8,15,2,4,2,2,3,1,0,1,1,9,9,0,2,2,0,0,18,-27,1,4,5,20,0,0,0,1,1,1,0,1
KR_6759770347,420,0,-25,30,3,2,2,0,-4,0,4,2,3,1,2,2,0,1,3,2,-1,-1,-226,-1,4,3,-1,0,0,1,-1,0,-1,6,1
KR_6761213255,420,1,-58,24,4,3,4,1,-1,4,5,0,2,2,0,3,3,2,2,0,0,3,5,3,2,5,3,0,0,0,-1,1,1,0,1
KR_6751382792,440,-1,2,15,-1,1,2,1,0,3,3,-2,1,3,1,2,1,-1,0,1,0,1,-107,-3,7,4,-1,0,1,1,-1,1,-1,6,1
KR_6728462331,420,4,74,4,10,6,6,0,0,3,3,3,3,0,1,1,0,0,0,0,0,2,4,-2,4,2,-2,0,0,1,1,1,1,5,1
KR_6708477749,420,2,64,-18,7,2,2,0,3,4,1,-3,0,3,1,3,2,4,4,0,0,12,5,4,4,8,-1,0,2,-1,1,1,1,2,1
KR_6764674385,420,7,92,43,13,4,4,0,0,3,3,6,6,0,2,4,2,1,1,0,1,13,4,1,4,5,3,0,1,1,1,1,1,4,1
KR_6759592588,420,0,67,0,-2,3,4,1,-3,2,5,-3,1,4,1,2,1,0,1,1,-1,-4,-24,-2,6,4,-1,0,1,1,-1,1,-1,6,1
KR_6698888696,420,-1,14,-13,1,-5,0,5,-2,0,2,1,3,2,6,7,1,1,4,3,-1,1,8,0,2,2,-1,0,1,-1,1,1,-1,5,1
KR_6745064675,420,-2,-79,-3,-3,-5,0,5,2,5,3,-1,2,3,1,2,1,0,2,2,0,11,16,5,1,6,-1,0,-1,-1,-1,-1,-1,5,1
KR_6518678243,420,-2,-35,-32,1,0,2,2,2,5,3,2,5,3,-4,4,8,1,1,0,1,9,-36,1,5,6,3,0,1,-1,1,1,1,1,1
KR_6679069940,440,5,21,24,14,6,7,1,2,6,4,1,2,1,2,4,2,3,3,0,0,12,-14,-1,2,1,-1,0,1,0,1,1,1,0,1
KR_6696207690,420,2,35,-16,2,3,3,0,0,2,2,0,5,5,-5,1,6,4,4,0,0,1,11,-1,4,3,1,0,1,-1,1,1,1,2,1
KR_6741101321,420,2,-38,-21,7,0,2,2,1,2,1,7,7,0,-1,3,4,0,0,0,0,11,-19,-1,4,3,0,0,0,-1,-1,-1,-1,4,1
KR_6396659257,420,-1,-5,-16,4,2,4,2,5,8,3,2,3,1,-3,2,5,-2,0,2,1,6,7,5,7,12,-5,0,1,-1,1,-1,-1,1,1
KR_6726504612,440,3,-16,46,5,2,2,0,-1,0,1,-1,3,4,5,6,1,0,0,0,-1,0,1,1,5,6,0,0,1,1,0,1,-1,2,1
KR_6675854276,420,0,58,9,4,2,2,0,-2,1,3,-1,2,3,5,5,0,0,0,0,0,-2,-1,2,4,6,2,0,1,1,1,1,1,3,1
KR_6755085832,420,2,1,8,6,2,2,0,-4,1,5,3,5,2,3,5,2,2,2,0,0,5,6,8,1,9,3,0,0,1,1,0,1,2,1
KR_6665060458,420,4,77,16,7,1,2,1,0,1,1,1,1,0,2,5,3,3,3,0,0,10,0,2,4,6,1,0,1,1,1,1,1,5,1
KR_6758939828,420,4,57,8,2,1,2,1,2,6,4,-6,0,6,4,6,2,1,2,1,0,2,-11,-6,10,4,7,0,1,0,-1,1,-1,0,1
KR_6752750941,420,0,10,-23,4,-3,0,3,-1,1,2,7,8,1,3,3,0,-2,0,2,0,-1,23,1,5,6,-1,0,0,1,0,1,1,6,1
KR_6628671602,420,0,-8,-10,0,2,2,0,2,4,2,0,0,0,-3,0,3,-1,0,1,0,0,-1,3,3,6,2,0,0,1,1,0,1,1,1
KR_6474767735,420,9,153,55,15,3,3,0,3,4,1,5,7,2,3,8,5,1,2,1,0,5,-102,2,1,3,4,0,2,1,1,1,1,2,1
KR_6669310534,420,-3,2,8,-1,-3,1,4,3,5,2,-1,2,3,1,4,3,-1,4,5,1,8,-112,6,4,10,1,0,-1,-1,1,-1,1,2,1
KR_6693593037,420,-2,-32,12,-3,-2,2,4,2,5,3,-1,5,6,1,3,2,-3,0,3,1,0,-1,-1,5,4,1,0,-1,1,-1,-1,1,5,1
KR_6597355868,420,2,7,-2,10,2,4,2,6,8,2,4,6,2,0,4,4,-2,0,2,-1,7,22,3,3,6,-7,0,1,-1,-1,1,-1,4,1
KR_6719037225,420,7,36,32,17,0,1,1,4,7,3,2,2,0,10,11,1,1,2,1,0,20,1,2,2,4,2,0,1,1,1,1,1,4,1
KR_6740192115,420,2,-6,-3,6,1,4,3,-1,2,3,1,2,1,4,6,2,1,3,2,0,2,-106,3,3,6,1,0,0,1,1,-1,-1,5,1
KR_6471029656,420,1,-48,39,-1,-2,0,2,3,6,3,8,8,0,-3,2,5,-7,1,8,0,-8,21,-3,7,4,-4,0,0,1,1,0,-1,6,1
KR_6547418835,420,2,84,-11,2,3,3,0,-1,2,3,0,2,2,-3,0,3,3,3,0,0,2,-11,1,2,3,3,0,1,0,1,1,-1,0,1
KR_6761839890,440,1,92,0,4,6,8,2,-3,0,3,1,4,3,-2,1,3,2,3,1,0,-6,2,4,2,6,-2,0,1,1,-1,1,1,5,1
KR_6717237040,420,4,48,28,9,1,6,5,4,5,1,-1,1,2,3,3,0,2,4,2,0,5,-6,-1,3,2,2,0,2,0,-1,1,-1,0,1
KR_6764092131,420,0,3,-1,-3,1,2,1,-2,0,2,-3,2,5,1,5,4,0,3,3,0,-5,28,-2,4,2,-1,0,0,-1,1,-1,1,4,1
KR_6756993177,420,0,-30,-28,-3,1,2,1,-3,2,5,0,3,3,-1,2,3,0,1,1,0,-14,91,-4,8,4,2,0,0,-1,-1,0,-1,1,1
KR_6761061167,420,1,75,-2,-1,-1,1,2,-1,0,1,3,3,0,-1,3,4,-1,0,1,0,-3,49,1,6,7,-18,0,-1,-1,1,-1,-1,5,1
KR_6725103539,420,0,-40,-4,1,1,3,2,1,5,4,4,5,1,-5,4,9,0,0,0,0,7,-62,3,3,6,-4,0,0,0,1,-1,1,0,1
KR_6496153956,420,-1,-31,20,-5,-4,0,4,3,5,2,0,4,4,-4,0,4,0,1,1,0,-3,23,-3,9,6,-6,0,0,-1,1,0,1,1,1
KR_6760433705,440,-2,31,-24,0,-4,1,5,-2,2,4,0,1,1,6,6,0,0,3,3,0,8,18,1,2,3,-2,0,1,1,-1,1,1,6,1
KR_6581211461,420,3,9,7,7,2,3,1,2,2,0,2,3,1,3,5,2,-2,2,4,0,8,31,-2,5,3,-2,0,0,1,-1,-1,-1,2,1
KR_6572199778,420,-1,-66,-8,1,0,2,2,4,8,4,-2,2,4,0,2,2,-1,0,1,0,1,24,8,5,13,-5,0,0,1,-1,0,-1,2,1
KR_6756150115,440,4,44,-19,14,4,5,1,0,0,0,2,2,0,7,8,1,1,2,1,0,19,0,3,5,8,3,0,1,1,-1,1,1,5,1
KR_6610086160,420,4,12,24,4,4,4,0,2,3,1,-1,4,5,0,3,3,-1,0,1,0,4,-17,1,3,4,3,0,1,1,1,1,1,6,1
KR_6756976037,420,2,10,6,1,3,3,0,-3,2,5,-2,3,5,3,3,0,0,0,0,0,4,3,5,1,6,-4,0,1,1,1,1,-1,6,1
KR_6757386689,420,2,1,21,3,-10,4,14,2,3,1,2,2,0,6,9,3,3,3,0,0,0,16,-1,5,4,-3,0,1,-1,0,1,1,3,1
KR_6601601918,420,-2,-41,-1,-9,0,0,0,-7,3,10,-2,2,4,1,5,4,-1,0,1,0,-13,3,-2,5,3,-2,0,0,1,-1,0,-1,4,1
KR_6588228055,420,2,-24,16,8,0,1,1,5,5,0,2,3,1,2,3,1,-1,0,1,0,14,4,4,6,10,5,0,0,-1,-1,0,1,3,1
KR_6764301493,420,5,25,-22,7,1,3,2,1,1,0,2,2,0,3,5,2,0,0,0,0,6,-11,4,1,5,2,0,1,-1,-1,1,1,5,1
KR_6708786819,440,2,14,-7,5,-4,2,6,2,4,2,1,4,3,4,4,0,2,2,0,3,15,6,5,3,8,-3,0,1,1,-1,1,1,5,1
KR_6755810149,420,-2,3,7,-6,1,1,0,-9,0,9,8,8,0,-4,0,4,-2,0,2,0,-14,32,0,4,4,-23,0,0,-1,-1,0,1,2,1
KR_6762433071,420,5,45,16,15,-2,0,2,6,7,1,2,2,0,2,4,2,7,7,0,2,23,5,6,1,7,-3,0,3,1,1,1,1,4,1
KR_6731294191,420,1,32,20,0,0,1,1,2,3,1,-4,2,6,2,4,2,0,0,0,0,6,-3,3,3,6,0,0,0,1,-1,0,-1,2,1
KR_6763575245,420,2,15,20,7,-3,0,3,2,2,0,7,9,2,1,1,0,0,2,2,0,10,19,3,2,5,1,0,0,1,1,0,-1,6,1
KR_6760382454,420,2,-3,4,4,1,3,2,0,1,1,3,7,4,0,1,1,0,0,0,1,-1,-219,-1,4,3,1,0,0,-1,-1,0,1,5,1
KR_6754044175,420,2,13,4,2,0,2,2,-3,0,3,4,9,5,-1,2,3,2,3,1,-1,1,-84,-1,9,8,0,0,1,1,1,1,1,5,1
KR_6708230467,420,3,38,26,7,6,8,2,-2,1,3,2,2,0,2,2,0,-1,0,1,0,4,-5,1,5,6,3,0,0,1,1,0,-1,5,1
KR_6764392359,440,2,30,0,-1,9,9,0,0,2,2,-5,1,6,-5,0,5,0,0,0,0,-5,1,-2,4,2,1,0,0,0,1,1,1,0,1
KR_6057180588,420,1,6,-8,6,2,3,1,5,8,3,-3,1,4,2,3,1,0,2,2,0,8,51,2,3,5,-6,0,1,1,0,1,1,2,1
KR_6761372747,420,4,-1,17,3,3,3,0,-3,3,6,2,6,4,1,2,1,0,0,0,0,-3,-223,2,1,3,1,0,1,1,1,1,1,2,1
KR_6724460403,440,1,-11,13,-4,8,8,0,-8,0,8,4,7,3,-3,1,4,-5,0,5,-1,-20,-32,0,2,2,1,0,2,1,1,1,1,5,1
KR_6695342676,420,-1,-10,-12,2,-4,0,4,7,10,3,1,4,3,-1,3,4,-1,1,2,0,12,157,1,5,6,-7,0,-2,1,-1,-1,1,2,1
KR_6761514571,420,0,98,5,-3,-1,2,3,-3,4,7,-1,1,2,2,2,0,0,0,0,0,0,0,-1,5,4,2,0,2,1,1,1,1,5,1
KR_6737723788,420,7,56,33,9,3,3,0,3,6,3,4,5,1,-3,4,7,2,2,0,0,8,4,2,1,3,4,0,1,1,1,1,1,4,1
KR_6728201929,440,4,29,21,6,0,2,2,3,6,3,0,0,0,2,3,1,1,1,0,0,3,-224,-2,7,5,6,0,0,0,1,1,1,0,1
KR_6676064103,440,0,-29,-12,-1,-1,0,1,2,3,1,-2,0,2,0,1,1,0,1,1,0,0,4,1,3,4,-1,0,1,0,1,1,-1,0,1
KR_6730853065,420,0,30,1,6,5,6,1,2,5,3,-1,2,3,-2,4,6,2,3,1,0,5,10,1,6,7,3,0,2,-1,1,1,1,6,1
KR_6757276786,420,2,1,0,0,3,5,2,0,3,3,-2,1,3,-2,5,7,1,2,1,0,-1,-2,7,2,9,-3,0,0,1,-1,0,1,1,1
KR_6627020395,420,1,75,12,6,5,5,0,3,3,0,-2,1,3,0,1,1,0,0,0,0,0,2,2,4,6,5,0,1,-1,1,1,-1,1,1
KR_6717114294,420,0,74,24,-12,-1,0,1,-6,0,6,-2,2,4,-3,0,3,0,1,1,0,-17,26,-1,5,4,4,0,0,1,-1,-1,-1,4,1
KR_6697141173,420,-3,-52,-39,-2,0,3,3,1,1,0,-3,3,6,0,0,0,0,1,1,0,2,-11,3,4,7,5,0,0,-1,-1,0,1,5,1
KR_6761729745,440,-1,54,-88,1,-1,2,3,-3,2,5,-3,0,3,7,7,0,1,2,1,0,5,-305,3,0,3,-1,0,1,-1,0,1,-1,4,1
KR_6703398588,420,1,23,-20,2,-1,2,3,2,3,1,0,3,3,5,6,1,-4,0,4,-1,5,-257,-8,11,3,5,0,0,1,-1,-1,-1,4,1
KR_6760234143,420,1,35,11,7,0,4,4,3,4,1,0,3,3,3,5,2,1,4,3,0,7,11,4,1,5,-2,0,2,1,1,1,1,3,1
KR_6759354777,440,3,104,28,15,0,1,1,6,7,1,-1,2,3,8,9,1,2,2,0,0,8,-36,-2,3,1,2,0,1,1,1,1,1,4,1
KR_6324917614,440,1,-51,16,4,-1,3,4,4,7,3,4,5,1,-2,1,3,-1,2,3,0,13,-11,6,2,8,-2,0,-1,1,-1,-1,-1,6,1
KR_6759756136,420,3,47,-9,8,2,3,1,1,1,0,2,2,0,6,8,2,-3,0,3,-1,3,-4,5,3,8,3,0,3,-1,1,1,-1,4,1
KR_6746624852,420,0,24,-6,-6,-3,0,3,-3,0,3,1,2,1,-2,2,4,1,3,2,0,-6,-4,-6,8,2,4,0,2,1,1,1,1,4,1
KR_6592120543,420,2,4,3,5,-1,4,5,9,9,0,0,2,2,-3,0,3,0,0,0,0,3,3,4,4,8,0,0,1,-1,1,1,1,1,1
KR_6764420878,420,-2,23,-12,-5,4,4,0,-5,1,6,-2,1,3,-1,0,1,-1,0,1,-1,-14,-8,4,4,8,1,0,-1,-1,-1,-1,-1,3,1
KR_6764661043,420,0,-4,-12,4,-2,3,5,3,4,1,4,5,1,-1,5,6,0,3,3,0,5,-2,5,4,9,-4,0,-1,1,-1,-1,-1,1,1
KR_6703355409,440,0,41,-9,3,3,3,0,0,0,0,1,2,1,1,4,3,-2,0,2,0,4,-3,-2,6,4,3,0,1,-1,1,1,1,4,1
KR_6729543298,420,5,122,29,9,3,5,2,0,5,5,2,6,4,3,5,2,1,2,1,0,3,5,2,4,6,3,0,1,1,1,1,1,2,1
KR_6615478902,420,4,47,-22,5,-3,2,5,-3,0,3,5,6,1,5,6,1,1,5,4,0,11,-7,-6,6,0,1,0,-1,1,-1,-1,1,2,1
KR_6730397311,420,1,-26,31,-2,-2,0,2,6,9,3,-3,1,4,-5,0,5,2,2,0,0,-1,-2,8,2,10,4,0,1,-1,1,1,-1,6,1
KR_6571192824,420,5,9,39,10,7,8,1,2,3,1,1,3,2,-2,3,5,2,2,0,0,5,5,-1,3,2,-3,0,1,1,1,1,-1,5,1
KR_6568708597,420,6,116,38,12,3,4,1,4,8,4,-1,1,2,6,7,1,0,2,2,0,8,22,0,3,3,1,0,1,1,-1,1,1,5,1
KR_6747391601,420,3,12,104,0,2,4,2,7,7,0,-5,0,5,-1,1,2,-3,0,3,1,6,29,3,1,4,3,0,1,1,1,-1,1,3,1
KR_6729109497,420,0,52,5,-2,-2,0,2,-4,2,6,2,3,1,1,3,2,1,1,0,2,-8,-78,2,4,6,-3,0,2,1,1,1,1,2,1
KR_6733585952,420,1,24,-16,9,5,6,1,5,6,1,3,6,3,-2,3,5,-2,0,2,-1,7,-18,1,3,4,-4,0,0,-1,0,1,-1,2,1
KR_6759666544,420,2,56,12,-4,-1,1,2,0,4,4,-1,1,2,-1,3,4,-1,0,1,0,-1,20,-2,5,3,1,0,1,0,0,1,-1,0,1
KR_6741436914,440,2,38,23,3,-4,1,5,4,4,0,0,2,2,3,3,0,0,1,1,0,-2,3,0,5,5,4,0,1,1,1,1,1,6,1
KR_6681093731,420,1,26,35,1,-2,1,3,0,4,4,2,3,1,0,2,2,1,3,2,1,1,10,1,6,7,1,0,0,1,1,1,1,3,1
KR_6627720796,420,3,15,27,3,1,1,0,2,4,2,3,3,0,-2,0,2,-1,0,1,0,1,-6,-1,6,5,-4,0,0,-1,1,0,1,3,1
KR_6604210595,420,0,8,-8,1,-2,0,2,1,5,4,1,3,2,0,2,2,1,3,2,0,1,-508,0,3,3,4,0,1,-1,0,1,-1,2,1
KR_6615557554,420,-2,-21,-20,-4,6,7,1,-5,1,6,-1,2,3,-6,0,6,2,2,0,0,-3,2,0,5,5,-6,0,0,-1,-1,1,1,4,1
KR_6752125043,420,0,-43,-8,5,0,2,2,-3,0,3,2,2,0,4,6,2,2,2,0,0,2,0,4,4,8,-1,0,0,-1,-1,-1,1,4,1
KR_6720155751,420,1,38,27,-1,5,6,1,0,3,3,3,4,1,-11,1,12,2,4,2,-2,-7,-5,-3,5,2,3,0,2,-1,1,1,-1,2,1
KR_6728961588,420,1,-18,20,4,0,3,3,5,10,5,2,3,1,-5,2,7,2,3,1,0,-4,15,-2,6,4,-3,0,2,0,1,1,-1,0,1
KR_6702831750,420,-1,-21,-15,-3,-4,0,4,-3,2,5,3,5,2,1,2,1,0,0,0,0,11,8,0,4,4,1,0,0,1,-1,0,-1,4,1
KR_6729870492,420,1,15,37,9,-1,0,1,4,6,2,4,5,1,0,4,4,2,2,0,0,4,8,7,3,10,1,0,0,0,1,0,1,0,1
KR_6576387383,420,0,18,-14,4,-5,2,7,-1,2,3,0,0,0,9,9,0,1,3,2,0,5,50,1,4,5,-11,0,1,-1,1,1,-1,1,1
KR_6660341954,420,1,25,-7,4,1,3,2,-2,2,4,-1,1,2,7,8,1,-1,1,2,0,6,53,7,2,9,-24,0,0,-1,1,1,1,1,1
KR_6736283390,420,0,-16,24,3,0,1,1,-2,1,3,-1,4,5,5,7,2,1,2,1,0,8,3,-2,5,3,5,0,1,1,1,1,-1,5,1
KR_6735426975,420,2,89,4,2,-5,0,5,2,3,1,-3,1,4,6,7,1,2,2,0,0,4,0,1,2,3,0,0,2,-1,-1,1,-1,4,1
KR_6729999127,420,2,88,-20,10,0,0,0,2,3,1,3,8,5,3,3,0,2,2,0,0,16,3,-1,3,2,-4,0,3,-1,0,1,1,5,1
KR_6762927551,420,-2,-49,-16,-2,-1,0,1,-1,1,2,-2,2,4,2,3,1,0,0,0,0,2,33,3,1,4,-24,0,0,0,-1,0,-1,0,1
KR_6730638374,420,2,26,24,4,6,6,0,1,2,1,-5,1,6,2,9,7,0,1,1,-1,3,-172,1,1,2,2,0,0,1,-1,1,-1,5,1
KR_6757975418,420,3,9,0,9,1,4,3,2,3,1,-4,0,4,8,8,0,2,2,0,0,10,-1,-1,4,3,4,0,0,1,0,0,-1,5,1
KR_6669067179,420,-4,-58,34,-3,1,3,2,-2,2,4,-2,2,4,-1,1,2,1,3,2,0,-8,5,5,2,7,-2,0,-2,-1,1,-1,1,4,1
KR_6604048100,420,3,74,25,16,3,4,1,0,3,3,5,5,0,11,13,2,-3,1,4,0,16,-4,0,3,3,2,0,3,1,1,1,1,4,1
KR_6641453886,420,-1,-27,-24,-5,3,5,2,-2,1,3,-4,1,5,-2,3,5,0,0,0,-2,-5,2,0,4,4,1,0,0,-1,0,-1,-1,4,1
KR_6761225568,440,5,130,40,12,0,1,1,4,5,1,2,3,1,8,8,0,-2,1,3,0,7,3,1,0,1,-1,0,3,1,1,1,1,2,1
KR_6664095648,420,0,21,-19,-2,1,2,1,-3,1,4,-1,2,3,4,8,4,-3,0,3,-1,-2,-6,-5,7,2,6,0,0,-1,-1,1,-1,6,1
KR_6761215767,420,-3,-14,-16,-3,0,1,1,-2,0,2,2,2,0,-2,1,3,-1,0,1,0,-6,-121,5,2,7,-2,0,0,1,-1,-1,-1,4,1
KR_6680300367,440,2,20,12,5,-3,2,5,2,4,2,2,3,1,1,2,1,3,4,1,0,9,2,1,1,2,2,0,-1,1,-1,-1,1,3,1
KR_6762978923,440,3,117,-32,-1,0,1,1,9,9,0,-7,4,11,0,2,2,-3,5,8,-1,12,5,2,2,4,0,0,2,1,-1,1,-1,5,1
KR_6756116193,420,5,67,-4,15,6,7,1,1,2,1,4,5,1,5,7,2,-1,0,1,0,14,-50,-3,7,4,21,0,2,1,1,1,-1,1,1
KR_6675865137,420,4,-17,16,13,5,5,0,3,3,0,2,4,2,3,3,0,0,2,2,0,9,5,3,3,6,3,0,1,-1,1,1,1,6,1
KR_6761797107,420,6,71,39,11,1,1,0,0,1,1,5,5,0,6,8,2,-1,2,3,0,2,-125,-2,5,3,0,0,1,1,1,1,1,1,1
KR_6763751869,420,2,14,-4,0,1,1,0,2,5,3,0,0,0,1,1,0,-4,1,5,0,3,-29,3,2,5,7,0,1,1,0,1,1,2,1
KR_6715990472,440,-1,-5,0,2,3,3,0,0,3,3,-2,2,4,1,2,1,0,1,1,0,6,1,3,1,4,4,0,1,-1,1,1,-1,1,1
KR_6763646055,420,2,27,4,1,7,7,0,-2,1,3,-1,1,2,-2,0,2,-1,1,2,0,-6,-8,1,2,3,-1,0,1,-1,1,1,-1,6,1
KR_6723570861,420,1,14,-1,6,1,2,1,4,5,1,1,2,1,-2,1,3,2,2,0,0,5,2,3,2,5,1,0,0,1,1,0,1,3,1
KR_6726828812,420,1,36,-31,2,3,3,0,4,4,0,-5,0,5,0,1,1,0,0,0,-2,1,-8,-3,7,4,1,0,1,-1,-1,1,-1,6,1
KR_6763248242,440,1,-19,-20,2,2,6,4,-3,4,7,0,4,4,2,4,2,1,2,1,2,-5,-2,1,5,6,-2,0,0,-1,0,0,1,6,1
KR_6693773547,420,8,91,51,15,7,7,0,6,7,1,2,2,0,0,0,0,0,0,0,0,6,353,1,2,3,0,0,2,1,1,1,1,1,1
KR_6761616622,420,1,-29,20,7,-2,0,2,4,5,1,-1,1,2,6,6,0,0,1,1,3,9,2,4,4,8,2,0,0,1,1,1,1,4,1
KR_6727993788,420,5,71,25,3,4,5,1,0,2,2,0,3,3,1,2,1,-2,1,3,0,1,-8,-3,6,3,2,0,-2,-1,-1,1,1,1,1
KR_6764361181,420,0,-25,-16,3,1,3,2,0,6,6,4,4,0,-1,3,4,-1,1,2,0,-1,-18,2,5,7,8,0,0,1,-1,1,1,5,1
KR_6749137681,440,2,-32,7,1,-2,1,3,0,2,2,3,5,2,-3,0,3,3,3,0,0,-6,5,-5,10,5,2,0,0,1,0,0,1,4,1
KR_6602916484,420,3,23,-23,6,0,0,0,1,1,0,-1,2,3,4,4,0,2,2,0,0,10,0,-1,4,3,2,0,0,-1,1,1,1,5,1
KR_6678229197,420,4,56,7,3,7,8,1,0,0,0,-4,1,5,-1,5,6,1,2,1,0,2,-24,1,2,3,0,0,1,1,-1,1,-1,5,1
KR_6764052693,420,3,57,-15,5,-1,2,3,4,4,0,-3,3,6,6,6,0,-1,0,1,0,9,0,-1,4,3,5,0,0,1,-1,1,1,3,1
KR_6738857139,420,7,79,0,11,0,3,3,4,6,2,0,4,4,7,7,0,0,0,0,1,19,-98,-1,7,6,7,0,1,1,-1,1,1,5,1
KR_6756264759,420,0,13,6,-1,-1,1,2,0,3,3,0,1,1,-1,0,1,1,1,0,0,0,59,-3,3,0,-1,0,0,0,1,0,1,0,1
KR_6754599217,420,0,-67,11,3,-2,0,2,5,6,1,5,11,6,-3,1,4,-2,0,2,0,5,-6,4,4,8,7,0,1,1,1,1,-1,3,1
KR_6679874450,420,2,48,27,3,4,4,0,1,3,2,-1,1,2,-1,4,5,0,3,3,1,1,-29,0,5,5,6,0,0,-1,-1,0,1,2,1
KR_6703758863,420,4,29,-3,5,6,8,2,-3,3,6,-5,0,5,4,5,1,3,3,0,0,6,5,0,2,2,2,0,3,-1,-1,1,1,2,1
KR_6755330256,420,2,35,-38,5,-1,0,1,-2,1,3,2,2,0,6,7,1,0,2,2,0,2,3,-2,4,2,-5,0,1,-1,0,1,1,1,1
KR_6587574442,420,6,56,12,9,-5,0,5,0,1,1,-1,3,4,7,8,1,8,8,0,0,10,1,-3,6,3,0,0,2,1,0,1,1,2,1
KR_6757754989,440,0,-35,15,-9,-3,0,3,-3,2,5,-2,1,3,4,5,1,-5,0,5,-1,-13,-7,-4,7,3,1,0,0,-1,-1,0,1,3,1
KR_6669202998,420,0,-58,26,-3,-4,1,5,2,7,5,4,4,0,-4,3,7,-1,1,2,-1,-4,42,-6,10,4,-12,0,0,1,-1,0,-1,2,1
KR_5606205937,420,4,8,8,8,0,1,1,6,8,2,0,4,4,2,3,1,0,0,0,0,14,-6,-4,8,4,-2,0,0,-1,-1,1,-1,3,1
KR_6644458133,420,2,109,36,3,0,2,2,7,10,3,-1,1,2,-2,4,6,-1,1,2,1,15,-6,-1,4,3,-2,0,0,1,-1,-1,1,4,1
KR_6752876945,420,3,63,12,5,3,4,1,1,2,1,-3,1,4,0,6,6,4,5,1,0,0,-7,0,6,6,-2,0,3,1,1,1,-1,1,1
KR_6754627219,440,-1,39,-5,1,2,4,2,-7,2,9,3,4,1,2,2,0,1,1,0,0,-3,-43,0,6,6,34,0,0,0,0,0,-1,0,1
KR_6751347739,420,3,42,-16,2,0,1,1,-3,2,5,-3,0,3,8,9,1,0,0,0,0,3,4,2,5,7,3,0,1,-1,1,1,1,3,1
KR_6754555428,440,4,35,30,13,2,3,1,9,12,3,1,2,1,-1,4,5,2,2,0,0,6,6,3,2,5,-1,0,0,1,1,1,-1,2,1
KR_6751706541,420,4,35,-10,11,2,4,2,-2,2,4,7,8,1,0,5,5,4,5,1,0,10,-31,6,2,8,10,0,4,-1,1,1,1,2,1
KR_6738259824,420,2,22,10,3,-3,0,3,-1,2,3,2,3,1,4,7,3,1,3,2,-1,2,-5,-1,5,4,2,0,1,0,0,1,-1,0,1
KR_6728614262,420,3,32,-3,13,7,7,0,1,3,2,2,3,1,2,2,0,1,1,0,-2,7,117,-1,4,3,1,0,0,-1,1,1,-1,3,1
KR_6741141982,420,6,4,19,15,-1,2,3,9,11,2,5,5,0,2,2,0,0,1,1,0,13,14,-2,6,4,-4,0,1,-1,1,1,1,2,1
KR_6764357463,420,2,12,51,10,-2,0,2,10,10,0,3,7,4,-1,4,5,0,1,1,0,12,15,6,2,8,-7,0,1,-1,-1,1,-1,5,1
KR_6567613341,420,0,-23,-3,4,-2,2,4,2,2,0,3,4,1,0,4,4,1,2,1,0,5,3,0,5,5,3,0,1,-1,1,1,-1,6,1
KR_6677247620,420,4,8,19,12,-3,0,3,5,5,0,3,4,1,3,3,0,4,5,1,1,12,45,0,6,6,-26,0,1,1,1,1,1,1,1
KR_6737536714,420,0,-12,-19,-1,1,4,3,-2,2,4,-1,4,5,1,4,3,0,0,0,-1,-5,-6,-5,10,5,-2,0,1,-1,1,1,-1,6,1
KR_6749080269,440,-2,10,-8,-5,2,3,1,-3,1,4,-5,1,6,1,3,2,0,0,0,0,-6,-30,-3,6,3,12,0,-1,1,-1,-1,-1,6,1
KR_6658124037,420,2,71,13,6,5,7,2,5,7,2,2,4,2,-5,0,5,-1,0,1,1,9,-5,-3,6,3,-3,0,-1,0,0,-1,1,0,1
KR_6733911975,420,0,78,-6,1,-2,1,3,-4,3,7,-2,1,3,6,6,0,3,3,0,-1,3,-110,-3,7,4,0,0,1,1,-1,1,-1,1,1
KR_6602402814,420,2,-6,24,2,0,4,4,2,3,1,4,4,0,-6,2,8,2,2,0,-2,1,24,3,2,5,-4,0,0,-1,1,0,1,6,1
KR_6761738227,440,-5,-45,-8,-11,-2,0,2,-3,3,6,0,1,1,-6,3,9,0,5,5,0,-2,19,2,4,6,-4,0,0,0,1,0,-1,0,1
KR_6703612470,420,1,27,12,2,-5,0,5,1,5,4,1,2,1,5,7,2,0,1,1,0,6,-21,2,2,4,3,0,-1,1,1,-1,-1,4,1
KR_6737446908,420,0,37,-10,2,4,5,1,-3,1,4,3,8,5,0,2,2,-2,0,2,0,-4,5,-2,4,2,-2,0,1,-1,1,1,-1,1,1
KR_6628097150,420,1,-19,38,1,-4,1,5,0,2,2,2,4,2,3,7,4,0,0,0,0,-1,-2,3,6,9,1,0,1,1,-1,1,1,4,1
KR_6741442339,420,1,44,5,6,-1,1,2,0,4,4,1,2,1,3,4,1,3,3,0,1,9,9,-2,5,3,2,0,0,0,-1,0,1,0,1
KR_6754855096,420,-1,17,2,-1,2,3,1,-5,1,6,-1,3,4,4,9,5,-1,1,2,0,-6,-3,0,2,2,-4,0,-1,1,1,1,-1,2,1
KR_6740289816,440,1,-27,6,2,3,8,5,0,1,1,-1,1,2,-3,0,3,3,3,0,0,10,3,-1,5,4,-1,0,0,1,1,1,1,5,1
KR_6638314641,420,2,64,22,12,4,7,3,4,5,1,2,4,2,1,1,0,1,1,0,0,8,0,6,2,8,3,0,1,1,-1,1,1,4,1
KR_6760169040,420,3,100,-3,4,2,3,1,3,4,1,-1,7,8,0,2,2,0,2,2,0,-1,58,2,2,4,-18,0,2,1,1,1,1,2,1
KR_6742559033,420,-1,19,-16,2,3,6,3,-3,2,5,0,0,0,0,3,3,2,2,0,0,-2,112,0,8,8,1,0,1,-1,1,1,-1,1,1
KR_6631737458,420,4,10,16,5,4,4,0,3,5,2,2,4,2,-2,6,8,-2,1,3,0,2,0,-3,6,3,5,0,0,-1,1,1,1,2,1
KR_6739062542,420,-1,-43,10,-4,-3,1,4,-1,2,3,0,2,2,0,1,1,0,2,2,0,2,1,1,6,7,6,0,1,-1,1,-1,1,5,1
KR_6751786494,420,-2,19,16,1,1,1,0,-1,2,3,1,3,2,-4,2,6,4,4,0,1,-2,2,7,1,8,-1,0,-1,1,1,-1,1,3,1
KR_6651110080,420,1,-3,-12,2,1,1,0,-2,5,7,3,3,0,1,3,2,-1,2,3,0,2,-5,4,5,9,2,0,2,0,1,1,1,0,1
KR_6665123232,420,1,-35,-12,4,0,2,2,1,2,1,1,3,2,-2,3,5,4,5,1,0,7,2,0,4,4,0,0,1,-1,1,1,-1,6,1
KR_6628388797,420,0,-16,-16,3,1,4,3,2,4,2,2,5,3,-1,0,1,-1,0,1,0,7,-4,3,3,6,3,0,-2,-1,1,-1,1,5,1
KR_6744956247,420,2,39,20,10,0,3,3,0,2,2,4,7,3,3,3,0,3,3,0,0,4,-5,2,3,5,2,0,1,0,1,1,1,0,1
KR_6745655016,420,1,66,-11,-2,2,3,1,-5,1,6,-1,2,3,2,3,1,0,0,0,0,-4,10,-2,5,3,-1,0,2,-1,1,1,-1,3,1
KR_6659956031,420,-1,-2,-24,-5,-5,0,5,5,5,0,-6,0,6,2,2,0,-1,1,2,0,3,-13,0,3,3,4,0,-1,-1,-1,-1,-1,2,1
KR_6762335966,420,0,19,8,-7,-2,0,2,2,3,1,-3,3,6,-4,4,8,0,2,2,1,-2,11,2,3,5,1,0,-1,1,1,-1,1,1,1
KR_6709126485,420,4,-22,6,4,-1,3,4,0,5,5,2,2,0,4,5,1,-1,1,2,0,8,-4,-4,8,4,2,0,0,-1,1,1,1,4,1
KR_6686429886,420,-2,-6,4,-4,-3,1,4,1,1,0,1,3,2,-2,3,5,-1,2,3,0,-2,24,5,1,6,-3,0,0,0,1,0,1,0,1
KR_6731464468,420,6,13,50,18,-2,1,3,8,8,0,4,5,1,5,7,2,3,3,0,0,25,0,2,7,9,2,0,2,1,1,1,-1,1,1
KR_6762888888,420,-2,-18,10,4,-3,1,4,1,2,1,2,5,3,5,6,1,-1,1,2,0,4,27,8,4,12,-3,0,0,-1,1,-1,1,3,1
KR_6731103847,420,1,27,32,1,1,2,1,-4,1,5,0,4,4,4,4,0,0,2,2,0,-2,5,0,2,2,-1,0,0,1,1,1,1,3,1
KR_6762500328,420,-3,-43,-12,-2,-1,1,2,2,4,2,-3,2,5,-1,1,2,1,2,1,1,-7,7,3,2,5,-4,0,-1,-1,1,1,1,2,1
KR_6731639494,420,-3,14,-8,0,0,0,0,1,2,1,1,3,2,-1,1,2,-1,2,3,0,4,14,4,4,8,-25,0,0,0,-1,0,1,0,1
KR_6729610173,420,3,57,54,-3,-4,0,4,5,8,3,1,4,3,-4,3,7,-1,1,2,-1,-14,112,-3,5,2,7,0,1,1,1,1,-1,3,1
KR_6744745852,420,3,46,15,4,3,3,0,-1,0,1,3,7,4,-3,0,3,2,2,0,0,5,2,2,3,5,1,0,0,1,-1,0,-1,1,1
KR_6728132140,440,4,78,30,9,4,6,2,-1,1,2,0,4,4,3,5,2,3,3,0,0,2,4,1,3,4,-1,0,1,-1,1,1,1,6,1
KR_6752994085,420,5,69,5,7,3,6,3,2,6,4,-1,2,3,2,4,2,1,1,0,-1,7,0,-3,6,3,2,0,2,-1,1,1,-1,1,1
KR_6582392792,420,2,36,14,6,-2,0,2,-1,1,2,2,3,1,9,11,2,-2,1,3,0,4,-6,1,5,6,8,0,0,-1,1,1,1,1,1
KR_6757034441,420,2,-14,4,1,1,4,3,-1,4,5,-5,0,5,3,5,2,3,4,1,0,-2,9,1,3,4,1,0,0,1,1,0,1,3,1
KR_6657275292,420,5,81,16,10,5,6,1,-1,4,5,7,10,3,-1,3,4,0,0,0,-1,4,-176,1,4,5,2,0,1,1,0,1,1,3,1
KR_6757157002,420,1,83,12,2,-1,0,1,1,3,2,1,3,2,2,3,1,-1,0,1,0,1,24,1,2,3,-1,0,3,1,1,1,1,5,1
KR_6763457738,420,1,-66,0,3,1,1,0,1,2,1,0,2,2,1,4,3,0,2,2,0,1,102,-3,8,5,3,0,1,0,1,1,-1,0,1
KR_6688649261,420,6,29,-9,10,6,6,0,4,5,1,-2,2,4,0,1,1,2,3,1,0,5,-40,2,2,4,13,0,2,-1,1,1,-1,1,1
KR_6751730292,420,3,-29,21,11,0,1,1,7,8,1,-1,4,5,7,8,1,-2,1,3,-1,9,-1,1,3,4,2,0,1,1,0,1,-1,4,1
KR_6757381121,420,2,-14,-14,5,-1,2,3,-1,2,3,7,7,0,1,2,1,-1,0,1,0,10,-2,-1,6,5,-9,0,-1,-1,-1,-1,-1,6,1
KR_6751104134,420,0,2,24,-4,2,3,1,-2,2,4,-2,2,4,-1,1,2,-1,0,1,0,-2,-67,2,2,4,-18,0,1,-1,0,1,-1,4,1
KR_6731813578,420,5,102,-14,10,5,5,0,3,4,1,-3,2,5,6,8,2,-1,1,2,-1,5,174,-1,4,3,15,0,0,-1,1,1,-1,2,1
KR_6388612528,420,2,57,18,2,1,1,0,0,5,5,2,2,0,-1,4,5,0,2,2,0,1,17,6,3,9,0,0,1,-1,-1,1,1,4,1
KR_6761640621,440,-3,0,-16,-1,1,5,4,-3,0,3,-2,4,6,1,2,1,2,2,0,0,5,-3,-1,4,3,-1,0,0,0,-1,1,-1,0,1
KR_6620287238,420,1,50,-4,1,1,2,1,-4,1,5,3,3,0,1,2,1,0,0,0,1,-2,-1,3,4,7,3,0,0,-1,1,0,1,5,1
KR_6728110887,440,6,29,32,5,3,3,0,1,1,0,3,4,1,-8,1,9,6,6,0,-1,1,-161,-6,7,1,1,0,1,-1,-1,-1,-1,3,1
KR_6752719421,420,0,5,4,0,3,4,1,1,3,2,-5,0,5,1,2,1,0,1,1,0,0,-6,-2,6,4,-2,0,0,-1,1,1,-1,5,1
KR_6707716234,440,-2,31,-13,-4,-1,1,2,0,2,2,-2,0,2,-1,0,1,0,2,2,0,-4,1,-2,8,6,-5,0,0,1,-1,0,-1,1,1
KR_6731086297,420,-1,-61,6,0,1,3,2,-2,1,3,2,4,2,0,3,3,-1,1,2,0,0,8,-3,6,3,-3,0,0,1,1,0,-1,6,1
KR_6616419232,420,0,-7,-8,2,-3,1,4,-1,1,2,0,2,2,3,3,0,3,4,1,0,5,-2,-1,5,4,3,0,-1,1,1,-1,-1,1,1
KR_6626981620,420,5,45,-24,11,2,2,0,0,2,2,2,4,2,3,5,2,4,4,0,0,16,6,-2,5,3,3,0,3,1,1,1,-1,6,1
KR_6755402899,420,0,0,-8,-5,-1,2,3,-5,0,5,-2,0,2,5,9,4,-2,0,2,0,-6,-28,2,2,4,-1,0,0,1,1,0,-1,6,1
KR_6675021245,420,0,20,-20,-7,0,2,2,2,5,3,-4,2,6,-8,0,8,3,3,0,0,-5,-21,-1,6,5,-1,0,-1,1,-1,-1,1,6,1
KR_6641380401,420,0,6,9,0,2,3,1,4,5,1,-4,1,5,2,3,1,-4,0,4,0,0,17,-5,9,4,-6,0,1,1,1,1,-1,1,1
KR_6531303417,440,0,47,0,1,1,1,0,-1,0,1,4,4,0,-2,2,4,-1,0,1,0,1,-1,2,4,6,-2,0,0,1,0,0,-1,1,1
KR_6678086582,420,1,-67,20,4,4,6,2,0,2,2,-5,0,5,5,5,0,0,0,0,-1,2,4,3,3,6,-2,0,0,1,-1,1,-1,2,1
KR_6667658921,420,3,-3,-22,14,2,2,0,7,8,1,2,3,1,2,3,1,1,1,0,0,19,13,5,4,9,-6,0,0,-1,-1,0,1,5,1
KR_6754613092,420,2,96,-8,10,5,5,0,-3,1,4,7,7,0,1,3,2,0,0,0,0,-2,-4,4,3,7,2,0,1,-1,1,1,1,2,1
KR_6740800423,420,-1,-7,-3,0,-2,1,3,1,1,0,-1,2,3,2,2,0,0,1,1,0,11,-5,-4,5,1,3,0,0,1,1,1,1,6,1
KR_6737365265,420,1,-1,12,-7,-1,1,2,1,5,4,-2,0,2,-3,1,4,-2,0,2,0,-8,-17,-2,9,7,7,0,0,-1,1,-1,-1,5,1
KR_6764638877,440,0,43,1,-5,1,3,2,-6,2,8,-4,0,4,5,6,1,-1,2,3,0,4,9,1,5,6,-6,0,1,-1,-1,-1,-1,5,1
KR_6700855127,420,-1,-10,30,-8,3,4,1,-7,1,8,-3,0,3,0,2,2,-1,0,1,-1,-10,3,2,4,6,0,0,1,0,1,-1,-1,0,1
KR_6622331615,420,1,1,8,-3,0,2,2,-3,2,5,-3,4,7,3,6,3,0,0,0,0,5,-13,-5,7,2,4,0,-1,-1,-1,-1,-1,2,1
KR_6669209887,420,3,-2,36,5,1,3,2,3,5,2,1,1,0,-1,1,2,1,2,1,0,11,4,3,5,8,0,0,2,-1,1,-1,1,3,1
KR_6679030639,420,4,-51,11,8,4,4,0,10,11,1,0,3,3,2,4,2,-8,1,9,0,5,-4,-3,6,3,0,0,0,1,1,1,1,3,1
KR_6724758454,440,7,81,48,15,5,5,0,2,4,2,4,4,0,2,5,3,2,6,4,3,8,-33,-4,6,2,16,0,1,1,1,1,1,6,1
KR_6592010656,420,4,55,6,9,3,3,0,0,5,5,5,6,1,4,7,3,-3,0,3,0,0,-6,-5,8,3,4,0,0,1,-1,-1,-1,1,1
KR_6764609808,420,3,29,-9,13,5,5,0,4,5,1,1,2,1,3,6,3,0,0,0,1,10,0,0,4,4,0,0,1,-1,1,1,1,1,1
KR_6752132384,420,2,98,5,4,0,1,1,1,2,1,1,5,4,7,7,0,-5,0,5,0,6,-5,-2,3,1,2,0,2,1,1,1,1,4,1
KR_6592276856,420,1,55,35,5,2,2,0,0,3,3,-1,4,5,3,5,2,1,1,0,0,14,-105,-3,10,7,3,0,0,1,-1,0,1,2,1
KR_6744960043,420,4,40,-7,10,3,7,4,1,2,1,1,2,1,6,7,1,-1,3,4,0,12,-22,0,6,6,7,0,1,1,1,1,-1,2,1
KR_6723809708,420,1,17,12,4,-3,1,4,2,3,1,3,8,5,0,2,2,2,2,0,1,1,-2,0,3,3,1,0,-1,-1,-1,-1,1,5,1
KR_6754493761,420,0,-38,-11,0,6,6,0,-1,2,3,-3,0,3,-3,0,3,1,1,0,0,-3,28,-4,6,2,2,0,-2,-1,-1,-1,-1,2,1
KR_6717703336,420,5,58,20,6,2,2,0,0,1,1,5,5,0,0,3,3,-1,0,1,1,5,-3,3,3,6,1,0,0,-1,1,1,1,1,1
KR_6759853403,440,3,63,24,6,2,2,0,-3,0,3,6,6,0,0,3,3,1,1,0,1,9,-3,0,5,5,0,0,1,1,-1,-1,1,1,1
KR_6659312552,420,-2,10,-30,5,1,2,1,-3,2,5,-1,1,2,5,5,0,3,3,0,0,6,3,1,4,5,3,0,-1,-1,-1,-1,-1,6,1
KR_6753845190,440,2,1,8,3,-2,1,3,1,2,1,-1,2,3,3,5,2,2,2,0,0,5,3,0,8,8,0,0,0,0,0,1,1,0,1
KR_6684581309,420,2,20,-12,12,2,3,1,3,4,1,-1,3,4,6,7,1,2,2,0,0,15,-1,0,3,3,3,0,2,1,1,1,1,4,1
KR_6754352825,420,-1,-3,36,-3,0,0,0,1,6,5,0,3,3,-4,2,6,0,0,0,0,0,-2,-5,11,6,1,0,0,0,1,0,-1,0,1
KR_6761008826,420,5,51,17,5,5,5,0,2,4,2,2,3,1,-1,1,2,-3,0,3,0,0,4,-2,4,2,1,0,0,-1,1,1,-1,6,1
KR_6756564637,440,4,97,-4,16,4,4,0,0,1,1,4,5,1,7,8,1,1,2,1,0,11,-91,-1,2,1,3,0,1,1,0,1,1,2,1
KR_6758004044,420,3,48,-28,1,3,3,0,0,2,2,-1,2,3,-1,1,2,0,1,1,0,-7,-32,-5,7,2,2,0,2,1,1,1,-1,6,1
KR_6657314008,440,6,89,8,12,4,4,0,4,4,0,1,3,2,4,4,0,-1,1,2,1,17,11,3,4,7,1,0,0,1,1,1,1,4,1
KR_6727660654,440,3,27,14,9,3,4,1,3,4,1,0,1,1,0,2,2,3,4,1,0,3,-13,1,5,6,5,0,1,1,1,1,1,3,1
KR_6661542838,420,3,89,-18,6,-1,2,3,-1,2,3,4,5,1,2,2,0,2,2,0,0,10,22,3,2,5,-2,0,2,-1,1,1,1,6,1
KR_6733527361,440,5,30,40,4,1,1,0,4,6,2,1,2,1,0,5,5,-2,1,3,0,2,11,2,2,4,0,0,0,-1,0,1,1,2,1
KR_6762452958,420,1,34,-5,6,0,2,2,-1,3,4,4,6,2,3,4,1,0,2,2,0,-2,-25,1,3,4,3,0,0,1,0,1,1,2,1
KR_6761475217,420,1,14,40,0,3,3,0,-5,1,6,2,4,2,-3,0,3,3,5,2,0,-3,8,-3,9,6,-6,0,2,1,1,1,1,2,1
KR_6734293907,420,3,89,25,6,0,1,1,3,3,0,1,3,2,3,4,1,-1,1,2,0,1,-21,4,4,8,6,0,1,1,1,1,1,1,1
KR_6505292063,420,1,-7,-15,0,-2,0,2,2,5,3,1,4,3,1,2,1,-2,0,2,0,5,-3,-3,7,4,3,0,1,-1,1,-1,1,2,1
KR_6733502899,420,1,21,1,1,-1,1,2,2,3,1,0,1,1,1,2,1,-1,1,2,0,-1,-1,-1,6,5,0,0,0,-1,1,0,-1,2,1
KR_6711359516,420,-1,2,12,5,0,0,0,-1,4,5,-1,1,2,3,4,1,4,5,1,-1,8,-147,-2,6,4,24,0,0,-1,0,0,-1,6,1
KR_6763604152,420,4,6,4,14,1,3,2,7,7,0,4,4,0,1,3,2,1,1,0,0,11,-2,3,0,3,3,0,2,1,1,1,1,3,1
KR_6682914714,420,7,54,40,18,5,6,1,-1,1,2,4,5,1,7,7,0,3,3,0,0,11,-176,1,3,4,-2,0,5,1,1,1,1,3,1
KR_6755012724,420,0,13,4,0,-2,0,2,0,2,2,0,2,2,0,0,0,2,3,1,0,0,-1,2,5,7,6,0,1,1,0,1,1,3,1
KR_6760506170,420,0,1,4,-2,0,1,1,0,5,5,0,2,2,-2,3,5,0,1,1,0,-4,2,7,2,9,-1,0,2,1,1,1,-1,6,1
KR_6569798406,420,-1,-21,-26,-5,-2,1,3,-1,4,5,-1,1,2,-1,6,7,0,1,1,0,-7,-1,4,2,6,3,0,1,1,-1,1,-1,4,1
KR_6761230451,440,2,3,-4,5,3,3,0,-2,2,4,5,7,2,0,0,0,-1,0,1,0,7,-5,-4,7,3,2,0,0,0,0,0,1,0,1
KR_6761479187,440,3,63,-1,3,-1,1,2,1,1,0,5,5,0,-3,0,3,1,2,1,0,1,14,1,3,4,-3,0,1,0,0,1,1,0,1
KR_6736148223,420,5,62,4,12,7,7,0,2,2,0,3,5,2,0,4,4,0,1,1,0,2,1,4,2,6,4,0,1,-1,1,-1,-1,4,1
KR_6719638762,420,-1,-43,0,0,-1,1,2,2,5,3,0,1,1,-1,2,3,0,1,1,0,3,144,2,5,7,-1,0,0,-1,1,0,1,4,1
KR_6752856039,440,-2,-24,17,-8,-1,0,1,1,1,0,-2,3,5,-1,1,2,-5,2,7,0,-11,-3,4,5,9,2,0,1,-1,1,1,-1,4,1
KR_6759295645,420,4,58,32,13,1,1,0,-1,2,3,-1,3,4,11,13,2,3,4,1,0,4,-22,1,3,4,-1,0,0,1,1,1,1,2,1
KR_6650651185,420,2,52,-8,1,-1,0,1,3,4,1,1,2,1,-2,1,3,0,0,0,0,3,0,-6,11,5,-4,0,0,-1,-1,0,1,2,1
KR_6757607594,420,0,-48,17,-2,-1,3,4,2,10,8,-2,4,6,-2,1,3,1,2,1,1,-8,14,-3,6,3,-3,0,-1,-1,0,1,1,5,1
KR_6727508095,420,0,-3,-8,-2,-3,2,5,-1,2,3,-2,1,3,5,5,0,-1,1,2,0,8,1,-5,8,3,5,0,-1,0,0,-1,-1,0,1
KR_6703583846,420,0,-9,22,1,1,3,2,2,4,2,2,6,4,-3,1,4,-1,1,2,0,6,3,1,7,8,4,0,0,0,0,0,-1,0,1
KR_6749422290,420,-1,-38,-16,-1,-2,2,4,-2,3,5,2,2,0,1,1,0,0,1,1,0,5,38,2,1,3,-14,0,1,-1,1,1,-1,6,1
KR_6757039269,420,2,85,1,5,2,3,1,-1,0,1,5,6,1,-2,1,3,1,2,1,0,7,3,2,3,5,0,0,1,-1,1,1,1,3,1
KR_6754139640,420,4,66,2,9,4,6,2,3,4,1,1,2,1,-1,1,2,2,3,1,1,2,0,1,2,3,-1,0,2,-1,1,1,1,1,1
KR_6717216225,420,-1,53,-16,2,0,3,3,-5,1,6,6,8,2,2,3,1,-1,2,3,3,12,9,1,3,4,-1,0,0,1,1,1,1,1,1
KR_6757071383,420,-4,23,7,-11,1,3,2,0,2,2,-5,2,7,-4,4,8,-3,2,5,0,-9,-3,0,2,2,0,0,0,0,0,0,-1,0,1
KR_6758516221,420,0,-11,-6,-7,3,4,1,0,3,3,-8,1,9,-1,1,2,-1,0,1,0,-3,20,0,5,5,-3,0,-1,1,1,-1,1,5,1
KR_6347732030,420,4,42,0,14,6,6,0,0,2,2,3,3,0,5,6,1,0,0,0,0,14,-21,2,5,7,5,0,0,1,-1,1,1,6,1
KR_6694243128,440,3,10,-20,5,2,3,1,0,1,1,3,3,0,1,3,2,-1,1,2,0,2,9,5,3,8,-3,0,0,1,-1,0,-1,1,1
KR_6692439952,420,1,35,39,7,4,4,0,-3,2,5,5,5,0,1,6,5,0,0,0,1,10,30,0,6,6,-3,0,1,-1,1,1,1,4,1
KR_6763274644,420,3,40,8,3,-2,1,3,2,2,0,2,4,2,3,4,1,-2,0,2,0,2,-4,-2,6,4,0,0,1,1,0,1,1,3,1
KR_6677031866,420,8,125,20,14,8,8,0,1,2,1,1,4,3,2,4,2,2,2,0,0,10,204,1,5,6,-2,0,3,1,1,1,1,4,1
KR_6651420983,420,2,19,19,3,1,2,1,-2,3,5,0,2,2,3,3,0,1,1,0,1,2,1,3,5,8,6,0,0,1,1,0,1,1,1
KR_6758848439,420,1,47,-19,1,-1,3,4,3,4,1,3,4,1,-2,2,4,-2,1,3,0,-1,23,0,7,7,7,0,1,1,1,1,-1,6,1
KR_6761744570,420,0,3,17,4,1,1,0,-1,2,3,2,4,2,2,8,6,0,1,1,0,-2,1,3,1,4,-1,0,1,1,1,1,1,5,1
KR_6433841090,420,1,22,-13,9,2,4,2,0,0,0,4,4,0,4,6,2,-1,2,3,0,12,-174,0,5,5,2,0,-1,-1,-1,-1,1,4,1
KR_6732233006,420,4,25,-24,5,2,2,0,0,2,2,1,5,4,4,8,4,-2,1,3,0,-4,-107,2,4,6,-2,0,0,1,1,0,1,3,1
KR_6746888079,420,2,35,22,-2,-1,3,4,1,4,3,-5,0,5,2,4,2,1,2,1,0,4,8,-2,7,5,-3,0,1,1,1,1,-1,3,1
KR_6734181828,420,2,41,28,7,5,5,0,2,4,2,1,1,0,1,4,3,-2,3,5,-1,9,11,8,0,8,-2,0,0,1,-1,0,-1,1,1
KR_6561795640,420,0,-3,2,5,1,2,1,1,3,2,1,3,2,6,7,1,-4,0,4,0,0,-6,-2,5,3,-4,0,0,1,1,1,1,1,1
KR_6720775959,420,0,11,36,3,1,1,0,1,3,2,3,7,4,-2,1,3,0,0,0,0,6,10,0,4,4,-2,0,2,1,-1,1,1,5,1
KR_6761250865,420,4,21,40,8,-3,0,3,4,4,0,3,4,1,5,5,0,-1,0,1,0,13,8,6,3,9,-4,0,2,0,1,1,1,0,1
KR_6730965158,440,10,130,39,17,3,6,3,7,7,0,-3,0,3,4,5,1,6,6,0,2,14,13,3,1,4,-2,0,3,1,1,1,1,6,1
KR_6660286799,420,2,39,-1,8,-2,4,6,4,5,1,1,4,3,0,2,2,5,7,2,1,8,7,1,1,2,1,0,1,1,0,1,1,3,1
KR_6757601987,420,3,-32,44,12,-1,2,3,-1,0,1,3,4,1,11,11,0,0,0,0,0,13,-224,1,1,2,0,0,1,-1,1,1,1,1,1
KR_6757084271,420,1,6,-24,8,3,6,3,3,3,0,1,2,1,-1,1,2,2,2,0,1,9,-154,10,2,12,0,0,0,-1,1,1,1,5,1
KR_6709836189,420,-1,-16,12,-3,-4,1,5,-5,0,5,1,4,3,4,6,2,1,1,0,2,6,-5,-3,10,7,1,0,1,1,1,1,1,5,1
KR_6761113121,420,0,0,-4,-2,4,5,1,-5,1,6,0,4,4,1,6,5,-2,0,2,1,-7,2,-1,3,2,-2,0,-1,-1,1,-1,1,6,1
KR_6665159635,420,-1,-25,-4,-1,-2,1,3,1,3,2,-1,1,2,-1,1,2,2,2,0,0,0,12,3,3,6,-1,0,-1,-1,1,-1,-1,3,1
KR_6755399498,440,7,127,-26,12,1,3,2,3,4,1,5,6,1,4,4,0,-1,0,1,0,10,3,5,1,6,-3,0,2,1,-1,1,1,2,1
KR_6763419094,420,4,48,17,6,0,3,3,-1,5,6,1,2,1,6,7,1,0,4,4,-4,-6,9,-6,8,2,2,0,0,1,-1,1,-1,6,1
KR_6690578873,420,5,69,25,11,3,3,0,1,3,2,4,5,1,2,3,1,1,1,0,1,2,-8,2,6,8,1,0,1,1,0,1,1,3,1
KR_6455107267,420,3,13,42,1,-2,0,2,10,12,2,-3,5,8,-1,2,3,-3,1,4,0,16,-14,8,1,9,5,0,1,1,1,1,1,6,1
KR_6683697309,420,5,44,4,4,2,3,1,-1,2,3,0,2,2,2,2,0,1,2,1,0,1,-3,-2,4,2,1,0,0,1,1,0,-1,1,1
KR_6732814013,420,5,56,32,11,3,4,1,3,6,3,1,4,3,4,5,1,0,0,0,0,4,18,0,4,4,0,0,1,1,-1,1,-1,5,1
KR_6740111857,420,-2,13,0,-2,-1,0,1,2,4,2,-3,3,6,1,5,4,-1,1,2,0,3,-9,-3,7,4,1,0,-1,1,-1,-1,-1,3,1
KR_6726334077,420,4,88,28,10,5,5,0,3,5,2,5,6,1,-3,2,5,0,0,0,0,3,7,2,4,6,-1,0,0,1,-1,-1,1,3,1
KR_6717663806,420,2,47,24,2,5,6,1,1,3,2,-1,2,3,-3,1,4,0,0,0,0,2,0,-1,2,1,0,0,1,1,-1,1,1,6,1
KR_6747843365,420,1,51,-26,0,-3,0,3,1,5,4,5,5,0,0,0,0,-3,0,3,0,-2,-18,1,7,8,0,0,0,-1,1,-1,1,3,1
KR_6610037359,420,4,-4,31,7,-2,1,3,4,7,3,3,4,1,-1,0,1,3,4,1,0,18,4,0,6,6,-3,0,1,1,-1,1,-1,4,1
KR_6692999663,420,0,42,-30,5,0,2,2,6,7,1,-1,2,3,1,2,1,-1,0,1,1,8,-4,4,2,6,1,0,0,-1,-1,0,1,3,1
KR_6725081746,420,2,64,-3,-2,-4,0,4,-3,3,6,5,5,0,0,4,4,0,0,0,-1,-5,-25,-2,7,5,-2,0,0,1,-1,1,-1,2,1
KR_6756975284,420,2,36,0,2,-3,2,5,-4,1,5,5,5,0,3,3,0,1,2,1,0,3,5,4,5,9,-3,0,1,-1,1,1,-1,5,1
KR_6698275595,420,-1,0,3,4,1,2,1,-1,2,3,5,5,0,0,1,1,-1,1,2,0,1,5,2,5,7,-1,0,0,1,1,0,1,6,1
KR_6637338753,420,-2,-3,26,1,-1,0,1,1,4,3,-1,0,1,2,5,3,0,0,0,0,3,-6,0,4,4,1,0,1,0,1,1,1,0,1
KR_6754600781,420,3,40,-12,6,3,3,0,1,2,1,1,1,0,1,1,0,0,0,0,0,4,-43,-3,5,2,26,0,0,0,0,1,1,0,1
KR_6735969814,420,-2,-60,-32,9,0,1,1,1,3,2,2,2,0,5,5,0,1,2,1,1,9,76,1,3,4,-1,0,1,1,1,1,1,2,1
KR_6702744354,420,2,44,4,5,-2,1,3,3,3,0,1,3,2,2,3,1,1,2,1,0,5,11,7,1,8,-3,0,0,1,1,0,1,4,1
KR_6761774028,440,1,-22,-3,6,2,2,0,3,4,1,0,1,1,0,2,2,1,2,1,0,10,1,-2,5,3,-3,0,2,0,1,1,1,0,1
KR_6698031209,420,3,96,1,7,1,1,0,4,5,1,4,4,0,1,4,3,-3,2,5,1,-2,-12,1,3,4,0,0,3,-1,1,1,1,5,1
KR_6737043961,420,3,32,38,11,4,4,0,2,3,1,1,2,1,4,5,1,0,0,0,0,8,-3,1,3,4,6,0,0,1,1,1,1,4,1
KR_6641033907,420,0,30,27,0,1,1,0,2,6,4,1,3,2,-6,2,8,2,2,0,0,2,2,1,3,4,4,0,0,1,-1,0,1,4,1
KR_6755241392,420,0,44,-18,-2,2,2,0,1,1,0,-2,2,4,-3,0,3,0,1,1,0,-9,-119,-1,4,3,3,0,0,0,0,0,1,0,1
KR_6737455549,420,1,18,3,7,2,2,0,1,2,1,3,4,1,-1,3,4,2,2,0,0,15,11,2,5,7,2,0,2,1,1,1,-1,3,1
KR_6725774184,420,5,64,30,2,3,4,1,5,6,1,-1,1,2,-2,1,3,-3,1,4,1,0,-22,-3,8,5,2,0,2,1,1,1,1,2,1
KR_6756509810,420,-1,7,-17,3,-1,0,1,1,4,3,1,1,0,2,3,1,0,1,1,0,5,9,1,3,4,-7,0,1,1,-1,1,1,3,1
KR_6705661993,420,3,13,-21,8,2,2,0,1,2,1,-1,2,3,7,7,0,-1,0,1,0,17,-18,4,4,8,2,0,1,1,-1,-1,-1,6,1
KR_6694110641,440,2,36,20,0,-1,0,1,0,6,6,1,2,1,2,2,0,-2,2,4,0,-1,1,-1,4,3,3,0,0,1,-1,0,-1,3,1
KR_6672752946,420,3,38,8,0,5,6,1,-2,0,2,-2,1,3,0,3,3,-1,0,1,0,-5,38,0,5,5,-18,0,1,1,0,1,1,4,1
KR_6761037086,420,1,63,12,1,-2,1,3,1,1,0,1,1,0,0,2,2,1,2,1,0,5,104,-1,6,5,7,0,-1,1,-1,-1,-1,6,1
KR_6658455271,420,1,0,3,3,0,2,2,4,5,1,1,3,2,1,3,2,-3,1,4,0,5,0,3,3,6,0,0,1,-1,1,1,1,1,1
KR_6759710190,440,0,-11,8,-2,-2,1,3,-1,0,1,-1,4,5,1,1,0,1,2,1,0,-3,-6,-3,5,2,5,0,0,1,1,0,1,1,1
KR_6627045035,420,2,15,52,-1,-5,1,6,1,3,2,4,6,2,-4,2,6,3,3,0,0,0,-6,-2,8,6,4,0,0,1,1,1,1,5,1
KR_6705827539,440,1,-43,16,10,-4,1,5,6,9,3,2,3,1,4,6,2,2,2,0,0,26,-2,-1,5,4,-1,0,1,1,0,-1,-1,6,1
KR_6762424270,420,6,29,18,10,2,4,2,-2,1,3,5,5,0,1,1,0,4,4,0,0,9,4,1,3,4,-2,0,0,1,1,1,1,5,1
KR_6658063450,420,2,-11,-10,3,1,3,2,2,3,1,1,6,5,-1,1,2,0,1,1,0,5,-3,-4,8,4,3,0,0,-1,1,1,-1,2,1
KR_6606453554,420,5,79,22,6,0,2,2,2,2,0,3,5,2,0,2,2,1,2,1,0,3,-1,3,3,6,3,0,1,1,1,1,1,2,1
KR_6761035493,420,0,64,52,-1,-2,0,2,2,4,2,-3,1,4,2,3,1,0,0,0,-2,-7,28,-3,5,2,4,0,1,1,1,1,-1,4,1
KR_6760698923,420,3,39,12,5,-2,0,2,3,4,1,1,3,2,2,3,1,1,1,0,0,6,-14,-4,7,3,12,0,1,1,-1,1,1,4,1
KR_6690475598,420,1,30,-20,2,3,3,0,-2,0,2,0,1,1,0,3,3,1,2,1,0,0,68,-2,3,1,3,0,1,1,1,1,1,4,1
KR_6152138410,440,-2,-34,-16,0,5,6,1,-3,0,3,-2,1,3,0,1,1,0,1,1,0,2,-25,-1,5,4,17,0,1,-1,1,1,1,4,1
KR_6726291298,440,2,16,32,3,-2,0,2,-1,1,2,3,3,0,4,6,2,-1,0,1,0,11,2,1,7,8,1,0,1,1,1,1,-1,3,1
KR_6745842048,420,7,84,8,12,4,4,0,-1,2,3,5,7,2,2,5,3,2,5,3,0,8,7,5,1,6,-1,0,1,1,1,1,1,2,1
KR_6757639884,440,3,39,32,2,-2,0,2,-2,3,5,4,6,2,3,4,1,-1,3,4,0,-2,-192,-1,5,4,5,0,1,1,1,1,-1,1,1
KR_6756775743,420,2,-26,0,9,2,2,0,7,8,1,0,3,3,-1,2,3,1,1,0,0,9,5,-2,4,2,-4,0,0,1,0,1,1,3,1
KR_6627956068,420,-1,-18,3,2,-1,2,3,2,4,2,1,3,2,0,0,0,0,0,0,0,5,-4,-2,5,3,-1,0,0,1,1,1,1,2,1
KR_6566719266,420,5,143,32,10,3,3,0,0,3,3,2,2,0,4,6,2,1,1,0,1,10,-10,2,3,5,4,0,1,1,1,1,1,4,1
KR_6760374504,420,0,-40,0,-4,2,5,3,-2,1,3,-2,0,2,0,4,4,-2,0,2,-2,-16,-29,-8,9,1,1,0,-2,-1,-1,-1,-1,3,1
KR_6759228897,420,2,13,-20,5,2,3,1,1,1,0,0,2,2,3,3,0,-1,1,2,0,4,40,4,4,8,-20,0,0,1,-1,1,-1,5,1
KR_6708251115,420,3,34,-8,13,1,2,1,5,7,2,5,5,0,1,3,2,1,4,3,0,8,-2,2,3,5,1,0,1,-1,-1,1,1,5,1
KR_6700025835,420,7,105,35,19,4,5,1,0,5,5,0,3,3,16,16,0,-1,1,2,0,21,12,7,2,9,6,0,1,1,1,1,1,6,1
KR_6717150174,420,4,46,-2,5,-5,0,5,2,4,2,1,5,4,6,6,0,1,1,0,0,11,1,1,5,6,-4,0,0,-1,-1,1,1,6,1
KR_6618390996,420,-3,-33,16,-6,-5,0,5,2,2,0,3,6,3,-5,4,9,-1,1,2,0,-3,1,-3,8,5,-3,0,1,-1,1,1,-1,2,1
KR_6589107112,420,3,58,5,1,1,3,2,-1,0,1,0,0,0,-1,1,2,2,2,0,0,1,130,2,1,3,0,0,0,1,-1,1,-1,2,1
KR_6759871370,420,-2,-62,-25,2,1,3,2,1,1,0,-1,0,1,0,3,3,1,1,0,0,4,-6,-4,7,3,-1,0,1,0,1,1,-1,0,1
KR_6287334202,440,-2,-35,-28,0,0,3,3,0,1,1,-1,1,2,-1,1,2,2,3,1,0,2,-5,0,4,4,-2,0,0,1,-1,0,1,2,1
KR_6760707559,420,3,26,8,6,0,2,2,-1,1,2,7,7,0,1,2,1,-1,1,2,0,4,-4,-3,6,3,1,0,1,1,-1,1,1,5,1
KR_6759660557,420,9,98,10,14,4,5,1,1,3,2,3,3,0,3,4,1,3,3,0,1,10,0,-1,6,5,4,0,3,1,-1,1,1,4,1
KR_6759429170,440,-1,4,-4,3,1,2,1,1,2,1,-4,1,5,2,4,2,3,4,1,0,2,117,0,3,3,-1,0,0,1,-1,0,1,5,1
KR_6706696068,420,-1,-55,-4,-3,0,0,0,4,6,2,-3,1,4,-4,1,5,0,0,0,0,2,-8,3,3,6,-1,0,0,1,-1,0,-1,2,1
KR_6761672552,420,1,41,4,1,-1,0,1,3,5,2,0,0,0,1,4,3,-2,0,2,-1,2,-22,-3,7,4,-2,0,0,-1,1,0,-1,3,1
KR_6679755595,420,-3,-28,-20,-6,1,2,1,-4,1,5,-2,0,2,0,1,1,-1,0,1,0,-8,136,-3,5,2,-2,0,-1,1,-1,-1,-1,2,1
KR_6756595132,420,7,16,64,27,2,3,1,9,9,0,10,13,3,5,5,0,1,1,0,0,17,-2,3,2,5,3,0,2,1,1,1,1,4,1
KR_6660143884,420,1,2,-15,8,3,4,1,3,4,1,1,5,4,1,4,3,0,2,2,0,9,30,1,4,5,0,0,1,1,1,1,1,6,1
KR_6742809939,420,-1,-20,28,4,0,2,2,2,3,1,1,2,1,-1,2,3,2,2,0,0,3,-10,3,3,6,4,0,0,-1,-1,0,1,1,1
KR_6711188577,420,-3,-8,4,-3,6,8,2,-5,1,6,0,0,0,-2,3,5,-2,0,2,0,-15,20,5,1,6,-2,0,1,-1,1,1,1,5,1
KR_6675197331,420,1,22,-4,8,1,1,0,1,5,4,-2,2,4,6,8,2,2,2,0,1,12,6,0,6,6,-2,0,0,0,1,-1,1,0,1
KR_6751315167,420,6,87,12,20,1,1,0,10,10,0,4,8,4,3,4,1,2,3,1,0,30,-106,-4,5,1,3,0,3,1,1,1,-1,6,1
KR_6748250177,420,5,3,31,13,2,4,2,6,7,1,0,2,2,5,8,3,0,1,1,0,2,4,5,4,9,-3,0,0,1,1,0,1,2,1
KR_6692013154,420,2,77,9,-1,1,2,1,-2,2,4,-5,1,6,5,5,0,0,2,2,-1,-1,-18,1,2,3,-1,0,0,1,1,1,-1,3,1
KR_6760744280,420,-4,-48,-1,-7,-6,1,7,4,7,3,-2,0,2,-4,2,6,1,2,1,0,-6,28,-2,5,3,-3,0,-1,1,-1,-1,-1,2,1
KR_6750582950,420,1,-16,15,8,-2,1,3,-1,5,6,2,2,0,2,5,3,7,7,0,1,12,-3,-5,7,2,-2,0,-1,1,-1,-1,1,1,1
KR_6686605121,420,-1,-50,8,0,0,2,2,-2,2,4,2,2,0,0,3,3,0,0,0,0,3,-6,3,1,4,-5,0,-1,-1,1,-1,-1,1,1
KR_6760391384,420,-5,-83,-12,-12,0,3,3,-1,3,4,-1,2,3,-6,3,9,-4,0,4,0,2,-4,-3,4,1,-4,0,-1,-1,1,-1,-1,4,1
KR_6760204373,420,4,86,-2,6,3,3,0,2,3,1,-4,0,4,3,4,1,2,3,1,-1,0,12,-4,5,1,3,0,2,-1,-1,1,-1,6,1
KR_6749461562,420,1,3,12,1,-4,3,7,-1,0,1,5,5,0,0,1,1,1,1,0,0,3,7,-1,7,6,-3,0,-1,0,0,-1,1,0,1
KR_6714778937,420,-1,-8,11,1,1,3,2,2,6,4,-4,0,4,3,5,2,-1,2,3,2,7,-8,-4,8,4,0,0,0,-1,-1,-1,1,6,1
KR_6742237497,440,0,8,8,2,5,5,0,-2,1,3,-2,0,2,1,4,3,0,1,1,0,4,-6,-3,7,4,4,0,1,1,1,-1,1,2,1
KR_6667712992,420,-1,-23,-11,3,-2,0,2,0,3,3,1,2,1,2,5,3,2,2,0,1,10,6,-2,3,1,-2,0,-1,-1,-1,-1,1,1,1
KR_6761464885,420,7,75,41,9,2,3,1,-1,0,1,4,4,0,2,2,0,2,3,1,0,3,-16,1,3,4,6,0,2,1,-1,1,1,4,1
KR_6685438518,420,0,33,-20,4,0,2,2,3,4,1,2,2,0,1,2,1,-2,0,2,0,6,-1,0,5,5,4,0,-1,1,-1,-1,1,5,1
KR_6734539912,420,1,6,-15,7,1,3,2,3,4,1,-1,0,1,5,5,0,-1,1,2,2,11,1,-1,7,6,3,0,2,-1,1,1,1,2,1
KR_6704997660,420,-1,5,-25,4,-1,1,2,5,5,0,1,4,3,1,2,1,-2,2,4,0,6,13,7,1,8,-2,0,0,1,0,0,1,2,1
KR_6764319920,420,1,47,-2,6,1,3,2,4,6,2,-3,1,4,3,4,1,1,1,0,0,4,-13,-1,6,5,-1,0,1,1,1,1,1,4,1
KR_6586608244,420,-1,-72,-6,0,-4,3,7,-1,2,3,-1,2,3,6,9,3,0,1,1,0,13,28,4,5,9,-3,0,0,-1,-1,-1,-1,3,1
KR_6762618927,420,3,69,-16,8,-2,3,5,2,4,2,2,8,6,5,6,1,1,2,1,0,6,-12,-3,8,5,0,0,1,-1,1,1,1,3,1
KR_6691190890,420,6,56,15,17,-1,1,2,3,3,0,4,8,4,10,10,0,1,2,1,4,35,6,4,4,8,0,0,2,1,1,1,1,4,1
KR_6751516336,420,2,108,12,7,2,4,2,-4,0,4,2,3,1,3,4,1,4,4,0,0,3,-2,-2,6,4,-1,0,0,1,-1,1,1,1,1
KR_6601790022,420,4,50,21,7,4,4,0,-2,8,10,-2,1,3,8,8,0,-1,1,2,0,6,2,-1,5,4,0,0,2,1,0,1,-1,1,1
KR_6723410295,420,3,115,40,-2,-1,1,2,1,2,1,3,4,1,-3,1,4,-2,0,2,0,-11,49,-4,5,1,-16,0,2,1,1,1,1,5,1
KR_6744292738,420,5,77,12,8,4,6,2,1,4,3,2,3,1,2,3,1,-1,0,1,0,3,-9,-2,4,2,1,0,2,1,1,1,-1,1,1
KR_6764604294,420,1,61,3,-1,-2,1,3,-1,5,6,2,3,1,0,2,2,0,1,1,0,-2,-9,4,4,8,0,0,0,1,1,1,1,1,1
KR_6764026541,420,3,16,15,6,2,3,1,-2,0,2,2,3,1,1,3,2,3,3,0,0,8,-1,0,4,4,-1,0,1,1,1,-1,1,2,1
KR_6661305408,420,2,-40,3,5,-3,0,3,-2,4,6,2,3,1,5,7,2,3,3,0,-1,6,-3,0,2,2,1,0,1,0,1,-1,-1,0,1
KR_6648131114,420,2,36,4,0,1,2,1,2,5,3,-2,1,3,-4,1,5,3,3,0,-1,-2,-3,1,8,9,3,0,1,1,1,-1,-1,2,1
KR_6663035140,420,5,-21,7,11,3,5,2,4,8,4,-1,1,2,3,3,0,2,2,0,0,13,-388,-5,10,5,3,0,1,1,1,1,-1,5,1
KR_6720242527,420,-1,-56,35,5,0,1,1,2,3,1,2,6,4,1,1,0,0,0,0,0,6,1,4,1,5,3,0,0,1,1,0,-1,3,1
KR_6739201905,420,6,50,-6,10,3,3,0,2,3,1,4,5,1,-1,3,4,2,2,0,0,2,14,0,5,5,-3,0,1,1,1,1,1,1,1
KR_6730472030,420,5,97,6,6,1,2,1,4,8,4,1,5,4,1,1,0,-1,1,2,1,4,9,2,4,6,-2,0,2,1,1,1,1,4,1
KR_6714289439,420,5,55,17,12,-3,2,5,4,4,0,7,9,2,2,2,0,2,3,1,3,23,-3,-3,6,3,1,0,1,1,1,1,1,1,1
KR_6675127772,420,2,44,7,0,2,3,1,0,4,4,1,3,2,1,3,2,-4,0,4,0,-3,-26,-5,7,2,-15,0,0,0,1,1,-1,0,1
KR_6714785842,420,-1,-14,-3,1,1,2,1,1,4,3,0,2,2,1,4,3,-2,0,2,1,1,4,2,2,4,1,0,1,1,1,1,1,4,1
KR_6745741567,420,0,10,1,-6,-3,2,5,-2,1,3,1,6,5,-1,1,2,-1,0,1,0,3,12,3,3,6,-2,0,1,1,-1,1,-1,5,1
KR_6758434014,420,3,10,0,10,2,4,2,2,6,4,0,1,1,6,6,0,0,1,1,0,7,-3,5,3,8,-2,0,1,-1,1,1,1,3,1
KR_6752353432,420,-1,-79,4,-4,0,4,4,0,1,1,-1,2,3,-3,1,4,0,1,1,0,-3,-1,0,4,4,2,0,-2,1,-1,-1,-1,2,1
KR_6549266621,420,4,88,9,6,-3,0,3,2,3,1,-4,1,5,9,9,0,2,2,0,0,10,78,1,4,5,-3,0,2,1,-1,1,1,3,1
KR_6673646864,420,5,62,29,11,7,8,1,0,2,2,2,2,0,2,3,1,0,0,0,0,9,0,2,5,7,2,0,3,1,1,1,1,1,1
KR_6715544411,420,3,53,17,7,-2,0,2,2,3,1,7,7,0,0,5,5,0,2,2,0,8,-56,0,4,4,26,0,0,1,-1,0,-1,1,1
KR_6680361211,420,5,18,20,10,0,2,2,1,4,3,-3,3,6,9,10,1,3,6,3,2,27,-88,-1,5,4,5,0,2,1,1,1,1,3,1
KR_6669727533,420,2,-5,-7,10,0,2,2,5,6,1,1,3,2,1,3,2,3,5,2,0,9,3,6,0,6,2,0,0,0,1,0,1,0,1
KR_6741429067,420,3,43,-7,2,0,2,2,0,3,3,5,5,0,2,2,0,-5,1,6,-1,0,20,2,1,3,6,0,2,1,-1,1,-1,4,1
KR_6638281062,440,-2,-18,-15,-1,-1,3,4,-3,1,4,-2,2,4,4,9,5,1,3,2,2,11,8,1,5,6,-3,0,0,1,1,-1,1,2,1
KR_6735919350,420,2,-7,24,6,-3,1,4,2,5,3,3,3,0,2,3,1,2,2,0,0,5,1,3,1,4,1,0,1,1,1,1,-1,1,1
KR_6762156271,420,2,29,12,1,-2,2,4,1,1,0,8,9,1,-5,0,5,-1,1,2,-1,-3,-1,-2,6,4,3,0,0,-1,1,0,-1,2,1
KR_6755285264,420,3,66,16,8,3,3,0,-6,0,6,3,4,1,5,8,3,3,4,1,0,5,1,2,2,4,1,0,1,1,1,1,1,6,1
KR_6731326027,420,6,32,12,11,-1,0,1,1,1,0,6,6,0,4,6,2,1,2,1,0,8,156,3,3,6,-9,0,1,1,1,1,1,3,1
KR_6654630888,420,4,42,44,13,2,3,1,2,3,1,5,8,3,5,6,1,-1,0,1,0,16,14,3,4,7,-1,0,2,1,0,1,1,4,1
KR_6756953541,420,-1,61,-68,3,1,3,2,-2,1,3,-4,1,5,4,4,0,4,4,0,0,7,-1,2,4,6,2,0,-1,-1,-1,-1,-1,5,1
KR_6760924150,420,2,77,-7,2,3,3,0,0,2,2,3,3,0,-2,1,3,-2,0,2,-1,0,-6,2,4,6,4,0,0,1,-1,0,-1,3,1
KR_6694913152,420,1,-7,21,-6,4,5,1,-1,4,5,-5,0,5,2,3,1,-6,2,8,0,-3,-18,0,2,2,2,0,0,1,1,0,1,1,1
KR_6726454775,440,4,42,26,7,3,4,1,0,1,1,1,2,1,2,5,3,1,1,0,0,4,-8,-1,5,4,3,0,0,-1,1,1,1,3,1
KR_6752474758,420,-1,-15,3,-1,-1,0,1,-1,2,3,-3,0,3,-3,2,5,7,7,0,1,1,5,0,5,5,-1,0,0,1,-1,0,1,1,1
KR_6697800652,420,0,-6,40,1,-5,1,6,5,5,0,-1,3,4,0,2,2,2,4,2,0,4,-4,-2,4,2,-4,0,0,1,0,0,-1,6,1
KR_6201679332,420,6,84,53,10,2,4,2,-2,2,4,3,3,0,3,3,0,4,4,0,0,7,0,-2,5,3,4,0,2,-1,1,1,1,5,1
KR_6665701911,420,0,-47,-16,2,1,3,2,2,3,1,-2,1,3,1,1,0,0,1,1,1,9,250,0,5,5,2,0,0,1,-1,0,1,3,1
KR_6758268564,420,1,11,-16,-1,-2,0,2,0,4,4,0,1,1,2,2,0,-1,0,1,0,-5,98,-4,7,3,0,0,0,-1,-1,0,-1,1,1
KR_6758086529,420,2,49,4,-1,2,4,2,0,3,3,0,2,2,-1,0,1,-2,0,2,1,-7,8,6,0,6,1,0,0,1,1,1,1,6,1
KR_6748269284,420,0,-13,24,-1,2,4,2,1,2,1,-3,0,3,-1,2,3,0,0,0,0,-5,-3,-2,5,3,2,0,0,-1,-1,0,-1,2,1
KR_6676851237,420,5,21,36,10,0,2,2,0,0,0,7,7,0,2,2,0,1,1,0,0,8,-1,1,5,6,2,0,0,-1,1,0,-1,4,1
KR_6661324172,420,7,165,8,8,2,6,4,0,3,3,2,3,1,6,7,1,-2,3,5,0,-2,33,-4,6,2,1,0,6,1,1,1,-1,3,1
KR_6588863423,420,1,38,15,3,0,2,2,-1,2,3,0,0,0,4,5,1,0,1,1,-1,-1,-26,-6,11,5,1,0,0,1,-1,0,-1,1,1
KR_6671282750,420,3,27,40,10,4,4,0,2,2,0,-2,2,4,5,8,3,1,2,1,0,8,0,2,1,3,-1,0,0,0,1,0,1,0,1
KR_6762913967,420,3,47,4,6,9,12,3,-2,1,3,-1,2,3,0,3,3,0,3,3,0,6,21,3,3,6,-2,0,3,-1,-1,1,-1,3,1
KR_6705345640,440,-1,0,24,2,1,2,1,-1,5,6,-3,0,3,-1,1,2,6,7,1,0,2,33,0,1,1,-16,0,0,1,0,0,-1,6,1
KR_6745830667,420,2,25,20,5,2,2,0,3,3,0,1,2,1,0,3,3,-1,0,1,-1,5,-9,-4,7,3,-1,0,0,1,1,0,-1,1,1
KR_6751248076,420,5,83,16,6,0,3,3,-1,2,3,3,4,1,3,7,4,1,1,0,1,2,-23,-3,6,3,7,0,0,1,1,1,1,3,1
KR_6596455227,420,-3,33,8,-3,-1,2,3,2,4,2,-1,0,1,-3,0,3,0,2,2,0,2,-2,0,4,4,0,0,0,-1,1,-1,-1,6,1
KR_6669875131,420,-1,-55,13,-1,-1,2,3,-1,1,2,0,4,4,1,2,1,0,1,1,-1,1,-5,-3,4,1,5,0,-2,1,-1,-1,-1,6,1
KR_6724175929,420,-2,73,-29,-5,2,3,1,-2,2,4,-2,2,4,-2,3,5,-1,0,1,1,-6,-30,-1,5,4,3,0,0,-1,0,0,1,5,1
KR_6761915466,440,0,-9,-5,-8,-2,1,3,1,5,4,-3,3,6,-3,3,6,-1,1,2,0,0,-7,0,6,6,5,0,2,0,1,1,-1,0,1
KR_6754719354,420,3,-54,20,12,0,2,2,-1,0,1,6,8,2,5,5,0,2,4,2,0,14,42,1,5,6,-17,0,-2,-1,-1,-1,1,3,1
KR_6686419370,420,-1,52,9,-4,-1,1,2,-2,8,10,-1,1,2,2,2,0,-2,1,3,0,-4,-1,-6,7,1,-1,0,0,-1,-1,0,1,6,1
KR_6735989721,420,-1,-42,-31,2,2,4,2,-3,3,6,2,5,3,1,2,1,0,0,0,1,6,13,-5,9,4,-3,0,0,-1,1,0,1,6,1
KR_6757169479,420,0,13,14,-2,1,3,2,1,3,2,-4,0,4,1,6,5,-1,1,2,0,2,-11,-4,11,7,-1,0,-1,-1,-1,-1,-1,5,1
KR_6758968099,420,2,19,21,7,4,6,2,6,8,2,-1,1,2,0,2,2,-2,1,3,1,1,-2,0,5,5,0,0,1,-1,1,-1,1,6,1
KR_6715787400,420,8,75,14,16,5,8,3,1,4,3,4,7,3,4,7,3,2,2,0,2,7,-34,-2,6,4,0,0,2,1,1,1,-1,1,1
KR_6761616191,420,1,-2,-8,2,0,0,0,-1,3,4,5,7,2,-3,1,4,1,1,0,0,8,-204,0,5,5,-4,0,1,-1,1,1,1,3,1
KR_6748270187,420,4,123,27,12,1,1,0,2,4,2,8,9,1,0,4,4,1,3,2,0,-2,-2,1,2,3,4,0,2,1,1,1,1,5,1
KR_6733939932,420,2,48,8,7,2,3,1,0,3,3,1,6,5,3,3,0,1,3,2,0,2,-11,-6,9,3,9,0,1,-1,0,1,1,2,1
KR_6561677066,420,-2,3,4,-7,-5,0,5,0,2,2,1,4,3,-2,1,3,-1,0,1,0,1,43,-1,6,5,-15,0,0,-1,1,1,-1,2,1
KR_6736786264,420,2,-24,4,2,-2,0,2,-1,2,3,-1,3,4,-1,1,2,7,8,1,0,-6,-76,-1,5,4,-3,0,0,1,0,0,1,4,1
KR_6743625930,420,5,109,33,17,5,5,0,3,5,2,7,8,1,2,3,1,0,0,0,0,8,-26,4,3,7,2,0,1,1,1,1,1,4,1
KR_6681172825,420,0,1,-12,3,4,6,2,-1,0,1,-5,0,5,4,5,1,1,2,1,0,2,3,0,2,2,-1,0,2,-1,1,1,1,3,1
KR_6710448557,420,1,22,4,6,4,4,0,-2,0,2,2,5,3,2,6,4,0,1,1,-2,3,6,1,5,6,-1,0,-1,-1,-1,-1,-1,2,1
KR_6753303270,420,-6,-93,-29,-8,-1,1,2,2,4,2,-5,2,7,0,3,3,-4,1,5,0,1,11,0,7,7,-6,0,-1,-1,-1,-1,-1,1,1
KR_6714736370,420,2,-25,4,6,2,3,1,0,2,2,3,4,1,3,3,0,-2,1,3,0,7,-42,-3,4,1,18,0,0,1,0,0,-1,2,1
KR_6761126584,420,2,16,-12,3,0,2,2,3,5,2,0,2,2,0,3,3,0,1,1,0,4,-3,2,4,6,2,0,3,-1,1,1,1,3,1
KR_6579261123,420,-2,0,-5,-5,3,4,1,3,5,2,-2,0,2,-1,1,2,-8,1,9,-1,-2,-34,-2,6,4,-1,0,0,-1,1,0,-1,6,1
KR_6748849102,420,2,45,-6,6,2,2,0,5,5,0,-3,3,6,1,4,3,1,1,0,0,9,-3,2,4,6,6,0,0,1,1,0,-1,2,1
KR_6760004340,420,4,93,24,17,4,5,1,-1,1,2,6,8,2,3,6,3,5,6,1,0,3,5,1,2,3,1,0,2,1,-1,1,1,3,1
KR_6751196801,440,-3,-26,20,-8,-3,0,3,1,2,1,-4,2,6,-3,1,4,1,3,2,1,-4,12,-1,6,5,-5,0,0,1,-1,0,1,2,1
KR_6758431080,420,4,112,-9,0,2,2,0,-3,2,5,4,4,0,-1,3,4,-2,0,2,1,-3,31,0,8,8,-25,0,1,-1,1,1,1,2,1
KR_6697167369,420,2,45,-15,9,0,3,3,-1,0,1,6,6,0,3,4,1,1,1,0,0,6,-18,1,5,6,-5,0,0,1,-1,1,1,2,1
KR_6746236508,420,-1,47,-40,1,2,2,0,1,3,2,-1,0,1,-1,1,2,0,1,1,0,-3,87,2,4,6,19,0,0,-1,1,0,1,6,1
KR_6700249075,420,6,97,25,8,-2,0,2,6,6,0,2,2,0,2,2,0,0,0,0,0,10,-31,-2,7,5,5,0,3,1,-1,1,1,5,1
KR_6744605544,420,2,60,7,5,1,2,1,2,5,3,1,4,3,3,6,3,-2,0,2,0,3,-46,1,5,6,1,0,1,1,1,1,1,1,1
KR_6682077245,420,1,47,20,5,2,2,0,1,2,1,1,1,0,-3,1,4,4,4,0,-1,-1,-26,-4,7,3,3,0,0,1,-1,0,-1,3,1
KR_6674650276,420,2,45,-16,11,-3,2,5,6,7,1,5,5,0,1,6,5,2,3,1,1,11,6,2,2,4,-3,0,1,1,1,1,1,6,1
KR_6670791045,420,2,-50,-8,2,3,5,2,1,5,4,2,3,1,-2,2,4,-2,1,3,0,-7,-2,-2,8,6,-2,0,0,-1,1,-1,1,4,1
KR_6761678188,420,1,21,-3,3,0,2,2,0,2,2,2,2,0,3,5,2,-2,1,3,0,3,0,3,5,8,2,0,0,1,0,0,-1,6,1
KR_6761089158,420,3,-38,-10,3,2,4,2,-2,1,3,0,1,1,2,2,0,1,1,0,1,5,124,1,4,5,-6,0,0,1,-1,0,1,5,1
KR_6606469716,420,2,-25,-33,8,-1,1,2,4,5,1,3,4,1,1,2,1,1,1,0,0,10,-3,-2,3,1,3,0,-2,-1,-1,-1,1,3,1
KR_6693002552,420,5,78,4,9,0,2,2,2,4,2,3,5,2,6,7,1,-2,0,2,0,15,-2,-3,4,1,0,0,0,1,1,1,1,2,1
KR_6013992553,420,-1,-84,-20,1,3,3,0,-3,3,6,5,8,3,-2,1,3,-2,1,3,-1,-1,168,2,5,7,-3,0,-2,-1,-1,-1,-1,3,1
KR_6757882094,440,2,41,20,8,1,3,2,0,0,0,2,2,0,2,2,0,3,3,0,0,7,40,-3,4,1,-18,0,1,1,-1,1,1,3,1
KR_6727912612,440,7,52,34,6,2,5,3,5,5,0,-1,2,3,0,2,2,0,4,4,-2,0,9,0,3,3,-1,0,2,0,1,1,-1,0,1
KR_6748723152,420,1,69,20,7,0,0,0,6,6,0,1,3,2,2,3,1,-2,0,2,0,4,-27,1,4,5,26,0,0,-1,0,0,-1,4,1
KR_6736246813,420,2,18,4,-2,3,4,1,-1,2,3,-3,1,4,0,3,3,-1,1,2,0,-4,6,-4,5,1,3,0,1,1,1,1,-1,4,1
KR_6521762015,420,5,38,-7,11,2,2,0,5,5,0,0,1,1,3,4,1,1,3,2,1,14,384,3,3,6,2,0,0,1,1,0,1,3,1
KR_6729715952,420,-1,38,8,-2,-4,0,4,-1,3,4,3,4,1,-1,3,4,1,1,0,1,-2,-21,-5,8,3,3,0,1,0,0,1,1,0,1
KR_6749226834,420,-1,52,2,-2,1,6,5,-1,1,2,-2,1,3,2,4,2,-2,2,4,0,-5,-5,-4,5,1,5,0,0,0,1,0,-1,0,1
KR_6761924127,440,4,29,19,-1,-4,1,5,2,4,2,0,1,1,3,13,10,-2,1,3,-2,1,2,3,3,6,-4,0,0,-1,-1,-1,-1,4,1
KR_6475161273,440,-3,-31,-5,-8,-6,0,6,-1,0,1,6,9,3,-1,0,1,-6,0,6,1,-4,0,1,4,5,-3,0,0,1,1,0,1,5,1
KR_6763537567,420,-5,-47,0,-4,-6,0,6,3,6,3,2,3,1,3,3,0,-6,0,6,0,0,-1,1,3,4,1,0,-1,0,-1,-1,-1,0,1
KR_6754955827,420,6,83,45,17,3,6,3,-1,2,3,5,8,3,6,7,1,4,4,0,4,13,27,0,3,3,1,0,1,1,1,1,1,4,1
KR_6671463639,420,-1,33,-4,-2,2,2,0,-7,3,10,1,6,5,1,2,1,1,2,1,1,-3,-39,-1,4,3,0,0,1,0,1,1,1,0,1
KR_6726643114,420,0,7,-27,4,-1,0,1,-1,3,4,3,5,2,2,4,2,1,3,2,1,8,-123,2,3,5,3,0,0,1,-1,0,1,4,1
KR_6471179540,420,4,61,27,11,3,5,2,5,5,0,2,2,0,1,3,2,0,3,3,2,17,1,2,1,3,1,0,4,1,1,1,1,1,1
KR_6757645296,420,1,30,-5,3,-1,0,1,1,3,2,2,2,0,3,3,0,-2,0,2,0,5,-1,0,3,3,0,0,0,1,-1,1,-1,6,1
KR_6757129523,420,-3,-61,-4,-2,0,3,3,-1,2,3,0,1,1,-1,2,3,0,3,3,0,-2,18,1,3,4,-5,0,-1,0,1,-1,1,0,1
KR_6634245992,420,0,28,28,-3,1,2,1,-2,0,2,-2,1,3,1,1,0,-1,1,2,0,4,-2,-2,7,5,0,0,0,1,-1,0,-1,4,1
KR_6722505276,420,-1,-72,20,6,-2,1,3,13,14,1,-1,1,2,-4,0,4,0,0,0,0,12,-4,1,4,5,-3,0,0,0,1,0,-1,0,1
KR_6742074283,420,3,-4,8,5,-1,1,2,1,3,2,-1,1,2,5,7,2,1,2,1,3,17,10,4,3,7,-2,0,0,-1,-1,1,1,5,1
KR_6758313044,420,2,24,8,9,2,4,2,-1,0,1,1,2,1,5,5,0,2,3,1,1,10,8,2,2,4,3,0,1,1,1,1,1,6,1
KR_6733646161,420,-1,2,-10,-2,0,1,1,3,5,2,-4,2,6,1,2,1,-2,0,2,0,2,1,-3,6,3,-1,0,-1,1,-1,-1,1,2,1
KR_6722258552,420,4,93,20,7,1,4,3,-1,2,3,3,4,1,3,4,1,1,3,2,0,9,-8,-2,4,2,1,0,2,1,1,1,1,4,1
KR_6677035578,420,1,-5,1,0,0,0,0,1,1,0,1,2,1,-2,2,4,0,2,2,0,-1,33,2,2,4,-3,0,0,-1,1,0,-1,3,1
KR_6739300335,420,1,75,43,0,-2,1,3,1,3,2,-1,1,2,2,3,1,0,0,0,0,4,-7,-1,7,6,10,0,0,1,-1,0,-1,3,1
KR_6569854307,420,2,-1,16,-1,-6,0,6,-1,3,4,3,4,1,1,3,2,2,2,0,0,2,-3,-3,6,3,2,0,-1,1,-1,1,-1,6,1
KR_6538792648,420,2,-49,32,2,-5,0,5,6,6,0,-1,1,2,-3,1,4,5,5,0,0,6,-9,-4,5,1,3,0,-1,-1,1,-1,-1,6,1
KR_6733775817,420,8,139,12,18,6,7,1,5,6,1,5,5,0,1,4,3,1,2,1,0,16,15,5,2,7,1,0,4,1,1,1,1,4,1
KR_6583983569,420,0,-17,-12,8,-3,0,3,3,5,2,-3,0,3,11,12,1,0,2,2,2,19,-41,0,4,4,26,0,-2,1,-1,-1,1,3,1
KR_6696721946,420,3,79,24,0,5,6,1,0,5,5,-1,0,1,-2,1,3,-2,0,2,1,-3,-33,1,3,4,3,0,4,1,1,1,1,4,1
KR_6666694739,420,2,-25,5,6,-1,1,2,4,4,0,-2,0,2,5,5,0,0,0,0,0,8,77,0,2,2,-3,0,0,0,1,0,-1,0,1
KR_6761188359,420,-2,-35,-8,-4,-1,1,2,-3,3,6,1,3,2,-1,4,5,0,4,4,0,-1,3,1,3,4,3,0,0,-1,-1,0,1,6,1
KR_6757715702,420,-4,-22,8,-5,0,3,3,-2,5,7,0,3,3,-1,4,5,-2,0,2,-1,-9,-20,0,3,3,-3,0,-1,0,1,-1,-1,0,1
KR_6727006101,440,0,-18,23,-2,5,7,2,-4,3,7,0,2,2,-4,2,6,1,1,0,-1,-5,10,1,4,5,-5,0,1,0,0,1,-1,0,1
KR_6689874563,420,1,23,15,2,-5,1,6,2,2,0,0,2,2,2,6,4,3,3,0,0,3,5,0,6,6,-4,0,1,-1,1,1,1,2,1
KR_6413510121,420,2,63,12,4,5,7,2,-6,3,9,3,5,2,1,1,0,1,1,0,2,-1,-5,3,6,9,0,0,1,1,-1,1,1,1,1
KR_6624531168,420,2,20,8,1,1,1,0,5,6,1,-2,1,3,-2,3,5,-1,1,2,0,3,9,4,4,8,-6,0,1,1,1,1,-1,6,1
KR_6687279905,420,3,21,25,0,-2,0,2,-1,3,4,1,3,2,1,2,1,1,1,0,0,7,15,3,4,7,2,0,1,1,1,1,-1,1,1
KR_6756591263,420,-1,-2,-8,2,2,3,1,-2,2,4,3,4,1,0,4,4,-1,0,1,0,-5,-8,-3,7,4,-1,0,0,0,-1,0,-1,0,1
KR_6760591381,440,1,-26,8,6,-2,0,2,2,2,0,-5,1,6,7,9,2,4,5,1,1,1,7,2,5,7,0,0,1,1,1,1,1,2,1
KR_6709921195,420,0,132,-1,-1,1,1,0,-1,3,4,-2,0,2,-1,3,4,2,2,0,0,-2,29,0,4,4,0,0,1,1,-1,1,1,1,1
KR_6748433811,420,1,57,6,-4,7,8,1,-4,1,5,0,3,3,-6,2,8,-1,0,1,-2,-8,259,-1,6,5,-1,0,1,1,-1,1,-1,5,1
KR_6760476810,420,2,40,-4,6,3,3,0,0,2,2,-2,4,6,3,3,0,2,2,0,0,3,-2,1,2,3,3,0,0,1,1,0,1,3,1
KR_6658228762,420,2,-4,-23,3,2,2,0,2,3,1,3,4,1,-2,1,3,-2,4,6,-1,-2,0,2,5,7,8,0,1,-1,-1,-1,-1,1,1
KR_6758415895,420,-1,53,-12,0,0,1,1,-3,1,4,4,6,2,-3,3,6,2,2,0,0,6,-8,0,6,6,-3,0,0,1,-1,1,1,4,1
KR_6753614485,420,0,76,-20,5,2,3,1,5,5,0,0,1,1,-4,1,5,2,4,2,1,2,-4,-2,5,3,2,0,1,-1,0,1,1,1,1
KR_6695041484,420,1,23,-6,5,1,1,0,1,4,3,3,4,1,2,3,1,-2,1,3,-1,5,-13,2,2,4,0,0,1,1,1,1,-1,6,1
KR_6762426459,420,-1,1,20,4,-7,2,9,1,1,0,0,1,1,8,10,2,2,3,1,0,14,7,4,0,4,-2,0,2,1,1,1,1,6,1
KR_6664693833,420,-2,-34,12,2,1,2,1,4,8,4,0,2,2,-2,1,3,-1,0,1,1,2,-5,-3,7,4,6,0,0,-1,0,-1,1,4,1
KR_6730534398,420,4,23,3,7,1,2,1,3,5,2,2,4,2,-1,1,2,2,2,0,0,12,58,0,5,5,2,0,2,-1,1,1,1,6,1
KR_6689281369,420,8,129,44,11,1,2,1,7,7,0,1,1,0,1,2,1,1,1,0,0,13,41,3,2,5,5,0,4,1,1,1,1,1,1
KR_6629460757,420,-2,-60,-32,1,3,6,3,0,2,2,1,3,2,-4,1,5,1,1,0,4,5,3,0,6,6,0,0,1,0,1,1,1,0,1
KR_6740469275,420,0,47,-4,5,1,1,0,6,8,2,-7,2,9,5,5,0,0,0,0,1,2,8,8,2,10,-2,0,2,1,1,1,1,2,1
KR_6692082364,420,1,14,12,-2,2,4,2,-4,1,5,1,1,0,0,3,3,-1,2,3,0,-7,-2,-9,12,3,3,0,1,1,-1,-1,-1,4,1
KR_6606703959,420,3,73,5,0,-2,3,5,-8,0,8,2,3,1,1,3,2,7,7,0,0,2,11,-4,8,4,6,0,2,-1,0,1,-1,1,1
KR_6435969858,420,2,-11,23,7,2,2,0,1,7,6,3,5,2,1,6,5,0,1,1,2,12,-5,7,8,15,1,0,-1,1,-1,-1,1,1,1
KR_6733706974,420,4,68,16,6,-2,3,5,-2,2,4,3,5,2,-1,2,3,8,8,0,0,-1,2,-2,4,2,4,0,1,1,-1,-1,1,2,1
KR_6744137057,440,1,37,-25,4,1,1,0,-2,1,3,2,2,0,2,4,2,1,1,0,0,1,9,2,5,7,4,0,1,1,-1,1,1,5,1
KR_6683511714,420,-4,-15,-23,-5,3,4,1,-5,4,9,-2,2,4,1,2,1,-2,0,2,0,0,13,3,2,5,-1,0,-1,1,-1,-1,-1,3,1
KR_6644578561,420,-1,16,-8,-2,-3,0,3,-3,1,4,-1,2,3,4,4,0,1,2,1,0,1,174,1,5,6,0,0,1,1,1,1,-1,5,1
KR_6669325511,420,-5,-42,-36,-10,-1,2,3,-6,3,9,-3,1,4,0,3,3,0,1,1,0,-6,0,5,4,9,-5,0,0,-1,1,-1,-1,6,1
KR_6758151718,420,4,17,28,14,0,0,0,3,3,0,11,11,0,1,5,4,-1,2,3,1,4,27,0,5,5,0,0,1,-1,1,1,1,2,1
KR_6754473014,420,-3,-51,-28,-9,-2,1,3,-1,3,4,-4,3,7,-3,1,4,1,1,0,0,-11,5,-7,9,2,1,0,-1,-1,-1,-1,1,4,1
KR_6730480350,420,5,75,14,20,2,2,0,4,6,2,0,0,0,10,11,1,4,5,1,0,17,-3,-1,7,6,8,0,2,1,1,1,1,2,1
KR_6710155919,440,3,-6,18,8,1,3,2,0,2,2,5,7,2,2,7,5,0,1,1,0,17,-27,-2,6,4,6,0,0,1,-1,-1,-1,1,1
KR_6680186803,420,3,110,5,12,10,10,0,0,2,2,-1,2,3,6,8,2,-3,2,5,1,9,-42,-2,5,3,30,0,3,1,1,1,1,6,1
KR_6762244757,420,0,28,24,-4,-1,0,1,0,2,2,-2,3,5,2,4,2,-3,0,3,0,-5,-31,2,2,4,-4,0,1,1,-1,1,-1,6,1
KR_6708310039,420,-3,-41,0,-6,1,1,0,-5,2,7,0,0,0,-1,1,2,-1,0,1,0,-8,-27,0,6,6,0,0,0,-1,-1,0,-1,6,1
KR_6736540805,420,5,-27,4,13,0,1,1,1,3,2,7,9,2,1,2,1,4,4,0,0,15,-13,2,3,5,-1,0,0,1,1,0,1,1,1
KR_6760497698,440,7,41,28,10,2,3,1,3,3,0,4,7,3,0,3,3,1,3,2,1,18,3,0,4,4,2,0,0,-1,-1,1,1,1,1
KR_6764271256,420,2,-22,28,7,5,6,1,2,4,2,4,5,1,-6,0,6,2,3,1,1,0,2,-1,3,2,-6,0,1,-1,1,1,1,1,1
KR_6659966974,420,-1,10,-27,-5,-2,2,4,1,4,3,-2,2,4,0,2,2,-2,0,2,0,-1,12,5,2,7,0,0,-1,-1,1,-1,1,6,1
KR_6670315121,420,-1,-68,4,0,-2,0,2,3,6,3,2,2,0,-3,2,5,0,3,3,0,-1,-9,-2,8,6,3,0,-1,1,-1,-1,-1,2,1
KR_6763542846,440,3,55,33,6,2,3,1,4,4,0,8,9,1,-8,1,9,0,3,3,0,1,-10,4,2,6,-1,0,0,1,0,-1,1,2,1
KR_6669905325,420,4,12,23,6,3,6,3,0,3,3,0,2,2,1,2,1,2,2,0,0,2,16,-3,6,3,-5,0,0,1,-1,-1,-1,5,1
KR_6763317350,420,-1,12,8,-3,-4,0,4,1,1,0,-2,0,2,0,1,1,2,2,0,0,3,2,-6,8,2,2,0,0,1,-1,-1,-1,3,1
KR_6740798984,420,0,-15,1,-8,3,3,0,0,1,1,0,1,1,-1,3,4,-10,0,10,0,-9,-19,-3,6,3,2,0,0,-1,0,-1,-1,3,1
KR_6706471175,420,3,59,17,5,-2,1,3,-1,1,2,2,3,1,5,5,0,1,2,1,0,5,6,3,4,7,1,0,1,1,0,1,1,6,1
KR_6744226383,420,0,39,14,8,-1,1,2,8,8,0,-1,4,5,3,5,2,-1,1,2,0,4,4,0,6,6,2,0,2,1,1,1,1,6,1
KR_6753728487,420,0,3,12,-2,3,4,1,-1,2,3,-1,1,2,-1,3,4,-2,0,2,1,-9,-7,1,2,3,1,0,0,1,1,1,1,5,1
KR_6696595539,420,3,48,10,7,2,3,1,0,1,1,-5,0,5,10,11,1,0,1,1,0,7,11,5,0,5,-2,0,2,1,1,1,1,3,1
KR_6717673167,420,2,15,14,4,-2,0,2,5,5,0,-4,0,4,1,4,3,4,4,0,0,8,-72,-5,6,1,3,0,-1,1,-1,1,1,3,1
KR_6689721772,440,1,16,2,5,1,5,4,-3,1,4,3,4,1,2,6,4,2,2,0,0,9,19,0,8,8,2,0,1,1,0,1,1,4,1
KR_6621594669,420,3,16,-12,13,6,6,0,7,8,1,0,2,2,0,3,3,0,3,3,0,6,-17,3,5,8,-1,0,0,-1,-1,-1,1,2,1
KR_6694660108,420,0,24,8,2,2,2,0,1,6,5,2,2,0,-4,0,4,1,1,0,0,-1,-4,3,2,5,1,0,0,-1,1,0,-1,4,1
KR_6649427277,420,0,24,-13,-3,2,4,2,0,2,2,2,5,3,-3,0,3,-4,0,4,0,-2,5,-7,8,1,-2,0,-1,1,-1,1,1,2,1
KR_6761862022,440,2,-11,44,0,7,8,1,-1,1,2,-1,2,3,-6,3,9,1,2,1,-1,1,28,4,2,6,1,0,-1,1,0,-1,-1,4,1
KR_6688126119,420,-1,-20,11,-6,-2,2,4,2,2,0,0,5,5,-5,2,7,-1,0,1,0,-10,-19,0,8,8,-3,0,0,1,1,-1,-1,5,1
KR_6759316792,420,2,-10,13,0,2,2,0,0,3,3,1,4,3,-2,0,2,-1,2,3,0,0,-9,-4,9,5,3,0,0,-1,-1,0,-1,2,1
KR_6755679925,440,4,61,68,7,-1,0,1,7,8,1,0,1,1,0,0,0,1,5,4,0,2,-11,2,3,5,7,0,0,1,1,1,1,1,1
KR_6636264105,420,-1,30,18,1,3,3,0,-2,0,2,1,1,0,2,4,2,-3,0,3,0,-3,-6,-3,5,2,0,0,0,-1,1,0,1,6,1
KR_6764387422,420,2,-31,16,7,0,0,0,2,4,2,3,4,1,1,2,1,1,1,0,0,3,131,4,3,7,-1,0,0,1,1,0,-1,4,1
KR_6753652282,420,6,-22,19,17,6,7,1,8,8,0,1,3,2,3,4,1,-1,2,3,0,12,6,6,2,8,4,0,0,0,1,0,-1,0,1
KR_6749259002,420,2,61,-8,3,3,4,1,2,4,2,0,2,2,-1,1,2,-1,1,2,0,-1,2,2,4,6,0,0,1,0,-1,1,1,0,1
KR_6719639295,420,-1,9,-24,-7,-2,2,4,1,4,3,0,1,1,-4,1,5,-2,1,3,0,-11,6,0,5,5,-3,0,0,1,1,0,-1,1,1
KR_6706723058,420,5,39,32,14,7,7,0,-1,2,3,-1,1,2,6,7,1,3,3,0,0,8,-2,1,5,6,3,0,1,-1,1,1,-1,4,1
KR_6655027065,420,5,61,14,8,1,3,2,3,4,1,2,2,0,0,2,2,2,2,0,0,5,-1,-3,5,2,1,0,0,0,-1,1,-1,0,1
KR_6737404888,420,0,-34,1,1,2,3,1,0,5,5,0,1,1,-1,2,3,0,0,0,0,4,127,3,2,5,-4,0,0,1,1,1,1,3,1
KR_6635399759,420,-1,108,13,1,-4,1,5,-1,2,3,5,5,0,0,0,0,1,2,1,0,3,-21,6,5,11,0,0,1,-1,1,1,-1,1,1
KR_6729389974,440,-1,-15,-16,-7,-1,1,2,2,4,2,1,3,2,-4,7,11,-5,1,6,-2,-9,-3,4,4,8,-1,0,0,-1,1,-1,-1,1,1
KR_6759901726,420,-2,-45,-44,-4,-7,1,8,-1,2,3,3,3,0,0,4,4,1,2,1,-2,2,-156,1,4,5,-2,0,0,1,1,0,-1,5,1
KR_6762917044,440,6,62,28,12,3,3,0,1,2,1,2,3,1,-1,3,4,7,7,0,0,7,53,4,1,5,-30,0,4,1,1,1,1,1,1
KR_6733279185,420,-2,-14,7,-3,-3,0,3,-3,3,6,0,3,3,3,3,0,0,0,0,0,1,4,0,4,4,-1,0,1,0,1,1,-1,0,1
KR_6539422178,440,1,118,0,-1,-2,2,4,-2,1,3,5,7,2,-1,4,5,-1,0,1,1,2,3,1,2,3,-2,0,0,0,-1,0,1,0,1
KR_6760381469,420,3,48,1,10,-1,1,2,2,6,4,-2,4,6,12,14,2,-1,2,3,2,14,-1,0,3,3,-1,0,-1,1,-1,1,1,1,1
KR_6741091034,420,1,-25,17,0,1,2,1,-1,1,2,-2,2,4,2,2,0,0,2,2,-1,5,7,2,3,5,0,0,1,-1,0,1,-1,4,1
KR_6730724361,420,0,98,-12,0,3,3,0,-3,2,5,1,1,0,0,4,4,-1,1,2,1,-3,33,-5,11,6,-26,0,1,-1,-1,1,1,4,1
KR_6760874955,420,-1,-54,-30,-1,0,0,0,0,0,0,1,1,0,1,3,2,-3,1,4,0,-2,169,1,2,3,0,0,0,1,1,1,-1,5,1
KR_6756557222,440,10,144,59,12,7,7,0,3,3,0,-1,1,2,2,3,1,1,2,1,1,10,33,0,2,2,-2,0,4,1,1,1,1,1,1
KR_6703704848,420,-1,-3,-34,-1,2,3,1,2,3,1,-2,1,3,-2,1,3,-1,0,1,0,3,50,-5,9,4,-32,0,1,-1,1,1,-1,2,1
KR_6699576263,420,4,43,18,5,4,6,2,-3,1,4,1,3,2,3,4,1,0,0,0,0,3,4,2,5,7,0,0,1,1,1,1,-1,5,1
KR_6721706294,420,3,41,16,1,1,1,0,2,3,1,4,5,1,-6,0,6,0,0,0,0,3,-169,-3,8,5,3,0,0,1,1,0,1,3,1
KR_6761580368,420,5,-24,33,11,5,5,0,0,3,3,1,6,5,4,4,0,1,1,0,0,12,117,0,6,6,-1,0,2,1,1,1,1,3,1
KR_6737953134,420,3,54,38,7,1,2,1,-2,3,5,4,7,3,-1,2,3,5,7,2,0,-3,17,-6,8,2,1,0,2,1,0,1,1,5,1
KR_6724819787,420,11,58,-17,2,0,1,1,2,2,0,7,7,0,-6,0,6,-1,0,1,0,7,0,-2,4,2,1,0,2,1,-1,1,-1,2,1
KR_6761198138,420,2,134,25,4,5,5,0,-3,2,5,2,4,2,-2,0,2,2,2,0,0,-8,-291,0,6,6,-5,0,1,-1,0,1,1,2,1
KR_6761594299,420,2,9,-5,-4,-2,0,2,1,2,1,0,2,2,-2,0,2,-1,0,1,0,-2,-9,-6,8,2,2,0,0,-1,0,0,-1,1,1
KR_6731826003,420,0,-3,4,1,3,3,0,-5,1,6,1,2,1,0,1,1,2,2,0,0,4,-1,6,3,9,-3,0,0,-1,-1,0,-1,6,1
KR_6649868915,420,-1,1,-18,-3,3,3,0,0,1,1,-4,1,5,-1,0,1,-1,0,1,0,1,-4,-3,8,5,4,0,0,-1,-1,-1,-1,4,1
KR_6736334617,420,1,52,-15,5,1,2,1,-2,1,3,-1,0,1,5,6,1,2,3,1,0,7,1,3,2,5,-1,0,1,-1,1,1,1,3,1
KR_6556508882,420,2,-17,6,3,0,1,1,2,6,4,2,4,2,-1,2,3,0,1,1,0,-2,63,-3,6,3,3,0,0,-1,1,0,-1,1,1
KR_6747973829,420,0,23,7,0,-5,0,5,-1,0,1,-1,1,2,7,7,0,0,1,1,0,0,-4,0,3,3,1,0,3,-1,-1,1,1,3,1
KR_6733449809,420,3,68,-15,4,3,3,0,-1,2,3,1,4,3,1,5,4,0,2,2,0,0,20,11,3,14,7,0,0,1,-1,1,1,3,1
KR_6661338727,420,2,110,-4,16,16,16,0,-3,0,3,1,3,2,1,2,1,1,3,2,0,-2,5,1,1,2,3,0,4,1,1,1,1,1,1
KR_6731727518,420,-4,10,-14,-2,1,2,1,1,4,3,-7,3,10,3,4,1,0,1,1,0,-1,-224,5,4,9,-3,0,0,1,-1,1,-1,1,1
KR_6731391225,420,-2,-11,-16,2,-3,1,4,-2,2,4,0,5,5,5,5,0,2,4,2,0,-2,-1,-1,4,3,2,0,0,-1,-1,1,1,3,1
KR_6694547228,420,3,39,23,4,1,3,2,4,6,2,-2,1,3,-2,1,3,3,5,2,0,8,12,0,3,3,0,0,2,0,0,1,1,0,1
KR_6757542400,420,2,4,-27,-1,4,4,0,-5,1,6,1,2,1,0,2,2,-1,0,1,0,-5,-48,0,1,1,15,0,0,-1,0,0,-1,1,1
KR_6759457401,420,1,-14,-12,1,2,2,0,2,3,1,1,4,3,-1,1,2,-3,1,4,0,-3,-16,-1,7,6,5,0,1,-1,1,1,1,1,1
KR_6764600596,420,0,-1,12,2,4,6,2,-1,2,3,-1,1,2,-2,3,5,2,4,2,-1,1,3,2,3,5,-5,0,0,1,-1,0,-1,6,1
KR_6760890614,420,3,-28,4,3,3,4,1,0,2,2,-2,0,2,3,4,1,-1,0,1,0,0,-44,-5,8,3,22,0,1,1,1,1,-1,3,1
KR_6294228027,440,-5,-56,-4,-12,-1,3,4,3,3,0,-5,0,5,-3,2,5,-6,2,8,0,-20,-18,0,7,7,2,0,0,0,-1,0,1,0,1
KR_6687157255,420,2,45,24,2,4,5,1,-3,5,8,-4,1,5,5,8,3,0,0,0,0,-17,-21,-1,3,2,4,0,1,-1,1,1,1,2,1
KR_6754402124,440,2,35,0,10,0,1,1,-1,1,2,9,9,0,1,3,2,1,1,0,0,10,6,5,0,5,-3,0,1,1,-1,1,1,3,1
KR_6650615868,420,2,86,5,5,1,1,0,-4,5,9,2,2,0,6,9,3,0,2,2,0,-3,-204,-2,6,4,20,0,0,-1,-1,-1,-1,1,1
KR_6761685509,420,0,-79,-8,-5,-3,1,4,1,5,4,1,4,3,-3,2,5,-1,1,2,0,-1,-2,1,2,3,-6,0,-1,-1,0,-1,-1,1,1
KR_6672584601,420,2,57,5,10,5,5,0,7,8,1,2,3,1,-1,0,1,-3,0,3,0,8,9,1,4,5,1,0,2,-1,1,1,-1,4,1
KR_6703583094,420,6,71,32,23,6,7,1,5,5,0,1,1,0,4,7,3,7,7,0,2,24,-3,2,2,4,0,0,2,1,0,1,1,3,1
KR_6685717713,420,6,75,17,21,3,4,1,5,7,2,-1,1,2,8,10,2,6,8,2,1,14,-3,1,4,5,5,0,3,1,-1,1,1,2,1
KR_6745612194,420,2,36,22,8,-3,0,3,9,9,0,1,2,1,2,7,5,-1,1,2,-1,10,15,-5,10,5,0,0,1,1,1,1,-1,1,1
KR_6752295617,420,4,36,-1,9,0,0,0,1,1,0,6,7,1,1,7,6,1,2,1,0,13,12,-3,9,6,2,0,0,1,-1,1,1,1,1
KR_6739585687,440,-2,-60,-4,-6,-1,1,2,-1,3,4,-3,1,4,1,1,0,-2,3,5,0,-7,-21,-6,10,4,5,0,-1,1,1,-1,-1,5,1
KR_6455406531,420,0,-47,0,-2,-3,3,6,1,7,6,-1,1,2,-2,1,3,3,4,1,-3,-3,2,-1,6,5,-1,0,0,-1,1,0,-1,3,1
KR_6667615233,420,-2,16,4,0,1,1,0,1,3,2,-1,5,6,-1,1,2,0,1,1,0,-4,-9,-4,8,4,4,0,-1,-1,-1,-1,-1,5,1
KR_6757786291,420,-2,-42,-8,1,1,2,1,2,3,1,-1,1,2,-3,1,4,2,3,1,0,9,-2,-1,5,4,0,0,0,-1,1,0,1,3,1
KR_6719319314,420,4,-3,24,8,-2,0,2,-1,4,5,6,7,1,6,9,3,-1,0,1,0,4,-159,-2,3,1,-4,0,-1,-1,-1,1,1,1,1
KR_6760589116,420,2,127,4,-1,0,4,4,1,4,3,2,4,2,-2,2,4,-2,0,2,-1,-3,245,1,6,7,-2,0,0,1,1,1,-1,4,1
KR_6741100369,420,2,6,44,4,3,3,0,3,4,1,0,0,0,-1,0,1,-1,1,2,0,1,7,-2,8,6,2,0,1,0,1,1,1,0,1
KR_6737519379,420,2,20,16,6,1,2,1,2,5,3,0,3,3,2,5,3,1,2,1,0,12,9,1,7,8,0,0,0,1,0,0,1,1,1
KR_6662111240,420,3,85,-7,18,3,5,2,-1,3,4,3,4,1,11,11,0,2,3,1,1,14,50,5,1,6,-14,0,3,1,1,1,1,3,1
KR_6708998186,440,2,22,26,0,5,5,0,-1,0,1,1,1,0,-3,2,5,-2,0,2,0,-4,-4,-4,5,1,-1,0,0,-1,1,-1,-1,5,1
KR_6741117680,420,4,72,15,8,-2,2,4,1,2,1,6,7,1,2,3,1,1,3,2,0,2,12,2,7,9,2,0,1,-1,1,1,1,5,1
KR_6746644274,420,-2,-15,28,2,-2,0,2,-1,6,7,-3,0,3,2,3,1,6,6,0,0,-1,-16,1,3,4,-1,0,2,-1,1,1,1,1,1
KR_6751931315,440,2,29,28,-4,-9,7,16,0,1,1,4,4,0,1,1,0,0,1,1,0,-5,-10,-6,10,4,3,0,0,-1,0,-1,-1,4,1
KR_6762078385,420,0,-15,5,-3,5,6,1,-1,0,1,-5,1,6,1,5,4,-3,0,3,0,-11,-2,-3,4,1,4,0,1,-1,1,1,1,3,1
KR_6750891635,420,4,65,33,3,-1,1,2,6,7,1,-1,1,2,-1,2,3,0,1,1,0,8,6,3,5,8,5,0,0,1,1,1,-1,5,1
KR_6630363806,420,4,-15,38,10,3,5,2,2,2,0,3,3,0,5,8,3,-3,0,3,1,9,6,0,5,5,0,0,1,1,0,1,1,6,1
KR_6740539957,420,6,99,-8,14,3,3,0,11,11,0,-3,2,5,1,1,0,2,2,0,0,10,18,0,3,3,1,0,1,1,-1,1,1,3,1
KR_6760238772,420,2,-31,48,3,-4,0,4,2,2,0,1,3,2,2,6,4,2,4,2,0,6,3,-1,3,2,3,0,0,1,0,1,-1,3,1
KR_6716225196,420,0,15,-20,5,-1,0,1,4,6,2,-2,2,4,3,4,1,1,1,0,0,2,1,-3,8,5,-2,0,0,1,-1,-1,1,3,1
KR_6756318272,420,3,39,19,12,3,5,2,3,4,1,2,4,2,3,6,3,1,2,1,-1,11,2,-1,4,3,4,0,0,1,1,1,-1,4,1
KR_6757625872,420,1,-8,-4,1,-3,4,7,2,4,2,4,4,0,-1,3,4,-1,0,1,1,11,7,-2,5,3,0,0,-3,-1,-1,-1,1,3,1
KR_6755116756,440,2,31,15,4,0,0,0,-2,0,2,5,5,0,1,2,1,0,1,1,0,3,9,2,2,4,4,0,1,1,1,1,-1,1,1
KR_6754203062,420,2,39,-4,0,0,1,1,1,3,2,-2,1,3,4,4,0,-3,0,3,0,-3,-9,4,3,7,2,0,0,-1,1,0,-1,4,1
KR_6763593561,420,3,72,-14,5,-1,1,2,-2,3,5,0,1,1,6,8,2,2,2,0,0,12,15,1,2,3,2,0,1,1,0,1,-1,2,1
KR_6576600866,420,2,-14,24,4,-5,1,6,1,3,2,2,3,1,5,5,0,1,2,1,1,-1,3,1,6,7,1,0,0,1,1,0,1,2,1
KR_6746112200,420,1,-21,-8,5,3,4,1,2,4,2,1,2,1,-1,2,3,0,1,1,0,4,3,4,1,5,-2,0,-2,1,-1,-1,-1,5,1
KR_6714193139,420,-5,-41,-28,-7,-2,0,2,-5,1,6,0,3,3,1,5,4,-1,0,1,-1,-7,-4,-6,7,1,2,0,0,-1,0,-1,-1,5,1
KR_6747329675,420,1,18,16,3,3,5,2,1,1,0,-1,4,5,-1,3,4,1,2,1,0,-2,109,2,1,3,2,0,0,-1,1,0,1,2,1
KR_6425189763,420,-2,-44,5,-5,1,1,0,-10,0,10,1,2,1,3,7,4,0,1,1,-1,-10,80,-7,8,1,-4,0,1,-1,1,1,1,1,1
KR_6408253048,420,1,0,-32,4,-2,3,5,-1,1,2,5,7,2,-3,1,4,5,5,0,-1,-3,-38,-2,7,5,4,0,-2,1,-1,-1,-1,4,1
KR_6730290136,440,-3,-21,-24,-1,0,2,2,-1,2,3,-1,0,1,2,2,0,-1,0,1,0,-1,0,1,3,4,-3,0,0,1,0,-1,1,5,1
KR_6716482457,440,0,-12,12,1,-1,0,1,-1,4,5,6,8,2,-1,1,2,-2,0,2,0,2,-14,-4,6,2,0,0,0,1,-1,0,1,1,1
KR_6713493692,420,1,40,9,2,-2,0,2,3,6,3,3,4,1,-2,2,4,0,1,1,-1,0,23,-1,7,6,-4,0,1,-1,1,1,-1,2,1
KR_6674627283,420,3,25,-3,5,-1,2,3,0,1,1,0,2,2,3,3,0,3,4,1,0,8,-7,-3,8,5,5,0,1,1,1,-1,1,3,1
KR_6347565065,420,1,30,-8,5,1,1,0,-1,0,1,0,2,2,5,8,3,0,2,2,0,6,140,0,7,7,-6,0,1,1,-1,1,1,1,1
KR_6617190047,420,4,36,5,13,7,8,1,-2,3,5,0,3,3,8,8,0,0,1,1,0,11,14,7,1,8,-3,0,2,-1,1,1,1,3,1
KR_6707173837,420,2,6,3,6,1,2,1,4,6,2,1,3,2,-1,0,1,1,2,1,0,4,-22,-3,6,3,7,0,2,1,1,1,1,1,1
KR_6744304888,420,1,-5,24,6,0,2,2,-2,2,4,3,4,1,3,3,0,2,3,1,0,6,-3,-6,8,2,-1,0,0,-1,1,1,1,5,1
KR_6759954783,420,-4,17,-32,-4,-6,1,7,-2,3,5,-2,0,2,6,7,1,0,2,2,-1,6,-24,-5,6,1,5,0,0,1,-1,-1,-1,4,1
KR_6733782090,440,0,75,3,1,4,5,1,-2,1,3,2,2,0,-1,1,2,-2,0,2,0,0,-19,1,6,7,3,0,1,0,1,1,-1,0,1
KR_6761939826,440,-2,34,-56,-5,0,2,2,0,3,3,-3,0,3,-2,1,3,0,3,3,0,-6,238,0,4,4,6,0,1,1,1,1,1,5,1
KR_6756035943,420,2,-38,5,8,2,2,0,1,3,2,1,2,1,3,5,2,1,1,0,0,8,-7,1,6,7,-2,0,0,1,1,1,1,4,1
KR_6657832897,420,-2,-53,-23,-1,-2,1,3,-1,6,7,4,7,3,-2,1,3,0,0,0,0,-1,-2,2,6,8,2,0,0,1,-1,1,-1,3,1
KR_6711031572,420,-2,-17,-2,-1,-7,0,7,5,5,0,-1,3,4,0,1,1,2,2,0,0,9,4,1,2,3,1,0,-1,-1,1,-1,1,5,1
KR_6388675030,420,7,111,4,10,-2,3,5,1,3,2,6,8,2,3,3,0,2,2,0,-1,6,-1,0,5,5,3,0,0,-1,-1,-1,-1,2,1
KR_6728270058,420,-3,34,-13,-5,0,4,4,-1,1,2,-1,2,3,-3,3,6,0,1,1,0,-7,-3,0,4,4,1,0,-2,-1,1,-1,1,5,1
KR_6726368702,440,2,59,0,13,3,4,1,1,2,1,8,8,0,-1,4,5,2,2,0,0,4,6,2,2,4,2,0,1,1,1,1,1,4,1
KR_6665287061,420,1,3,3,1,-2,0,2,5,6,1,-4,0,4,2,5,3,0,1,1,0,5,-9,1,3,4,-1,0,-1,1,-1,-1,-1,4,1
KR_6568791260,420,0,-13,-13,-6,-2,1,3,3,4,1,0,3,3,-5,6,11,-2,0,2,0,-13,1,6,2,8,-4,0,1,-1,1,1,1,2,1
KR_6751438386,440,3,41,-4,9,5,5,0,-1,1,2,0,4,4,5,5,0,0,3,3,-1,3,-10,-6,9,3,1,0,1,1,-1,1,-1,6,1
KR_6652658249,420,-1,-36,-18,-3,0,0,0,0,4,4,-1,3,4,3,6,3,-5,1,6,0,2,-1,0,5,5,1,0,0,1,-1,-1,-1,3,1
KR_6746184934,420,-2,2,-9,-2,-2,3,5,-2,1,3,1,2,1,0,1,1,1,1,0,0,2,-125,1,2,3,0,0,0,0,0,0,-1,0,1
KR_6762864290,420,-2,-38,11,-8,-3,1,4,-2,0,2,-2,2,4,-1,3,4,0,1,1,0,-9,3,7,2,9,0,0,0,-1,-1,-1,1,6,1
KR_6688993035,420,0,19,0,-1,-2,2,4,-2,2,4,1,2,1,1,2,1,1,1,0,1,-1,-15,0,4,4,4,0,2,-1,1,1,1,1,1
KR_6755853051,440,-1,-17,3,0,-1,1,2,1,2,1,3,3,0,-4,0,4,1,1,0,0,-6,-3,-5,5,0,2,0,1,0,-1,1,-1,0,1
KR_6763517343,420,1,35,-19,7,-2,3,5,5,7,2,-1,0,1,5,6,1,0,2,2,0,17,-9,5,2,7,5,0,0,-1,-1,0,1,5,1
KR_6752858063,420,-2,-7,-22,0,0,0,0,-2,1,3,0,2,2,2,3,1,0,0,0,0,4,-2,-1,2,1,1,0,-1,1,-1,-1,-1,4,1
KR_6751675698,420,0,30,-16,-2,-1,2,3,0,3,3,1,1,0,-2,4,6,0,2,2,0,-3,-18,1,1,2,-2,0,0,1,1,0,1,4,1
KR_6661133626,420,-2,4,1,-6,-4,0,4,-4,0,4,1,2,1,-1,0,1,2,3,1,0,1,-5,0,4,4,3,0,0,1,-1,-1,-1,5,1
KR_6720061240,420,5,102,-20,16,6,7,1,1,5,4,3,4,1,8,10,2,-2,2,4,1,16,9,1,3,4,-4,0,2,1,0,1,1,1,1
KR_6750914700,420,5,43,4,4,0,1,1,-4,0,4,3,4,1,3,5,2,2,4,2,2,1,4,-1,3,2,2,0,0,1,-1,0,1,3,1
KR_6689128016,420,1,9,-16,1,-3,1,4,0,2,2,-2,1,3,5,7,2,1,3,2,0,8,58,-3,5,2,-31,0,0,-1,1,0,-1,2,1
KR_6658200377,420,3,-13,5,6,1,2,1,2,2,0,1,1,0,0,2,2,2,2,0,0,8,51,-6,11,5,3,0,1,1,-1,-1,1,4,1
KR_6724251295,420,4,83,24,9,0,3,3,4,6,2,4,4,0,1,2,1,0,0,0,0,10,24,2,3,5,2,0,1,1,1,1,1,2,1
KR_6471216559,420,0,15,5,-2,-1,2,3,-2,4,6,3,4,1,-3,1,4,1,2,1,-1,-5,-4,-1,9,8,3,0,-1,-1,-1,-1,-1,2,1
KR_6737125859,420,3,-36,32,8,3,3,0,5,5,0,-2,1,3,2,3,1,0,1,1,0,15,17,4,2,6,0,0,0,1,1,0,1,4,1
KR_6757133372,420,-1,28,16,5,0,3,3,3,4,1,1,2,1,1,2,1,0,0,0,0,5,2,1,4,5,2,0,-1,1,-1,-1,1,3,1
KR_6749646091,420,-1,14,-8,1,2,6,4,-1,0,1,-2,1,3,4,5,1,-2,0,2,0,2,12,-2,4,2,0,0,0,1,0,-1,1,1,1
KR_6750312044,420,1,2,-8,-4,-4,0,4,-1,3,4,1,5,4,-1,6,7,1,3,2,-2,4,-1,-5,8,3,5,0,2,-1,-1,1,-1,1,1
KR_6734493091,420,1,-2,2,1,2,2,0,5,9,4,0,2,2,-5,0,5,-1,1,2,1,0,-7,-1,7,6,-7,0,1,1,-1,1,1,3,1
KR_6748925162,420,-1,18,1,-3,-1,3,4,-3,0,3,-1,0,1,2,2,0,0,3,3,0,-6,-36,-3,5,2,1,0,0,-1,-1,0,-1,4,1
KR_6728665021,440,1,-12,5,9,1,3,2,3,5,2,5,7,2,1,2,1,-1,2,3,2,17,17,-2,7,5,-1,0,0,1,1,0,1,3,1
KR_6643655994,420,-2,35,-9,-5,-2,0,2,-1,1,2,-6,1,7,2,5,3,2,4,2,0,-4,-3,1,2,3,-1,0,0,1,-1,-1,1,6,1
KR_6754600102,420,-2,-10,-31,-2,2,2,0,-3,0,3,0,4,4,1,3,2,-2,1,3,0,-13,-1,-3,6,3,2,0,0,-1,1,1,-1,3,1
KR_6738322695,420,-2,4,23,-1,-1,4,5,-1,2,3,1,3,2,0,1,1,0,1,1,0,1,8,1,3,4,-4,0,1,0,-1,1,-1,0,1
KR_6751127582,440,1,2,7,0,2,3,1,-1,0,1,0,2,2,1,5,4,-2,0,2,0,1,298,3,4,7,-1,0,0,0,1,0,1,0,1
KR_6748988667,440,1,61,-16,-7,-5,0,5,2,2,0,-2,1,3,-1,0,1,-1,0,1,0,-5,8,1,3,4,-2,0,0,1,0,0,-1,2,1
KR_6668957494,420,0,56,-12,-1,-1,4,5,0,2,2,2,3,1,-2,1,3,0,0,0,0,-4,110,-4,6,2,8,0,1,-1,1,1,-1,2,1
KR_6762120444,420,3,16,0,13,1,3,2,2,4,2,6,6,0,1,4,3,3,4,1,0,7,117,-6,8,2,5,0,1,-1,-1,1,1,5,1
KR_6753798028,420,3,-4,-8,5,5,5,0,1,3,2,-3,1,4,-1,3,4,3,3,0,1,8,1,-1,5,4,1,0,0,1,-1,0,1,3,1
KR_6425160371,420,1,61,14,5,-2,0,2,2,2,0,-1,2,3,7,10,3,-1,1,2,0,-5,19,0,1,1,-1,0,1,1,-1,1,-1,3,1
KR_6287273993,440,5,39,-28,13,4,6,2,-2,1,3,1,2,1,7,9,2,3,3,0,0,19,234,-1,6,5,-1,0,0,1,-1,1,1,5,1
KR_6762887580,420,-1,-71,0,4,-1,1,2,6,6,0,-1,3,4,-1,3,4,1,2,1,0,1,5,3,3,6,2,0,0,0,1,0,1,0,1
KR_6580932082,420,3,23,32,10,-1,2,3,6,10,4,6,7,1,-1,4,5,0,2,2,0,5,-2,-5,11,6,-2,0,3,1,1,1,1,3,1
KR_6644705552,420,6,77,20,10,3,4,1,3,4,1,2,2,0,0,3,3,2,2,0,0,3,-5,0,4,4,-2,0,1,-1,1,1,-1,1,1
KR_6694533622,420,-2,67,-3,-4,-1,1,2,1,3,2,2,4,2,-3,2,5,-3,0,3,2,-1,-7,-4,7,3,1,0,0,1,-1,0,1,3,1
KR_6292107426,420,1,8,4,0,3,4,1,1,7,6,-4,1,5,1,2,1,-1,0,1,0,-8,8,2,3,5,2,0,1,1,1,1,-1,4,1
KR_6748026553,420,2,51,4,9,9,11,2,1,2,1,-6,1,7,5,5,0,0,1,1,0,9,2,-1,5,4,1,0,1,-1,1,1,1,3,1
KR_6757284285,420,-2,39,-33,-1,0,1,1,0,4,4,-2,1,3,-1,4,5,2,3,1,0,3,-3,-3,6,3,3,0,1,-1,1,1,1,3,1
KR_6742250693,440,2,71,-11,7,0,0,0,0,1,1,5,5,0,0,2,2,2,2,0,0,11,-33,1,4,5,24,0,0,1,1,0,1,3,1
KR_6735765688,420,1,30,-24,4,2,2,0,-1,1,2,2,3,1,3,4,1,-2,0,2,0,2,22,4,3,7,-5,0,0,1,-1,0,1,5,1
KR_6763223052,440,0,-27,40,0,2,4,2,-1,3,4,-1,1,2,-3,3,6,3,4,1,0,3,1,-1,4,3,-2,0,0,-1,1,-1,-1,3,1
KR_6763758113,420,3,8,32,6,2,3,1,3,3,0,2,3,1,-2,2,4,1,3,2,0,1,0,-5,5,0,-1,0,0,-1,-1,0,1,5,1
KR_6726632713,420,3,88,-27,10,4,4,0,6,8,2,-3,1,4,2,4,2,1,2,1,0,8,3,2,2,4,3,0,2,-1,1,1,1,6,1
KR_6726817558,440,3,36,23,0,2,3,1,-6,1,7,1,2,1,0,6,6,3,4,1,1,-5,0,-2,5,3,-2,0,1,-1,0,1,1,5,1
KR_6750452809,420,2,66,-2,2,0,0,0,1,2,1,-3,1,4,2,4,2,2,2,0,0,5,49,2,3,5,-26,0,0,1,0,1,1,5,1
KR_6758544420,420,4,2,24,13,1,1,0,-2,2,4,9,9,0,2,6,4,3,3,0,-1,14,0,3,2,5,0,0,0,0,1,0,-1,0,1
KR_6755306063,420,0,24,0,0,1,2,1,-4,0,4,1,5,4,2,4,2,0,1,1,0,-1,-41,-2,5,3,22,0,0,0,0,0,1,0,1
KR_6632772822,420,0,46,-28,3,1,5,4,-3,0,3,1,3,2,3,5,2,1,3,2,0,-1,15,2,4,6,-2,0,0,-1,-1,1,1,1,1
KR_6620519272,420,-3,9,28,0,0,6,6,-3,2,5,0,2,2,1,3,2,2,2,0,2,-7,-3,1,3,4,-2,0,1,-1,1,1,1,4,1
KR_6565363136,420,1,34,8,-3,0,2,2,1,4,3,2,3,1,-7,0,7,1,1,0,-1,-9,2,2,1,3,-3,0,-1,-1,-1,-1,-1,5,1
KR_6748688099,420,2,20,-3,6,2,2,0,1,3,2,0,1,1,1,3,2,2,2,0,-1,3,26,0,6,6,2,0,0,1,-1,0,-1,6,1
KR_6732335317,420,0,-34,3,1,-1,0,1,0,5,5,-1,0,1,2,2,0,1,1,0,0,6,-13,1,1,2,0,0,0,1,1,0,-1,4,1
KR_6739063897,420,1,-10,4,2,-2,1,3,2,4,2,3,5,2,-2,1,3,1,1,0,0,11,53,-4,5,1,-1,0,0,1,-1,-1,1,4,1
KR_6754197195,420,4,3,-4,7,-1,1,2,5,6,1,-2,2,4,1,3,2,4,4,0,0,7,12,0,5,5,3,0,0,1,0,0,-1,1,1
KR_6579916424,420,1,27,-24,-6,-8,0,8,-1,4,5,3,5,2,0,3,3,0,1,1,-1,-2,-15,-3,6,3,-2,0,-1,-1,-1,-1,-1,4,1
KR_6738453333,420,2,-20,-3,3,-5,2,7,0,0,0,5,6,1,1,3,2,2,2,0,0,0,0,0,2,2,2,0,1,1,1,1,-1,4,1
KR_6761395132,420,4,49,32,3,-1,0,1,2,4,2,1,1,0,1,2,1,0,1,1,0,1,-13,-3,6,3,6,0,1,1,0,1,1,1,1
KR_6743616393,420,4,65,12,10,-1,0,1,1,1,0,3,6,3,3,3,0,4,4,0,0,14,8,6,3,9,2,0,2,1,1,1,1,5,1
KR_6613103318,420,4,66,24,3,2,5,3,-4,2,6,5,6,1,-1,2,3,1,1,0,0,-1,5,-1,7,6,3,0,0,1,-1,0,1,5,1
KR_6733619900,420,3,26,-3,13,2,3,1,5,5,0,3,3,0,3,3,0,0,0,0,0,13,17,5,1,6,2,0,1,1,1,1,1,2,1
KR_6759397181,420,0,34,-16,-3,2,2,0,1,3,2,0,3,3,-4,3,7,-2,0,2,0,-14,-12,1,4,5,0,0,-1,1,-1,-1,1,4,1
KR_6758283360,420,3,-46,14,12,2,2,0,1,2,1,5,5,0,3,3,0,1,1,0,2,13,15,-3,5,2,0,0,-1,1,-1,-1,1,3,1
KR_6668765635,420,7,154,-4,6,3,3,0,1,2,1,2,2,0,0,1,1,0,0,0,0,2,8,0,3,3,-2,0,2,1,-1,1,1,4,1
KR_6733288879,440,5,116,15,17,0,1,1,4,4,0,3,5,2,11,13,2,-1,0,1,0,23,25,5,2,7,3,0,1,-1,1,1,1,3,1
KR_6756892755,420,1,20,8,2,0,2,2,2,4,2,0,2,2,-1,5,6,1,1,0,0,-2,3,2,3,5,1,0,-1,0,-1,-1,1,0,1
KR_6700571106,420,3,45,36,8,0,1,1,-1,1,2,9,10,1,0,4,4,0,1,1,-2,1,10,3,3,6,1,0,1,1,-1,1,-1,6,1
KR_6701436763,420,0,37,25,-1,-2,0,2,7,8,1,-2,0,2,-3,2,5,-1,0,1,0,-6,-1,-1,3,2,5,0,1,1,-1,1,1,3,1
KR_6689370502,420,3,30,32,6,3,3,0,3,4,1,-3,1,4,2,8,6,1,2,1,2,8,18,2,4,6,-3,0,0,1,-1,-1,1,2,1
KR_6717194005,420,0,55,-20,1,-1,0,1,-3,0,3,-1,2,3,3,4,1,3,4,1,0,7,1,2,3,5,1,0,2,-1,0,1,-1,5,1
KR_6458180474,420,-1,0,5,3,-1,2,3,5,6,1,-1,4,5,1,1,0,-1,0,1,0,4,-186,-1,4,3,-2,0,0,-1,-1,0,1,1,1
KR_6672249784,420,-1,-10,0,-4,0,0,0,-2,4,6,0,2,2,-1,1,2,-1,0,1,0,-7,37,4,1,5,-31,0,0,-1,-1,0,-1,5,1
KR_6607673998,420,1,-56,22,-4,-3,0,3,-1,3,4,2,3,1,-2,1,3,0,2,2,0,2,13,1,5,6,2,0,0,1,1,-1,-1,2,1
KR_6762532882,420,1,22,-5,4,-2,3,5,0,4,4,-1,2,3,5,8,3,2,3,1,3,11,-4,-2,6,4,3,0,1,-1,-1,1,1,6,1
KR_6756745203,420,10,40,43,22,9,9,0,2,5,3,3,4,1,7,7,0,1,1,0,0,14,-1,0,6,6,4,0,3,1,1,1,1,5,1
KR_6692540933,420,2,63,-8,-2,2,3,1,3,6,3,1,2,1,-4,1,5,-4,2,6,-1,-1,6,2,5,7,-2,0,1,1,1,1,-1,4,1
KR_6729026502,420,-3,-66,12,-3,-4,0,4,2,4,2,5,7,2,-3,2,5,-3,0,3,-1,1,0,0,3,3,-2,0,0,0,1,0,-1,0,1
KR_6726697985,420,1,45,8,-3,1,1,0,-1,1,2,2,3,1,-2,2,4,-3,0,3,0,-3,-5,-4,11,7,5,0,1,1,-1,1,-1,2,1
KR_6707571122,420,0,-5,24,2,3,3,0,-4,1,5,2,3,1,2,3,1,-1,1,2,0,-6,312,-4,8,4,7,0,1,1,1,1,1,5,1
KR_6712781787,420,-2,-33,-47,-1,1,1,0,-1,1,2,-2,0,2,1,2,1,0,0,0,0,0,16,2,2,4,2,0,0,-1,1,0,-1,2,1
KR_6662717113,420,3,59,5,9,2,3,1,5,6,1,1,2,1,1,2,1,0,1,1,2,5,34,-1,5,4,0,0,1,1,1,1,1,4,1
KR_6763798798,420,-1,11,8,-1,2,2,0,2,2,0,-4,0,4,0,3,3,-1,2,3,0,-1,-23,-1,5,4,0,0,1,-1,1,1,-1,3,1
KR_6760458464,420,-4,5,40,-7,-1,3,4,-3,1,4,-2,1,3,-1,1,2,0,0,0,0,-6,8,-5,5,0,-1,0,-1,0,1,-1,-1,0,1
KR_6760376259,420,2,68,-2,2,1,3,2,-4,1,5,6,7,1,-4,1,5,3,3,0,-3,-8,-10,-4,5,1,-2,0,0,1,1,0,-1,6,1
KR_6697615315,420,-2,29,12,2,-4,0,4,4,4,0,0,1,1,1,4,3,1,2,1,0,8,262,-1,5,4,0,0,0,1,0,0,-1,1,1
KR_6733782366,420,2,-9,24,4,1,2,1,6,6,0,4,4,0,-4,1,5,-3,1,4,0,3,0,3,2,5,-5,0,0,1,1,0,-1,5,1
KR_6757903161,440,-2,-12,-1,-2,2,2,0,1,4,3,2,5,3,-1,4,5,-6,1,7,0,-9,-1,-2,5,3,2,0,-1,1,1,-1,-1,3,1
KR_6673431240,420,4,5,16,7,1,2,1,1,4,3,-1,2,3,3,3,0,3,3,0,0,6,2,2,1,3,-2,0,0,1,0,0,-1,6,1
KR_6632063946,420,4,84,-10,3,1,4,3,3,4,1,-1,2,3,-1,0,1,1,2,1,0,0,15,-2,5,3,-1,0,0,0,1,1,-1,0,1
KR_6757423390,420,0,25,29,1,2,2,0,-1,1,2,-1,1,2,2,5,3,-1,0,1,2,7,-7,4,3,7,-1,0,0,1,-1,0,-1,2,1
KR_6660902924,440,-1,52,6,-3,1,1,0,-1,1,2,0,1,1,-3,1,4,0,1,1,0,-1,-8,-4,7,3,0,0,-1,1,0,-1,1,4,1
KR_6760795300,440,1,68,12,0,-3,1,4,1,1,0,-1,1,2,2,2,0,1,3,2,0,-4,4,2,3,5,1,0,1,-1,1,1,-1,1,1
KR_6749127299,440,1,37,-1,1,3,4,1,2,2,0,-12,0,12,5,5,0,3,4,1,0,-3,3,-3,5,2,-3,0,0,1,-1,1,-1,4,1
KR_6741356821,420,4,31,37,12,3,5,2,3,6,3,5,6,1,1,2,1,0,1,1,0,8,-3,-1,3,2,3,0,3,1,1,1,-1,3,1
KR_6763708742,420,1,78,27,-1,7,10,3,-2,3,5,0,4,4,-8,1,9,2,2,0,1,-2,-1,1,8,9,2,0,0,1,1,1,1,3,1
KR_6728162490,420,3,1,32,8,4,5,1,2,6,4,1,2,1,0,1,1,1,2,1,0,6,-13,-1,5,4,0,0,1,0,1,1,1,0,1
KR_6689945635,420,0,48,-49,1,0,2,2,1,5,4,-2,1,3,-2,1,3,4,4,0,0,5,33,0,3,3,-3,0,0,-1,1,1,-1,6,1
KR_6625931133,420,2,25,44,5,0,1,1,0,1,1,-2,1,3,6,6,0,1,2,1,0,10,-3,-2,4,2,3,0,0,-1,1,1,1,5,1
KR_6674364925,420,4,48,36,9,5,5,0,2,2,0,2,3,1,-1,4,5,1,1,0,0,-2,-48,1,2,3,21,0,1,1,1,-1,-1,4,1
KR_6720258814,420,3,34,-5,0,5,7,2,4,6,2,-1,0,1,-6,0,6,-2,1,3,0,-8,0,-6,9,3,0,0,0,-1,1,0,1,6,1
KR_6761142960,420,0,-6,-33,2,-2,2,4,1,1,0,-1,0,1,3,4,1,1,2,1,0,6,0,3,1,4,1,0,-1,1,-1,-1,-1,1,1
KR_6747119445,420,-1,3,-36,3,-1,0,1,1,1,0,1,2,1,1,1,0,1,1,0,0,2,-4,-3,5,2,1,0,0,1,-1,0,1,1,1
KR_6703743156,420,6,15,0,11,2,2,0,1,4,3,2,6,4,6,6,0,0,1,1,-1,13,1,0,4,4,2,0,0,1,-1,0,-1,2,1
KR_6729010142,440,4,-19,-6,7,2,2,0,7,7,0,-4,0,4,0,1,1,2,2,0,0,3,-5,-2,7,5,1,0,0,-1,-1,1,1,1,1
KR_6657243705,420,2,28,-23,5,-1,2,3,1,4,3,3,4,1,-2,4,6,4,4,0,1,7,9,2,4,6,2,0,-1,1,0,-1,1,1,1
KR_6752383145,420,5,-2,32,11,1,1,0,6,6,0,1,2,1,2,2,0,1,2,1,0,14,33,1,4,5,2,0,1,1,1,1,-1,1,1
KR_6712299127,420,-1,23,21,5,-1,1,2,7,9,2,3,5,2,-5,2,7,1,2,1,0,4,2,6,3,9,0,0,0,1,1,0,-1,3,1
KR_6709083543,420,7,35,8,17,2,3,1,6,6,0,-1,1,2,9,10,1,1,2,1,1,20,-15,-3,10,7,8,0,2,1,1,1,1,1,1
KR_6750185770,440,1,61,11,2,1,3,2,0,3,3,-1,3,4,2,4,2,0,0,0,1,0,-57,-2,6,4,0,0,0,0,0,0,1,0,1
KR_6755837130,420,2,-13,-4,5,2,2,0,1,2,1,0,3,3,1,1,0,1,2,1,0,4,8,7,0,7,-1,0,3,1,1,1,-1,4,1
KR_6752240731,420,3,1,-14,12,2,2,0,4,4,0,2,5,3,4,5,1,0,1,1,0,10,20,4,2,6,1,0,1,1,-1,1,1,2,1
KR_6714256973,420,7,40,76,5,1,3,2,2,2,0,6,6,0,-4,0,4,0,2,2,1,2,-15,-2,6,4,1,0,2,1,1,1,1,5,1
KR_6654629687,420,-1,2,4,4,-6,0,6,6,6,0,1,3,2,3,3,0,0,0,0,0,8,24,2,2,4,6,0,0,1,-1,0,1,5,1
KR_6647104987,420,0,5,0,0,2,4,2,-1,2,3,0,1,1,-1,3,4,0,1,1,0,4,-5,-2,4,2,0,0,1,-1,1,1,-1,4,1
KR_6739324012,440,-3,-11,-28,-7,-1,1,2,-3,0,3,-2,0,2,3,5,2,-4,1,5,0,-2,28,4,3,7,-5,0,0,1,-1,0,1,5,1
KR_6742373975,420,2,68,5,8,3,3,0,1,4,3,3,3,0,1,3,2,0,1,1,0,8,0,2,4,6,2,0,0,1,-1,0,1,1,1
KR_6725916804,420,4,48,28,1,1,3,2,0,3,3,0,4,4,-1,2,3,1,2,1,0,-7,13,2,3,5,-2,0,0,1,-1,1,-1,3,1
KR_6737230432,420,6,-4,24,8,-1,2,3,0,3,3,2,4,2,4,4,0,3,3,0,0,10,-42,4,2,6,17,0,1,-1,1,1,1,5,1
KR_6728519635,420,0,31,0,1,1,2,1,0,1,1,0,4,4,1,1,0,-1,0,1,0,7,18,1,5,6,-1,0,0,-1,1,0,-1,6,1
KR_6714940544,420,-1,-5,-22,6,1,4,3,-1,2,3,-1,6,7,3,5,2,4,6,2,1,7,15,-2,8,6,3,0,1,-1,1,1,1,6,1
KR_6758147745,420,1,81,8,2,2,4,2,0,0,0,-1,2,3,2,5,3,-1,0,1,0,-5,-12,-3,7,4,6,0,0,1,1,0,1,6,1
KR_6530946837,420,-2,-52,4,-4,0,2,2,0,1,1,0,1,1,-2,1,3,-2,1,3,0,-7,-3,1,5,6,4,0,0,1,-1,0,1,1,1
KR_6706580305,440,-3,-48,-12,-4,-5,0,5,-3,2,5,6,8,2,-2,0,2,0,0,0,0,-1,2,3,1,4,1,0,0,1,1,1,-1,4,1
KR_6712035549,420,4,65,-24,15,2,2,0,-1,2,3,5,6,1,5,5,0,4,6,2,0,16,0,0,3,3,-2,0,0,1,-1,0,1,4,1
KR_6752798419,420,0,-1,20,-1,-2,1,3,8,8,0,-6,1,7,-3,1,4,2,2,0,1,-4,-8,-1,5,4,3,0,-1,1,-1,-1,1,6,1
KR_6681569840,420,-3,-19,17,-1,0,1,1,-1,5,6,0,1,1,-1,1,2,1,1,0,0,-2,-4,-3,5,2,0,0,-1,1,-1,-1,-1,4,1
KR_6736671224,440,-1,-31,-1,-2,-2,1,3,5,8,3,2,3,1,-7,0,7,0,1,1,0,-6,12,3,5,8,0,0,-2,-1,-1,-1,-1,6,1
KR_6716071155,420,5,66,0,15,6,7,1,1,2,1,3,3,0,5,6,1,0,0,0,0,12,-2,3,3,6,1,0,1,1,1,1,1,5,1
KR_6754259347,420,5,41,39,10,2,5,3,-1,2,3,2,4,2,5,5,0,2,3,1,0,13,-4,-3,7,4,8,0,0,1,-1,-1,1,1,1
KR_6620474670,420,5,98,20,8,6,6,0,4,6,2,3,3,0,-3,2,5,-2,0,2,0,8,30,4,1,5,2,0,1,1,1,1,-1,3,1
KR_6758521015,420,1,4,-16,7,0,2,2,-1,1,2,-4,1,5,8,9,1,4,4,0,1,11,9,7,1,8,-2,0,0,1,1,0,1,3,1
KR_6757143276,440,0,-19,16,4,-1,0,1,-5,0,5,-1,3,4,2,2,0,9,10,1,0,9,-9,3,6,9,-1,0,0,1,-1,0,-1,1,1
KR_6764790483,420,1,49,0,7,0,3,3,5,5,0,-3,0,3,2,4,2,3,3,0,0,9,-12,-4,8,4,3,0,1,0,-1,1,-1,0,1
KR_6744425055,420,-1,47,-4,2,1,2,1,2,3,1,4,5,1,0,2,2,-5,3,8,0,-2,8,2,1,3,0,0,0,1,-1,1,-1,4,1
KR_6763600334,420,3,116,-16,4,4,5,1,-1,0,1,-1,1,2,3,4,1,-1,0,1,0,3,-6,-1,3,2,2,0,0,1,0,1,1,4,1
KR_6761657701,440,-2,-78,2,-1,3,3,0,3,4,1,4,6,2,-6,0,6,-5,1,6,0,6,-8,4,2,6,-2,0,0,1,-1,-1,1,1,1
KR_6739980828,420,0,-46,-41,2,0,3,3,-3,3,6,4,6,2,5,8,3,-4,4,8,-2,-6,7,1,4,5,3,0,0,1,1,1,-1,5,1
KR_6756465303,420,6,49,48,12,4,4,0,1,3,2,2,3,1,3,7,4,2,3,1,0,8,5,-7,8,1,0,0,-1,-1,0,-1,1,2,1
KR_6663235204,440,1,110,12,-3,-4,1,5,-1,3,4,3,5,2,-1,4,5,0,1,1,0,-5,-1,0,3,3,3,0,0,0,-1,-1,1,0,1
KR_6616650061,420,1,88,4,5,2,4,2,3,5,2,3,6,3,-1,4,5,-2,0,2,0,1,4,4,2,6,-4,0,0,-1,0,0,1,1,1
KR_6728313082,420,-2,-6,32,-5,1,2,1,-1,1,2,-6,0,6,-1,4,5,2,3,1,-1,-7,5,1,7,8,-3,0,0,-1,-1,-1,-1,4,1
KR_6759100902,420,0,55,11,-5,0,3,3,0,1,1,0,1,1,-5,2,7,0,1,1,0,-17,-2,-2,5,3,4,0,1,-1,1,1,-1,2,1
KR_6672538413,420,4,50,51,11,3,3,0,3,5,2,8,8,0,-5,0,5,2,3,1,1,-3,-106,6,3,9,0,0,1,1,1,1,1,4,1
KR_6739474936,420,2,-1,8,0,-2,2,4,-3,2,5,0,4,4,4,4,0,1,1,0,0,2,5,0,6,6,-3,0,1,1,0,1,-1,2,1
KR_6763393686,420,2,3,20,7,2,2,0,3,4,1,1,2,1,-2,0,2,3,3,0,0,9,12,-4,8,4,2,0,0,1,1,1,1,1,1
KR_6733690232,420,-2,3,-16,6,2,3,1,-1,1,2,-4,0,4,2,4,2,7,7,0,0,6,-4,5,0,5,4,0,2,1,1,1,1,5,1
KR_6740328173,420,3,38,12,0,1,1,0,-2,5,7,2,4,2,0,1,1,-1,1,2,0,-3,5,-2,4,2,5,0,1,-1,1,1,1,1,1
KR_6742944088,420,2,-20,8,12,1,2,1,5,6,1,5,7,2,-1,2,3,2,2,0,3,12,6,6,1,7,-4,0,0,0,1,0,1,0,1
KR_6669282062,420,0,74,4,7,2,4,2,0,5,5,2,5,3,3,3,0,0,0,0,0,5,3,-3,7,4,-2,0,0,1,0,0,1,6,1
KR_6763234692,420,2,-41,-2,7,1,2,1,4,6,2,1,3,2,1,3,2,0,1,1,0,13,1,2,1,3,2,0,-1,1,-1,-1,-1,4,1
KR_6758426110,440,4,29,-9,4,-4,0,4,4,5,1,9,9,0,-7,3,10,2,2,0,0,-2,-4,1,4,5,2,0,3,1,-1,1,1,6,1
KR_6638099479,420,4,15,24,11,1,1,0,5,8,3,0,1,1,2,4,2,3,6,3,0,11,202,3,4,7,-2,0,0,1,1,0,1,5,1
KR_6758082786,440,-2,56,-14,-8,-11,2,13,-1,1,2,4,4,0,1,3,2,-1,0,1,-1,-4,44,5,1,6,1,0,2,1,1,1,-1,6,1
KR_6701996819,420,2,10,1,3,1,2,1,0,3,3,5,5,0,-2,2,4,-1,2,3,0,1,-3,-2,6,4,1,0,2,1,-1,1,-1,1,1
KR_6728052381,440,0,49,32,0,1,2,1,3,4,1,2,4,2,0,5,5,-6,0,6,0,-3,-7,-2,6,4,-3,0,1,-1,1,1,-1,3,1
KR_6763027250,420,-1,13,17,-3,3,5,2,-3,4,7,-5,2,7,-2,2,4,4,4,0,0,-10,4,1,3,4,3,0,0,1,1,1,-1,2,1
KR_6651783032,420,2,39,-4,4,0,2,2,2,5,3,2,5,3,0,4,4,0,1,1,-1,2,-26,-3,3,0,4,0,0,-1,-1,0,-1,1,1
KR_6763583262,420,3,57,8,6,2,3,1,3,4,1,3,4,1,4,8,4,-6,1,7,-1,0,7,4,1,5,1,0,-3,1,0,-1,-1,1,1
KR_6743559695,420,-1,31,4,3,-1,1,2,1,4,3,-3,0,3,5,5,0,1,2,1,0,7,-9,1,3,4,1,0,0,1,-1,-1,1,4,1
KR_6699011105,420,4,39,39,4,1,1,0,-3,1,4,2,3,1,2,2,0,2,2,0,0,4,0,2,0,2,1,0,0,1,-1,1,-1,4,1
KR_6643252911,420,3,20,-20,13,1,3,2,1,2,1,-4,0,4,12,12,0,3,4,1,0,14,-6,-2,7,5,0,0,1,-1,-1,1,1,2,1
KR_6708997439,420,3,-15,19,4,-5,2,7,3,7,4,0,0,0,6,8,2,0,0,0,0,5,70,-1,7,6,-1,0,0,1,-1,-1,-1,5,1
KR_6574277847,420,5,41,-8,10,0,1,1,5,6,1,4,5,1,1,2,1,0,0,0,0,13,-46,0,7,7,18,0,1,1,1,1,1,4,1
KR_6742706993,420,0,-51,0,-1,-2,0,2,4,6,2,2,3,1,-3,1,4,-2,0,2,0,-2,-47,2,2,4,11,0,0,0,1,1,-1,0,1
KR_6707334760,420,-3,-18,12,-5,-4,0,4,2,3,1,-1,4,5,-4,4,8,2,3,1,0,-3,5,4,0,4,-2,0,0,1,1,1,1,4,1
KR_6738315105,420,4,72,-18,10,4,4,0,-2,2,4,4,4,0,1,3,2,3,5,2,0,1,-44,2,4,6,33,0,-1,-1,-1,-1,1,3,1
KR_6762957788,420,-4,-22,-36,-9,0,1,1,-3,2,5,-5,0,5,0,2,2,-1,0,1,0,-3,10,-2,3,1,2,0,-1,-1,-1,-1,-1,6,1
KR_6678642255,420,0,-8,24,5,-1,2,3,2,3,1,4,5,1,0,2,2,0,0,0,0,4,28,3,3,6,-5,0,1,1,-1,1,-1,6,1
KR_6612229611,420,3,81,3,7,5,5,0,0,3,3,1,4,3,2,3,1,-1,0,1,1,1,12,3,2,5,1,0,2,1,1,1,1,6,1
KR_6763227363,440,4,26,20,2,2,2,0,-1,1,2,0,2,2,0,0,0,1,3,2,0,-1,2,0,7,7,-1,0,0,-1,1,1,1,4,1
KR_6697583617,420,0,60,11,-5,1,2,1,-1,1,2,-1,0,1,-6,5,11,2,2,0,0,-9,24,0,8,8,2,0,0,1,0,-1,1,2,1
KR_6648452920,420,4,98,16,13,3,3,0,6,9,3,3,3,0,1,2,1,0,0,0,0,7,2,3,4,7,-1,0,3,1,1,1,1,6,1
KR_6756040868,420,6,79,24,16,6,8,2,2,4,2,4,6,2,3,3,0,1,2,1,2,15,9,9,4,13,1,0,2,1,0,1,1,1,1
KR_6758132496,420,0,19,16,3,1,2,1,2,3,1,2,2,0,-2,2,4,0,1,1,0,6,-9,-1,5,4,0,0,0,1,1,1,1,5,1
KR_6657530283,420,2,6,32,-4,0,2,2,1,6,5,-1,1,2,-1,2,3,-3,1,4,-1,-8,5,-8,9,1,4,0,1,1,-1,-1,-1,5,1
KR_6722816065,440,6,45,20,8,1,1,0,7,7,0,0,1,1,1,9,8,-1,3,4,-2,4,6,0,6,6,0,0,1,1,-1,1,1,3,1
KR_6753468515,420,1,-14,4,-1,1,3,2,3,4,1,-6,0,6,-1,1,2,2,3,1,-1,-5,-2,2,4,6,-4,0,-1,1,-1,-1,-1,3,1
KR_6611762686,420,1,104,-23,5,1,4,3,3,5,2,-2,2,4,0,1,1,3,3,0,0,7,-177,0,4,4,-3,0,1,1,-1,1,-1,1,1
KR_6738851980,420,1,-49,9,0,0,3,3,1,1,0,-4,0,4,0,4,4,3,3,0,0,-1,-11,5,4,9,-8,0,-1,0,-1,-1,-1,0,1
KR_6745222844,420,4,42,20,7,1,1,0,2,3,1,3,4,1,2,4,2,-1,0,1,0,10,71,2,4,6,1,0,0,0,1,0,1,0,1
KR_6753735950,440,-1,71,-8,-2,-1,2,3,-1,1,2,-4,2,6,1,4,3,3,4,1,0,0,-4,0,3,3,4,0,1,1,0,1,1,1,1
KR_6731528442,420,1,23,16,7,2,3,1,1,2,1,-4,0,4,5,6,1,3,3,0,0,6,-33,-1,2,1,20,0,0,1,0,0,1,3,1
KR_6633892714,420,0,34,-8,0,-1,0,1,3,5,2,3,3,0,-5,1,6,0,1,1,0,0,-9,2,5,7,2,0,0,-1,1,0,-1,3,1
KR_6581995653,420,2,-30,64,6,1,2,1,2,2,0,2,2,0,1,2,1,0,0,0,0,5,-152,1,0,1,4,0,0,0,1,0,-1,0,1
KR_6564067201,420,-1,-59,-2,1,0,3,3,-4,0,4,5,5,0,0,3,3,0,0,0,-1,11,-10,-4,9,5,5,0,-1,1,1,-1,-1,1,1
KR_6673324990,420,-1,-2,15,-5,0,2,2,3,3,0,1,3,2,-9,0,9,0,1,1,-1,-8,-6,-2,6,4,5,0,-1,-1,1,-1,-1,1,1
KR_6752774287,440,6,22,31,18,5,6,1,1,4,3,0,3,3,7,7,0,5,5,0,1,17,-5,6,3,9,2,0,1,0,-1,1,1,0,1
KR_6736598144,420,6,51,66,8,-2,0,2,6,7,1,4,6,2,1,1,0,-1,0,1,0,10,-2,2,1,3,2,0,2,1,1,1,1,6,1
KR_6763238937,420,2,14,0,0,-3,0,3,2,4,2,2,5,3,3,3,0,-4,0,4,0,4,6,-2,7,5,-1,0,0,1,-1,-1,-1,4,1
KR_6760801968,420,6,-5,111,9,1,3,2,5,5,0,-1,1,2,2,3,1,2,4,2,2,15,1,2,2,4,3,0,2,1,1,1,1,4,1
KR_6760457722,420,4,62,8,5,5,7,2,0,1,1,-1,5,6,1,5,4,0,0,0,1,8,1,-8,9,1,4,0,0,1,1,0,1,2,1
KR_6755127718,420,-3,-14,-23,-4,-1,1,2,-4,0,4,-1,5,6,3,6,3,-1,1,2,0,-8,-9,-2,6,4,1,0,1,-1,1,1,1,5,1
KR_6702716716,420,-2,-23,8,-2,0,2,2,3,5,2,-5,2,7,0,2,2,0,0,0,0,-3,0,4,4,8,-3,0,0,1,-1,0,1,2,1
KR_6729244078,420,0,-72,-7,0,-2,0,2,0,5,5,-1,3,4,3,3,0,0,1,1,0,10,8,3,0,3,-1,0,-1,-1,0,-1,1,2,1
KR_6670498796,420,-1,12,-16,5,5,6,1,-1,2,3,-1,1,2,0,4,4,2,3,1,0,2,-4,1,3,4,-1,0,1,0,-1,1,1,0,1
KR_6739824575,420,3,33,28,7,-2,1,3,4,4,0,-3,2,5,7,8,1,1,3,2,0,9,3,2,4,6,1,0,1,1,1,1,-1,4,1
KR_6711900768,420,-1,12,-40,-4,3,3,0,2,3,1,-5,4,9,-4,3,7,0,1,1,0,-2,240,-5,5,0,3,0,-1,-1,-1,-1,-1,2,1
KR_6700082974,420,1,-12,-1,2,1,1,0,1,4,3,0,2,2,0,3,3,0,1,1,0,0,3,3,7,10,-5,0,1,1,1,1,-1,6,1
KR_6752536329,440,-1,51,-23,6,2,3,1,1,1,0,3,3,0,0,0,0,0,1,1,0,7,15,3,3,6,1,0,0,-1,1,0,1,2,1
KR_6744033052,420,2,95,18,9,3,3,0,1,2,1,0,0,0,1,2,1,4,4,0,0,8,3,0,5,5,-3,0,0,1,1,0,1,1,1
KR_6648382153,420,3,81,11,8,1,1,0,6,7,1,-2,3,5,2,4,2,1,1,0,0,8,-4,0,5,5,-1,0,1,1,1,1,1,3,1
KR_6720529482,440,-1,95,5,2,1,2,1,3,7,4,1,2,1,-1,1,2,-2,0,2,0,0,24,-1,3,2,5,0,0,0,0,1,1,0,1
KR_6744592210,420,2,42,16,-3,-3,0,3,-2,4,6,-1,0,1,2,4,2,1,2,1,0,1,-7,-3,9,6,-4,0,1,1,-1,1,-1,1,1
KR_6725559778,420,1,30,-9,2,2,3,1,-3,2,5,-2,0,2,4,4,0,1,2,1,1,1,-5,2,2,4,1,0,1,1,0,1,1,4,1
KR_6762722134,420,3,75,-8,12,3,3,0,-2,2,4,6,6,0,4,4,0,1,2,1,0,12,10,2,3,5,-3,0,2,1,0,1,-1,1,1
KR_6700247694,420,-1,-49,-6,-2,0,1,1,1,3,2,-4,0,4,1,4,3,0,0,0,0,0,-17,0,4,4,5,0,0,-1,-1,0,-1,4,1
KR_6680317078,440,3,-66,16,6,1,3,2,4,5,1,0,2,2,0,1,1,1,2,1,1,9,8,2,3,5,0,0,1,-1,1,1,1,1,1
KR_6741743127,440,1,52,25,7,2,3,1,1,3,2,-1,2,3,2,4,2,3,3,0,1,6,33,-4,8,4,4,0,1,1,-1,1,1,2,1
KR_6752496371,420,3,-19,20,3,2,2,0,2,4,2,1,3,2,-2,0,2,0,0,0,0,0,-307,-1,3,2,3,0,0,1,1,1,-1,1,1
KR_6741553966,440,2,12,12,6,2,3,1,2,2,0,0,4,4,-2,1,3,4,5,1,0,12,1,-1,5,4,1,0,1,1,-1,1,-1,1,1
KR_6764106722,420,5,45,41,10,-2,1,3,1,3,2,2,7,5,7,8,1,2,3,1,-1,14,-4,-1,3,2,-1,0,1,1,1,1,-1,6,1
KR_6643183852,420,2,-58,7,0,-3,0,3,2,4,2,2,5,3,-2,0,2,1,2,1,0,0,0,0,3,3,0,0,0,1,-1,0,-1,3,1
KR_6616783614,420,2,68,-19,3,0,1,1,-2,0,2,3,4,1,1,2,1,1,1,0,0,-1,10,1,2,3,-1,0,1,1,1,1,1,4,1
KR_6720867123,420,5,-14,73,16,1,1,0,9,9,0,2,2,0,3,5,2,1,1,0,1,17,-39,-3,5,2,19,0,1,1,1,1,-1,6,1
KR_6729028408,440,7,114,57,17,4,5,1,4,4,0,2,3,1,7,11,4,0,1,1,0,17,5,6,2,8,-1,0,3,1,1,1,1,3,1
KR_6635023756,420,5,48,59,13,4,4,0,2,5,3,4,6,2,2,4,2,1,2,1,0,0,-7,-6,8,2,4,0,-1,1,1,1,1,5,1
KR_6760459902,420,-1,-6,0,2,-2,1,3,1,4,3,0,3,3,5,5,0,-2,0,2,0,7,-5,2,3,5,1,0,2,-1,1,1,1,1,1
KR_6761043603,420,2,-19,6,3,0,1,1,3,3,0,2,3,1,-1,2,3,-1,0,1,0,-2,3,1,3,4,-1,0,1,1,-1,1,-1,5,1
KR_6764493261,420,-1,28,-15,-5,-1,0,1,-2,4,6,1,3,2,-4,2,6,1,1,0,2,-8,142,-2,9,7,0,0,1,-1,-1,1,1,6,1
KR_6752127287,420,0,-26,4,4,1,2,1,0,3,3,1,6,5,2,3,1,0,0,0,0,2,4,4,4,8,-3,0,0,1,-1,0,-1,3,1
KR_6670418441,420,2,28,-23,4,-2,1,3,3,3,0,-2,1,3,4,7,3,1,2,1,0,6,7,-1,5,4,0,0,1,1,-1,1,-1,4,1
KR_6763610210,420,4,29,16,6,2,2,0,6,6,0,5,5,0,-7,3,10,0,1,1,0,8,-6,-2,3,1,4,0,1,-1,1,1,1,2,1
KR_6764226853,420,4,51,16,9,-1,0,1,-1,1,2,4,4,0,6,7,1,1,1,0,0,8,-2,0,4,4,0,0,0,1,-1,0,1,5,1
KR_6731579569,420,4,24,8,6,-3,1,4,1,1,0,-1,2,3,9,10,1,0,0,0,0,13,12,2,3,5,-1,0,4,1,1,1,-1,6,1
KR_6742284406,420,6,78,52,20,1,4,3,2,3,1,8,8,0,8,9,1,1,1,0,1,14,1,-2,4,2,2,0,1,1,1,1,1,5,1
KR_6676996157,420,3,77,13,9,0,1,1,3,4,1,0,2,2,4,4,0,2,3,1,0,13,6,4,2,6,2,0,0,1,-1,0,1,4,1
KR_6760821476,440,-2,-79,8,-6,-1,0,1,0,0,0,1,2,1,-5,1,6,-1,0,1,0,-4,2,-2,6,4,-2,0,0,0,1,0,-1,0,1
KR_6466727611,420,2,47,8,12,3,3,0,0,2,2,2,2,0,3,4,1,4,6,2,1,12,0,-1,6,5,3,0,1,1,1,1,1,1,1
KR_6760341092,420,4,27,10,12,2,3,1,4,5,1,1,1,0,6,9,3,-1,3,4,0,7,7,4,1,5,1,0,0,1,1,1,1,2,1
KR_6594185416,420,0,40,1,4,0,2,2,0,0,0,4,7,3,-1,2,3,1,1,0,0,8,1,7,2,9,0,0,-1,1,0,1,-1,5,1
KR_6010175656,420,1,6,-13,3,3,3,0,0,2,2,1,3,2,-2,2,4,1,2,1,1,1,33,3,10,13,-10,0,1,1,1,1,1,1,1
KR_6749154332,420,3,30,11,0,1,1,0,0,2,2,-2,1,3,-1,3,4,2,2,0,0,-8,10,0,4,4,-1,0,0,1,-1,-1,-1,2,1
KR_6641189581,420,0,-15,0,7,-4,0,4,0,0,0,3,4,1,7,8,1,1,2,1,0,10,-24,0,7,7,0,0,-1,1,-1,-1,1,5,1
KR_6763008612,420,0,-26,3,4,-1,1,2,3,6,3,2,3,1,0,1,1,0,0,0,0,8,-2,0,5,5,6,0,0,-1,1,0,-1,4,1
KR_6681932411,420,2,-2,8,6,0,1,1,6,6,0,2,4,2,-5,3,8,3,6,3,-1,11,37,1,4,5,-27,0,1,-1,1,1,-1,1,1
KR_6625109869,420,7,80,8,17,5,5,0,1,3,2,3,5,2,6,6,0,2,3,1,0,15,-25,-1,5,4,1,0,1,1,1,1,1,1,1
KR_6763567942,420,1,4,1,0,-1,2,3,2,2,0,-2,3,5,0,4,4,1,3,2,0,12,4,4,3,7,2,0,0,-1,1,0,1,3,1
KR_6692170898,420,3,-15,13,1,3,4,1,4,4,0,0,3,3,-3,2,5,-3,0,3,0,0,-2,-3,6,3,0,0,0,0,1,1,1,0,1
KR_6679386600,420,-4,-40,3,-2,0,1,1,-4,1,5,3,4,1,1,3,2,-2,0,2,0,-2,3,2,3,5,-5,0,-1,0,0,-1,1,0,1
KR_6750030098,420,1,2,0,-2,-6,1,7,-1,0,1,0,4,4,4,6,2,1,1,0,0,6,19,-2,5,3,0,0,-1,-1,-1,-1,-1,2,1
KR_6741032926,420,4,38,35,8,4,4,0,0,2,2,9,9,0,-3,2,5,-2,1,3,0,0,-15,-1,4,3,3,0,2,1,-1,1,1,2,1
KR_6756971415,420,-1,-28,-8,-10,-2,1,3,-3,1,4,-2,1,3,-4,0,4,1,1,0,0,-12,152,0,4,4,-2,0,0,-1,-1,-1,-1,1,1
KR_6764495663,440,5,40,23,7,0,5,5,1,2,1,2,4,2,2,2,0,2,2,0,0,6,9,-2,8,6,3,0,0,-1,1,1,-1,6,1
KR_6741750248,420,2,60,3,4,2,3,1,1,2,1,4,4,0,-2,1,3,-1,0,1,0,2,11,2,4,6,0,0,-2,-1,1,1,1,1,1
KR_6458235494,420,-2,-22,-28,-4,-4,0,4,-4,2,6,1,2,1,-1,0,1,4,4,0,0,2,-4,5,3,8,3,0,0,1,1,0,1,6,1
KR_6762573794,420,-1,68,13,1,1,4,3,-1,1,2,-1,2,3,5,10,5,-3,0,3,2,2,2,1,4,5,0,0,0,1,1,1,-1,3,1
KR_6754044030,420,0,43,6,1,2,3,1,-1,1,2,2,5,3,2,3,1,-4,0,4,0,5,-12,-3,4,1,3,0,1,-1,-1,1,1,5,1
KR_6624773638,420,4,98,24,5,1,1,0,0,2,2,4,4,0,-1,0,1,1,1,0,0,2,-10,0,3,3,2,0,1,-1,1,1,1,4,1
KR_6759493898,420,0,-13,-4,1,1,2,1,3,4,1,-2,1,3,1,1,0,-2,0,2,0,-1,-102,2,5,7,0,0,-1,1,-1,-1,-1,6,1
KR_6653913630,420,2,16,-3,5,5,7,2,-3,5,8,0,2,2,4,7,3,-1,2,3,0,4,265,-8,9,1,7,0,1,1,1,1,1,3,1
KR_6697124609,420,2,56,-8,7,0,1,1,-1,1,2,3,5,2,2,4,2,3,3,0,0,8,4,3,3,6,-5,0,2,1,0,1,1,2,1
KR_6761685283,420,2,-23,18,1,3,4,1,-4,2,6,2,2,0,0,3,3,0,1,1,-2,5,-34,-2,6,4,28,0,1,1,-1,1,-1,6,1
KR_6750097705,420,-2,-10,-23,0,3,5,2,-1,4,5,-3,1,4,0,4,4,1,2,1,0,8,-2,-2,4,2,4,0,0,1,-1,0,-1,5,1
KR_6601561367,420,3,-50,11,3,-1,1,2,-4,2,6,9,9,0,-3,3,6,2,2,0,0,6,1,-2,4,2,-3,0,0,1,-1,-1,1,2,1
KR_6763597855,440,1,31,-16,-1,-2,0,2,0,2,2,1,2,1,4,4,0,-4,0,4,0,-3,63,0,3,3,6,0,1,1,1,1,-1,3,1
KR_6759598682,440,-3,15,3,-5,-3,1,4,0,3,3,1,4,3,-3,1,4,0,0,0,0,-8,1,4,1,5,-2,0,-2,1,-1,-1,1,6,1
KR_6728301696,420,0,29,9,-4,-2,1,3,-3,1,4,-1,3,4,-1,4,5,3,3,0,0,-2,2,1,6,7,-3,0,-1,1,-1,-1,-1,3,1
KR_6742925706,420,3,7,4,7,1,2,1,4,7,3,3,4,1,0,2,2,-1,0,1,0,3,6,2,5,7,1,0,0,0,0,0,-1,0,1
KR_6764067024,420,3,18,16,4,0,3,3,-1,1,2,-2,2,4,4,7,3,3,3,0,0,-1,-4,-4,9,5,0,0,0,1,-1,1,1,4,1
KR_6742952362,420,0,18,-22,9,-2,3,5,4,4,0,4,5,1,4,4,0,-1,0,1,0,9,2,0,4,4,5,0,-1,1,-1,-1,1,5,1
KR_6753208830,420,5,28,0,8,2,3,1,1,2,1,-4,0,4,8,8,0,1,3,2,0,15,17,1,5,6,5,0,1,-1,-1,1,1,4,1
KR_6738044521,420,2,53,14,11,9,9,0,1,4,3,3,5,2,0,3,3,-2,0,2,-1,5,35,3,5,8,2,0,0,0,1,1,-1,0,1
KR_6593929184,420,1,87,-13,4,-4,0,4,3,3,0,1,1,0,4,7,3,0,2,2,1,6,-7,1,4,5,4,0,-1,1,-1,1,1,6,1
KR_6751118254,440,5,76,-19,7,3,4,1,0,4,4,2,3,1,5,7,2,-3,5,8,0,-1,-1,-2,4,2,2,0,3,0,0,1,1,0,1
KR_6748108130,420,4,63,3,4,1,5,4,0,2,2,3,3,0,2,3,1,-2,1,3,2,7,5,2,6,8,1,0,2,-1,1,1,1,6,1
KR_6763588635,420,0,-14,8,-1,0,1,1,2,2,0,-1,2,3,-1,1,2,-1,0,1,0,1,7,-2,3,1,0,0,0,-1,1,0,-1,1,1
KR_6741660610,420,-3,-97,0,-1,-1,2,3,2,4,2,-3,2,5,1,1,0,0,0,0,0,6,15,-1,6,5,-1,0,-1,-1,1,-1,1,4,1
KR_6731730876,420,3,60,24,1,-3,1,4,3,4,1,3,4,1,-2,2,4,0,1,1,-1,-4,-23,-1,3,2,1,0,1,1,1,1,-1,1,1
KR_6549284451,420,0,19,4,-3,3,4,1,1,3,2,2,3,1,-7,2,9,-2,2,4,2,-4,-16,4,3,7,-5,0,-3,1,1,-1,1,3,1
KR_6763598181,420,2,34,29,10,-1,1,2,4,5,1,2,2,0,5,5,0,0,1,1,1,14,-1,5,2,7,1,0,1,1,1,1,1,1,1
KR_6714992319,420,3,-29,44,7,-1,2,3,2,4,2,6,7,1,-1,3,4,1,1,0,1,3,8,3,4,7,-4,0,1,1,1,1,1,3,1
KR_6703816151,420,1,-12,-13,7,-1,0,1,1,3,2,-1,0,1,6,9,3,2,5,3,1,15,0,0,6,6,0,0,0,1,-1,-1,1,5,1
KR_6586778783,420,-2,65,-15,6,0,2,2,-1,1,2,1,2,1,1,2,1,5,7,2,0,6,-30,3,1,4,4,0,2,1,1,1,1,4,1
KR_6749985500,420,3,31,21,9,3,5,2,4,5,1,3,6,3,-1,1,2,0,1,1,0,9,18,2,1,3,-4,0,1,1,0,1,1,4,1
KR_6756131136,420,1,-16,-9,1,2,2,0,3,3,0,-1,3,4,0,0,0,-3,0,3,0,1,12,1,4,5,-3,0,0,-1,-1,0,1,5,1
KR_6740929587,420,-3,-18,10,0,-1,1,2,-1,2,3,5,6,1,-2,3,5,-1,0,1,0,3,-4,2,3,5,-2,0,1,1,1,1,1,2,1
KR_6763513425,420,5,45,21,-1,0,1,1,1,3,2,-1,2,3,-4,2,6,3,4,1,-1,-9,-1,-2,7,5,4,0,1,0,0,1,-1,0,1
KR_6710774303,420,1,115,-7,4,0,2,2,-1,1,2,3,4,1,0,0,0,2,2,0,0,7,-8,3,3,6,1,0,1,-1,-1,1,1,4,1
KR_6744383455,420,8,101,28,15,0,0,0,2,3,1,10,10,0,2,3,1,1,2,1,0,14,354,-4,6,2,-23,0,2,1,1,1,1,4,1
KR_6762368992,420,-1,55,22,-7,-6,2,8,1,1,0,3,3,0,-3,4,7,-2,0,2,0,-4,1,-1,6,5,-1,0,0,-1,-1,-1,1,6,1
KR_6688085877,420,5,19,16,8,-2,1,3,3,5,2,0,1,1,0,1,1,7,7,0,0,14,4,1,6,7,7,0,0,1,-1,0,-1,6,1
KR_6647466360,420,1,-101,22,3,1,2,1,3,6,3,0,2,2,-4,4,8,3,4,1,-1,1,4,-2,7,5,-4,0,-1,1,1,-1,-1,3,1
KR_6762791673,420,2,37,21,5,-5,1,6,4,4,0,0,2,2,6,6,0,0,0,0,0,13,29,2,2,4,0,0,2,1,1,1,1,2,1
KR_6626247838,420,5,112,8,8,2,3,1,2,3,1,6,6,0,-1,1,2,-1,1,2,0,4,10,1,2,3,1,0,1,1,-1,1,-1,2,1
KR_6759579859,420,-3,14,-28,-5,-2,0,2,1,3,2,-3,0,3,-2,4,6,1,2,1,0,-9,-10,-3,6,3,3,0,0,-1,1,0,1,2,1
KR_6698918508,420,2,-19,-21,8,2,2,0,2,2,0,-2,2,4,5,6,1,1,1,0,0,15,121,2,3,5,-2,0,2,0,1,1,1,0,1
KR_6660067573,420,4,40,17,5,3,5,2,2,2,0,-1,3,4,0,0,0,1,1,0,0,3,-8,-2,5,3,3,0,1,1,1,1,-1,4,1
KR_6735146709,440,3,25,-4,14,-3,0,3,5,6,1,1,5,4,10,12,2,1,4,3,0,15,152,-2,3,1,2,0,1,0,1,1,-1,0,1
KR_6751475909,440,0,-22,-1,2,0,3,3,1,2,1,-1,1,2,3,3,0,-1,0,1,0,7,38,-3,7,4,-18,0,0,-1,0,0,1,4,1
KR_6740694769,420,-2,58,-1,-5,2,2,0,-2,2,4,0,3,3,-5,1,6,0,0,0,0,-4,390,0,3,3,2,0,0,1,-1,0,-1,4,1
KR_6705861037,420,2,54,-20,1,5,7,2,-2,5,7,-1,1,2,-2,1,3,1,1,0,0,-2,323,0,3,3,1,0,2,-1,1,1,1,6,1
KR_6760347953,420,0,15,-20,6,2,2,0,-2,1,3,-2,1,3,8,10,2,0,1,1,1,11,-14,1,5,6,1,0,-1,1,-1,-1,1,6,1
KR_6754028132,440,5,-17,18,8,2,2,0,5,6,1,-2,0,2,4,4,0,-1,0,1,0,9,-44,-4,8,4,20,0,0,1,1,0,1,2,1
KR_6707451948,440,-3,-16,-20,-1,2,2,0,0,1,1,-2,2,4,0,1,1,-1,0,1,0,2,-12,0,4,4,4,0,0,-1,-1,0,1,4,1
KR_6736542882,440,-3,9,-20,-6,-3,2,5,-4,2,6,0,1,1,-1,2,3,2,2,0,0,-4,6,-2,4,2,3,0,0,1,-1,0,-1,2,1
KR_6740255661,440,1,15,12,5,2,4,2,3,4,1,0,3,3,0,2,2,0,1,1,0,4,-34,1,5,6,31,0,1,1,-1,1,1,1,1
KR_6708422245,420,0,82,-4,1,-3,0,3,3,5,2,0,1,1,1,3,2,0,0,0,0,6,0,-1,5,4,-2,0,0,-1,-1,0,1,1,1
KR_6764707970,420,-1,18,4,-1,-1,2,3,-1,2,3,-3,0,3,7,8,1,-3,0,3,0,2,7,3,6,9,-4,0,0,1,1,1,1,6,1
KR_6726947349,440,1,-57,4,2,-2,0,2,0,0,0,-2,2,4,1,3,2,5,6,1,0,10,-17,-5,9,4,2,0,-1,1,-1,-1,-1,4,1
KR_6698551985,420,1,78,15,5,1,4,3,-1,2,3,1,1,0,3,4,1,1,1,0,1,6,4,2,3,5,-2,0,0,0,1,0,1,0,1
KR_6716196046,420,3,-53,37,5,2,2,0,3,3,0,-1,1,2,0,2,2,1,2,1,0,7,-7,-4,7,3,0,0,-1,1,-1,-1,-1,2,1
KR_6763752607,420,3,162,1,9,2,2,0,0,2,2,4,4,0,-2,2,4,5,6,1,0,3,-3,7,2,9,0,0,2,1,-1,1,1,4,1
KR_6750487710,420,0,-13,-12,2,-2,0,2,2,3,1,1,3,2,2,5,3,-1,2,3,0,5,7,-4,7,3,1,0,-1,1,-1,-1,-1,5,1
KR_6643126462,420,-2,-47,8,-4,-4,0,4,2,3,1,-1,0,1,-1,3,4,0,0,0,-1,-4,-13,0,4,4,2,0,-1,-1,-1,-1,-1,5,1
KR_6658779630,420,2,-6,-1,7,0,1,1,1,3,2,2,5,3,9,12,3,-5,0,5,0,4,48,2,5,7,-3,0,2,1,-1,1,1,6,1
KR_6731383694,420,-4,12,-5,-7,2,3,1,-3,3,6,0,3,3,-3,1,4,-3,0,3,0,-10,-1,3,2,5,-1,0,-1,0,-1,-1,-1,0,1
KR_6756445268,420,-2,-57,-24,-3,-1,2,3,-1,1,2,3,3,0,-4,4,8,0,4,4,0,-4,-4,-4,7,3,0,0,-1,-1,1,-1,-1,5,1
KR_6688488334,420,3,48,-24,8,3,3,0,-2,1,3,2,2,0,5,5,0,0,1,1,0,6,-6,0,7,7,8,0,1,-1,1,1,1,6,1
KR_6761559799,440,1,24,28,4,-1,2,3,4,4,0,-1,1,2,2,5,3,0,1,1,1,11,2,0,4,4,-1,0,0,1,0,-1,1,5,1
KR_6761007358,420,3,49,20,6,1,4,3,4,5,1,-2,1,3,3,3,0,0,1,1,0,11,-109,0,4,4,2,0,1,0,0,1,-1,0,1
KR_6730031971,420,1,49,-23,1,0,0,0,4,6,2,-1,3,4,-1,2,3,-1,0,1,0,2,-4,2,6,8,2,0,-1,1,-1,-1,-1,2,1
KR_6708899399,420,1,17,10,4,-2,1,3,1,6,5,1,2,1,3,4,1,1,1,0,-1,2,-2,5,4,9,0,0,1,-1,1,1,-1,1,1
KR_6628479467,420,-1,-48,16,5,-1,0,1,-1,0,1,2,4,2,1,1,0,4,4,0,0,7,-6,-1,5,4,-4,0,0,1,1,0,1,3,1
KR_6752963833,420,2,-28,21,3,3,4,1,-1,2,3,1,3,2,-3,1,4,3,3,0,-1,-5,7,-5,9,4,0,0,0,1,0,0,-1,5,1
KR_6732404504,440,4,-28,24,1,4,4,0,1,2,1,0,1,1,-3,0,3,-1,1,2,0,2,13,-2,5,3,1,0,1,0,1,1,-1,0,1
KR_6729157637,420,1,8,1,0,0,3,3,-3,0,3,-1,0,1,0,1,1,4,4,0,-1,-3,4,1,2,3,-3,0,0,-1,1,0,-1,6,1
KR_6644212322,420,1,-10,44,1,-4,1,5,7,10,3,2,2,0,-4,0,4,0,0,0,0,-4,-1,1,6,7,0,0,2,-1,1,-1,-1,3,1
KR_6762998465,420,3,-2,28,4,-3,2,5,4,4,0,-3,1,4,5,6,1,1,2,1,-1,0,-10,-1,3,2,-3,0,0,1,0,0,-1,4,1
KR_6714590217,420,2,19,12,6,0,3,3,3,3,0,1,2,1,2,3,1,0,0,0,0,9,-4,1,5,6,-2,0,1,-1,1,1,1,1,1
KR_6716183843,440,1,4,4,1,4,4,0,-3,2,5,1,1,0,4,8,4,-5,1,6,0,5,11,-4,6,2,2,0,0,-1,0,0,-1,2,1
KR_6736043381,420,0,-14,33,2,-1,2,3,3,5,2,-2,2,4,0,1,1,2,2,0,0,4,1,3,2,5,-1,0,2,1,1,1,1,2,1
KR_6001085816,420,2,5,24,2,2,3,1,-2,0,2,3,3,0,-3,1,4,2,3,1,0,-4,-3,-5,8,3,0,0,0,1,-1,0,1,4,1
KR_6660232578,420,1,-13,-14,-1,2,3,1,-1,3,4,-2,1,3,0,0,0,0,0,0,0,-4,-7,-3,6,3,-4,0,-1,-1,-1,-1,-1,1,1
KR_6759783003,420,5,-2,-7,9,1,1,0,4,6,2,3,5,2,3,4,1,-2,0,2,0,13,-358,0,3,3,0,0,0,1,-1,0,1,2,1
KR_6722428400,420,-3,-22,7,-7,-5,0,5,-1,1,2,3,4,1,-2,0,2,-2,0,2,0,-5,4,-1,6,5,0,0,0,1,-1,1,-1,2,1
KR_6733871163,440,1,16,-20,2,0,1,1,2,4,2,1,2,1,-3,1,4,2,3,1,1,4,363,4,0,4,-1,0,0,-1,0,1,1,3,1
KR_6624763175,420,3,-48,0,4,-4,1,5,2,5,3,0,2,2,7,8,1,-1,0,1,-1,7,-7,2,6,8,-2,0,-2,1,-1,-1,-1,4,1
KR_6762572445,440,2,-7,13,6,6,7,1,-4,1,5,2,3,1,3,4,1,-1,0,1,0,2,6,5,4,9,-4,0,1,1,1,1,1,6,1
KR_6740499412,420,-1,-21,20,-3,-1,3,4,-2,0,2,2,4,2,-2,1,3,0,3,3,0,-6,37,2,3,5,2,0,1,-1,1,1,-1,5,1
KR_6633121364,420,-1,-41,-44,-4,0,1,1,3,5,2,0,2,2,-6,1,7,-1,0,1,0,-4,-28,-1,4,3,-1,0,0,-1,1,0,-1,2,1
KR_6757667951,420,-5,31,-96,-11,-5,0,5,-6,1,7,-1,3,4,3,4,1,-2,0,2,-1,-10,218,-7,9,2,0,0,-1,-1,-1,-1,-1,1,1
KR_6619089119,420,-1,6,4,1,-5,1,6,0,1,1,7,10,3,1,3,2,-2,0,2,-1,12,13,-3,6,3,4,0,-1,-1,-1,-1,-1,5,1
KR_6714323034,420,1,-16,-21,0,1,3,2,0,2,2,-2,0,2,1,2,1,0,0,0,0,3,19,0,5,5,0,0,1,-1,1,1,-1,2,1
KR_6665785464,420,5,94,25,7,1,5,4,0,2,2,6,6,0,1,2,1,-1,0,1,1,10,17,-2,3,1,0,0,2,1,-1,-1,1,3,1
KR_6759739139,440,5,21,65,10,3,4,1,4,8,4,6,6,0,1,4,3,-4,1,5,2,10,3,1,1,2,2,0,2,1,1,1,1,2,1
KR_6691867448,420,4,53,44,9,-3,2,5,5,5,0,2,6,4,5,5,0,0,3,3,1,11,4,1,3,4,4,0,2,1,1,1,1,2,1
KR_6718928632,420,12,93,95,15,2,5,3,5,5,0,3,3,0,0,4,4,5,7,2,1,10,10,2,3,5,3,0,4,1,1,1,1,3,1
KR_6668944287,420,1,71,-8,-2,-1,0,1,-1,2,3,0,1,1,1,3,2,-1,0,1,0,-4,-5,0,4,4,2,0,0,-1,0,0,-1,3,1
KR_6729573307,420,-1,-109,-20,-1,0,1,1,-5,1,6,4,6,2,1,1,0,-1,0,1,0,-2,-6,-4,5,1,5,0,-1,-1,0,-1,-1,2,1
KR_6598075312,420,1,7,10,1,1,2,1,2,8,6,-3,1,4,3,5,2,-2,0,2,0,1,281,2,5,7,2,0,0,1,-1,0,-1,5,1
KR_6658732125,420,7,90,19,13,3,3,0,7,7,0,0,1,1,3,4,1,0,0,0,0,9,27,1,5,6,5,0,2,1,1,1,1,1,1
KR_6735245250,420,-1,42,-12,4,2,4,2,-2,2,4,2,5,3,1,4,3,1,2,1,0,-9,-11,-3,8,5,6,0,2,0,-1,1,-1,0,1
KR_6763234782,420,1,63,-8,3,3,4,1,-1,1,2,5,6,1,-4,1,5,0,0,0,0,-6,25,1,4,5,-11,0,0,-1,0,0,-1,4,1
KR_6760213798,420,2,40,-7,0,-2,0,2,6,6,0,-2,1,3,0,4,4,-2,1,3,0,3,-10,-1,4,3,7,0,0,1,-1,0,-1,4,1
KR_6728245908,420,10,76,92,21,3,3,0,1,1,0,4,4,0,15,15,0,-2,0,2,0,18,1,1,2,3,1,0,1,1,1,1,1,4,1
KR_6755810252,420,2,10,-4,-1,1,3,2,5,8,3,-1,2,3,-1,3,4,-5,1,6,-1,4,-5,-5,6,1,5,0,-1,0,1,-1,-1,0,1
KR_6731351601,420,4,-51,13,14,1,2,1,10,11,1,0,3,3,3,6,3,0,1,1,0,23,0,2,5,7,2,0,2,1,1,1,-1,2,1
KR_6646353352,420,0,-57,-13,3,1,2,1,-5,1,6,0,2,2,6,7,1,1,1,0,0,0,-5,-2,4,2,3,0,-1,0,-1,-1,-1,0,1
KR_6762067960,420,-3,-7,-16,-1,-1,1,2,-3,3,6,-3,0,3,3,7,4,3,4,1,0,-4,-4,-2,6,4,2,0,0,-1,1,0,1,3,1
KR_6662878012,420,-3,-7,-23,0,1,4,3,1,4,3,1,3,2,-1,2,3,-2,2,4,0,-2,-9,8,2,10,4,0,-1,1,1,-1,-1,4,1
KR_6714608742,420,-1,14,0,3,-4,3,7,-3,1,4,3,4,1,4,5,1,3,4,1,0,-5,-6,-6,8,2,9,0,1,0,-1,1,1,0,1
KR_6749090898,420,0,28,-16,3,-1,1,2,-4,3,7,4,5,1,4,8,4,0,0,0,0,-3,-114,5,3,8,1,0,-1,1,-1,-1,-1,5,1
KR_6736544434,420,4,100,8,11,1,3,2,5,6,1,-1,3,4,3,3,0,3,4,1,0,5,5,1,3,4,2,0,1,1,1,1,1,4,1
KR_6739255164,420,2,50,-2,4,2,3,1,4,7,3,2,4,2,-5,0,5,1,3,2,1,-7,-27,1,4,5,-3,0,3,-1,-1,1,1,5,1
KR_6685004176,440,2,55,12,-1,-2,1,3,-4,2,6,-3,3,6,5,5,0,3,3,0,0,-5,-23,-2,3,1,1,0,0,-1,1,1,1,1,1
KR_6764561075,420,0,-43,-12,7,1,1,0,3,3,0,4,6,2,0,2,2,-1,1,2,0,16,-3,1,4,5,4,0,-1,1,-1,-1,1,3,1
KR_6718637004,420,-1,14,-4,6,1,2,1,0,7,7,1,3,2,3,6,3,1,2,1,0,13,-1,-2,6,4,3,0,1,1,1,1,1,6,1
KR_6643359310,420,2,-33,-20,7,4,4,0,4,5,1,0,2,2,-1,0,1,0,1,1,0,5,4,-2,8,6,-2,0,0,-1,-1,0,-1,1,1
KR_6693300625,440,2,114,-5,12,3,3,0,0,2,2,3,4,1,6,6,0,0,1,1,-1,3,10,3,2,5,-1,0,1,-1,-1,1,-1,4,1
KR_6763193161,420,0,62,8,2,4,5,1,-2,0,2,1,2,1,-1,1,2,0,2,2,0,-4,-108,2,3,5,0,0,1,0,-1,1,1,0,1
KR_6667210216,420,0,-14,15,3,-1,1,2,2,2,0,0,1,1,-2,1,3,4,4,0,0,8,38,4,4,8,-2,0,0,1,1,1,-1,1,1
KR_6637056151,420,3,22,16,3,4,4,0,-1,5,6,6,7,1,-6,1,7,0,0,0,-1,-7,13,5,5,10,-1,0,0,-1,-1,0,-1,2,1
KR_6764481979,440,2,-17,24,1,-3,0,3,3,7,4,-2,2,4,3,4,1,0,3,3,0,-7,-1,1,3,4,-1,0,0,0,1,-1,-1,0,1
KR_6763427185,420,3,10,-8,12,-1,0,1,6,6,0,5,7,2,1,1,0,1,2,1,0,14,-7,2,3,5,-4,0,0,1,1,0,1,5,1
KR_6640110419,420,0,66,20,2,2,3,1,4,7,3,-2,1,3,-2,2,4,0,3,3,1,1,1,-7,8,1,-2,0,1,-1,1,1,1,2,1
KR_6763909785,420,5,119,20,-2,-1,0,1,0,4,4,-5,1,6,4,4,0,0,0,0,0,1,14,5,1,6,2,0,1,-1,-1,1,1,2,1
KR_6763446623,440,1,-11,14,5,-2,0,2,-4,0,4,4,4,0,5,5,0,2,3,1,0,5,29,1,3,4,2,0,1,-1,0,1,1,2,1
KR_6698760694,420,2,63,8,3,4,5,1,1,3,2,2,2,0,-2,3,5,-2,1,3,0,3,29,0,5,5,-18,0,0,-1,-1,1,-1,4,1
KR_6762427556,420,2,6,9,13,5,5,0,3,5,2,-2,0,2,8,11,3,-1,0,1,0,11,-4,0,2,2,-2,0,-1,-1,1,1,-1,3,1
KR_6651995371,420,4,79,8,5,0,1,1,0,2,2,0,2,2,5,5,0,0,0,0,0,-1,-6,-5,6,1,1,0,0,1,-1,0,-1,1,1
KR_6738844996,420,-1,-35,8,-2,-2,0,2,4,4,0,-2,1,3,-1,0,1,-1,2,3,0,-3,-11,5,5,10,-2,0,0,-1,1,0,1,1,1
KR_6747851766,420,5,71,28,8,5,6,1,-1,2,3,2,4,2,1,3,2,1,2,1,0,3,-4,2,4,6,4,0,0,1,1,1,1,4,1
KR_6649358412,420,3,38,10,3,-1,1,2,-5,3,8,4,4,0,5,5,0,0,1,1,0,-4,0,-3,6,3,0,0,0,-1,-1,-1,-1,6,1
KR_6646470205,420,3,48,-19,11,1,1,0,-1,3,4,1,1,0,7,7,0,3,3,0,0,10,-6,-2,6,4,5,0,1,1,-1,1,-1,2,1
KR_6759625529,420,-1,0,-47,0,-6,0,6,1,1,0,0,1,1,1,5,4,4,4,0,3,14,14,-3,7,4,-1,0,1,1,0,1,1,5,1
KR_6719027232,420,4,55,8,0,3,5,2,2,4,2,2,4,2,-4,2,6,-3,0,3,0,-9,22,4,3,7,-2,0,-1,-1,1,-1,-1,6,1
KR_6764573539,420,0,-5,43,4,-2,0,2,4,4,0,2,7,5,1,2,1,-1,0,1,0,-1,10,-1,5,4,0,0,0,1,-1,-1,-1,3,1
KR_6751913058,440,6,20,60,9,-1,1,2,9,9,0,-1,2,3,-3,7,10,5,5,0,0,5,-34,-3,4,1,27,0,2,1,1,1,-1,3,1
KR_6576881525,420,0,64,2,2,-1,1,2,-3,1,4,4,4,0,4,6,2,-2,0,2,0,-3,-10,1,5,6,1,0,-1,-1,-1,-1,-1,2,1
KR_6746697096,440,1,58,20,7,3,3,0,0,3,3,3,4,1,2,6,4,-1,4,5,1,13,4,2,3,5,-1,0,1,0,1,1,-1,0,1
KR_6672603490,420,2,113,-12,-3,3,3,0,-1,3,4,-1,0,1,-2,4,6,-2,1,3,-1,-7,-15,1,2,3,7,0,1,1,-1,1,-1,2,1
KR_6649327716,420,8,25,46,16,3,4,1,4,4,0,9,9,0,-1,1,2,1,4,3,1,14,30,2,4,6,3,0,2,1,1,1,1,2,1
KR_6738767460,420,-1,-32,8,-3,-1,1,2,-1,2,3,3,6,3,-2,2,4,-2,2,4,1,-6,-20,-3,6,3,-5,0,1,1,1,1,1,6,1
KR_6729836804,420,5,79,16,12,0,2,2,4,5,1,5,6,1,4,4,0,-1,0,1,0,7,21,-4,7,3,5,0,2,1,1,1,-1,6,1
KR_6698527752,420,1,-7,16,5,1,3,2,5,7,2,1,1,0,-4,1,5,2,2,0,0,8,25,-8,11,3,2,0,0,1,-1,0,1,1,1
KR_6699097879,440,1,-11,19,-5,0,2,2,0,2,2,-9,0,9,1,2,1,3,3,0,0,-7,17,0,4,4,-2,0,0,1,1,0,-1,5,1
KR_6752448199,420,0,-43,32,11,0,2,2,-1,2,3,3,4,1,6,6,0,3,4,1,1,19,6,2,3,5,2,0,1,1,1,1,1,5,1
KR_6705789760,420,4,89,6,2,3,4,1,3,4,1,-4,0,4,1,1,0,-1,1,2,0,4,10,-5,9,4,2,0,1,1,-1,1,-1,4,1
KR_6763756960,420,3,104,31,-1,2,3,1,2,4,2,0,1,1,-2,0,2,-3,0,3,0,-4,-38,0,4,4,21,0,0,1,0,0,-1,6,1
KR_6755765635,420,1,-3,4,-1,2,6,4,2,5,3,3,5,2,0,1,1,-8,0,8,-1,-6,10,0,5,5,6,0,0,1,-1,1,-1,1,1
KR_6757887322,420,4,4,12,8,-1,4,5,0,1,1,0,3,3,6,6,0,3,3,0,0,23,-12,1,4,5,1,0,1,1,1,1,-1,4,1
KR_6714390737,420,-1,-56,-4,0,0,2,2,5,7,2,-6,0,6,-1,2,3,2,2,0,1,-4,55,-2,5,3,9,0,-3,1,-1,-1,1,4,1
KR_6751361530,440,0,70,14,-1,-3,1,4,2,6,4,2,4,2,-1,2,3,-1,2,3,0,-6,9,5,2,7,3,0,0,1,-1,-1,1,2,1
KR_6753831946,420,-3,-56,-8,-3,-7,0,7,-1,0,1,1,2,1,2,3,1,2,2,0,0,2,192,1,3,4,-4,0,-1,1,-1,-1,-1,6,1
KR_6757090356,440,5,4,48,15,2,2,0,5,5,0,0,1,1,6,7,1,2,2,0,0,16,9,6,2,8,0,0,0,0,1,1,1,0,1
KR_6743212385,440,1,29,20,6,2,3,1,2,3,1,2,4,2,0,0,0,0,4,4,-1,7,-4,1,2,3,3,0,0,1,-1,0,-1,1,1
KR_6741056454,420,-1,-26,21,2,-3,0,3,3,3,0,-3,0,3,5,7,2,0,1,1,-1,3,2,1,2,3,2,0,-1,1,-1,-1,-1,3,1
KR_6763377233,420,7,60,-3,15,-1,4,5,1,2,1,1,3,2,13,14,1,1,1,0,0,20,2,3,2,5,2,0,2,1,1,1,1,5,1
KR_6735741572,420,2,-4,15,0,-1,1,2,2,3,1,5,5,0,-6,0,6,0,0,0,0,-1,15,-2,8,6,2,0,0,-1,1,0,-1,6,1
KR_6735520432,420,2,20,40,7,2,2,0,1,3,2,2,4,2,2,4,2,0,4,4,0,5,-1,-5,6,1,0,0,1,1,1,1,1,3,1
KR_6751655012,420,2,81,6,5,-2,0,2,-1,1,2,6,9,3,1,2,1,1,1,0,1,1,3,0,2,2,3,0,3,1,-1,1,1,5,1
KR_6679629691,420,-3,17,-28,0,1,1,0,-3,0,3,-4,2,6,2,3,1,4,5,1,1,-1,-43,3,4,7,20,0,-1,-1,-1,-1,1,1,1
KR_6753654773,420,3,77,12,14,4,5,1,2,2,0,7,8,1,2,4,2,-1,0,1,0,6,-25,6,2,8,4,0,2,1,1,1,1,1,1
KR_6758946518,420,0,-2,4,-11,-1,2,3,1,4,3,-4,2,6,-4,1,5,-3,0,3,0,-10,8,5,1,6,-3,0,0,-1,1,0,-1,5,1
KR_6671151458,420,3,-24,18,12,3,5,2,4,7,3,2,5,3,1,2,1,2,2,0,0,10,7,0,3,3,0,0,-1,1,0,1,1,6,1
KR_6756659959,440,-2,-11,27,-8,-5,0,5,-6,1,7,0,2,2,0,3,3,3,3,0,0,-7,-11,0,9,9,16,0,-1,1,-1,-1,-1,5,1
KR_6701798512,420,2,12,20,9,1,2,1,-2,2,4,0,4,4,8,8,0,2,2,0,1,2,-13,0,5,5,-2,0,0,1,0,1,1,6,1
KR_6703106865,420,2,13,39,4,-7,0,7,-1,1,2,1,2,1,6,6,0,5,6,1,-1,10,12,-1,4,3,1,0,1,1,1,-1,-1,4,1
KR_6654613270,420,2,-18,6,0,1,1,0,0,2,2,-1,1,2,0,2,2,0,1,1,0,-3,51,-3,8,5,4,0,1,-1,-1,1,1,1,1
KR_6197058818,420,-2,52,-10,-3,-3,2,5,0,1,1,-2,0,2,2,4,2,0,1,1,0,-8,-20,-3,9,6,6,0,0,-1,1,0,-1,3,1
KR_6672731868,420,7,52,31,11,0,3,3,5,5,0,3,4,1,4,5,1,-1,0,1,0,12,4,2,3,5,2,0,1,1,1,1,1,6,1
KR_6744602946,420,2,7,-3,5,1,2,1,5,7,2,-3,4,7,3,6,3,-1,1,2,0,9,23,2,5,7,8,0,-2,1,-1,-1,-1,6,1
KR_6650905924,420,6,162,35,12,7,7,0,1,4,3,0,2,2,3,3,0,1,1,0,1,12,6,3,3,6,2,0,1,1,1,1,1,2,1
KR_6763051170,420,1,1,7,-4,3,4,1,1,3,2,-5,0,5,-5,1,6,2,3,1,-2,-11,-37,-4,8,4,2,0,-1,1,1,-1,-1,4,1
KR_6757101602,420,3,93,-16,3,3,3,0,4,4,0,0,3,3,-5,2,7,1,3,2,0,-3,0,-1,5,4,1,0,0,0,0,0,1,0,1
KR_6704761722,420,5,96,32,10,3,8,5,2,3,1,8,8,0,-3,1,4,0,0,0,1,9,-3,-3,5,2,1,0,1,1,1,1,1,5,1
KR_6756155569,420,0,49,-26,-4,-1,1,2,-1,3,4,-1,1,2,3,3,0,-4,0,4,1,-5,13,1,3,4,1,0,0,-1,1,1,1,3,1
KR_6698497041,420,4,74,-29,20,6,7,1,4,5,1,-3,1,4,11,12,1,2,2,0,1,27,-5,2,4,6,0,0,2,1,1,1,1,6,1
KR_6762251926,420,2,-42,-14,9,0,5,5,3,3,0,3,4,1,3,3,0,0,0,0,0,12,-4,0,4,4,2,0,2,1,1,1,-1,1,1
KR_6763957990,420,0,-17,8,1,4,5,1,2,2,0,-2,1,3,-1,0,1,-2,0,2,0,5,-4,0,4,4,4,0,-1,-1,1,-1,1,1,1
KR_6622696636,420,0,-6,24,3,2,2,0,1,4,3,2,2,0,0,3,3,-2,3,5,1,10,-303,-2,7,5,2,0,-1,1,-1,-1,1,3,1
KR_6763633061,420,0,13,-7,0,-1,2,3,-2,1,3,-1,2,3,2,3,1,2,2,0,1,1,12,4,2,6,-8,0,2,1,1,1,1,2,1
KR_6704600391,420,2,-68,27,8,1,1,0,5,7,2,1,4,3,0,1,1,1,1,0,0,5,-6,-5,7,2,3,0,0,1,1,1,1,2,1
KR_6761152301,420,1,23,3,6,1,5,4,1,1,0,1,4,3,4,5,1,-1,1,2,1,5,0,2,4,6,-1,0,0,-1,1,-1,1,3,1
KR_6690827286,420,-2,3,4,2,1,2,1,2,3,1,1,2,1,0,1,1,-2,0,2,0,-4,133,1,5,6,-1,0,2,1,1,1,1,3,1
KR_6724462358,420,4,201,-19,8,5,6,1,5,7,2,0,2,2,1,3,2,-3,0,3,0,0,-19,2,3,5,2,0,2,1,-1,1,1,5,1
KR_6692068953,420,1,45,8,2,2,3,1,4,6,2,1,1,0,-7,1,8,2,3,1,1,2,35,4,3,7,-17,0,0,-1,1,1,1,2,1
KR_6684257037,420,4,27,2,5,-2,5,7,4,5,1,0,1,1,2,6,4,1,1,0,0,12,6,-1,4,3,1,0,1,-1,-1,-1,1,5,1
KR_6674298885,420,8,97,23,14,3,5,2,4,6,2,0,2,2,7,7,0,0,1,1,1,7,-2,1,3,4,6,0,2,1,1,1,1,3,1
KR_6761772736,420,1,41,-22,10,1,3,2,0,3,3,3,4,1,5,7,2,1,1,0,2,15,-6,3,4,7,9,0,-1,1,1,1,1,6,1
KR_6745708690,420,-4,-90,-29,-1,-2,1,3,4,6,2,-4,1,5,0,2,2,1,1,0,-1,7,158,-2,6,4,1,0,0,-1,1,0,-1,1,1
KR_6743371447,420,2,69,0,2,-1,0,1,2,4,2,0,3,3,1,2,1,0,0,0,-1,-3,36,-2,6,4,-14,0,2,-1,1,1,-1,6,1
KR_6752401495,420,5,13,23,14,3,3,0,2,2,0,3,6,3,4,4,0,2,2,0,0,19,-2,6,0,6,2,0,3,1,1,1,1,6,1
KR_6722589715,440,1,73,14,6,-1,0,1,-3,1,4,1,3,2,7,9,2,2,2,0,1,5,9,4,1,5,1,0,0,1,1,1,1,4,1
KR_6746178241,420,-1,11,29,-6,1,2,1,3,5,2,0,3,3,-4,2,6,-6,1,7,1,-8,11,6,2,8,-3,0,-1,1,-1,-1,1,1,1
KR_6763835057,420,-1,16,34,5,-1,1,2,3,5,2,-1,1,2,3,3,0,1,1,0,2,4,-140,-4,7,3,3,0,0,1,-1,0,1,3,1
KR_6757124498,440,0,15,-35,2,-9,3,12,3,3,0,1,1,0,3,4,1,4,5,1,0,-6,3,-3,9,6,5,0,1,-1,1,1,-1,1,1
KR_6740986505,420,1,-28,-4,3,1,4,3,-4,2,6,2,2,0,4,4,0,0,1,1,0,8,3,1,1,2,1,0,0,1,0,1,1,5,1
KR_6717446643,420,0,-54,-12,6,2,4,2,-1,3,4,3,3,0,1,4,3,1,2,1,0,2,281,4,4,8,-3,0,1,1,1,-1,1,1,1
KR_6759540575,420,4,26,24,1,1,2,1,-7,0,7,8,8,0,-1,1,2,0,0,0,0,-4,14,2,1,3,1,0,0,1,-1,0,-1,5,1
KR_6749714461,440,3,58,-2,21,6,6,0,2,4,2,2,4,2,10,13,3,1,2,1,0,11,7,-1,4,3,0,0,3,1,-1,1,1,1,1
KR_6751543914,440,2,45,29,8,1,2,1,0,1,1,1,1,0,0,3,3,6,7,1,0,16,-142,-3,9,6,3,0,0,1,1,1,-1,5,1
KR_6756932798,420,2,-27,20,4,4,7,3,2,3,1,0,1,1,-2,1,3,0,2,2,0,4,104,5,3,8,-2,0,1,-1,1,1,1,4,1
KR_6763307561,420,-1,-16,-28,-3,3,4,1,0,2,2,0,0,0,-5,1,6,-1,0,1,0,-2,389,-3,7,4,0,0,2,-1,1,1,1,1,1
KR_6655697110,420,0,1,4,6,0,1,1,-2,2,4,0,0,0,9,10,1,-1,2,3,-1,2,0,-1,6,5,-6,0,1,-1,1,1,-1,1,1
KR_6620546995,420,1,56,-3,5,1,3,2,-1,3,4,0,3,3,0,2,2,5,5,0,1,8,42,-1,6,5,-10,0,0,1,-1,0,1,2,1
KR_6764475876,420,5,105,48,14,1,3,2,4,4,0,2,2,0,8,8,0,-1,0,1,0,5,2,1,6,7,5,0,0,1,1,0,1,4,1
KR_6746380947,420,3,43,10,11,1,5,4,3,6,3,-1,2,3,7,8,1,1,1,0,0,10,6,-2,4,2,-2,0,3,1,-1,1,1,5,1
KR_6681831304,420,-4,-60,36,-6,-6,1,7,-3,0,3,-1,0,1,3,4,1,1,2,1,0,-6,37,-4,8,4,0,0,-1,1,-1,-1,1,4,1
KR_6724417415,420,2,37,4,3,6,6,0,-3,2,5,-2,0,2,0,0,0,2,5,3,0,3,7,-2,6,4,0,0,0,1,-1,0,1,4,1
KR_6764674683,440,2,42,13,1,-1,0,1,0,1,1,0,0,0,2,5,3,0,1,1,0,2,-22,-2,5,3,5,0,0,-1,1,1,-1,2,1
KR_6759987540,420,3,55,8,2,3,4,1,-1,1,2,0,0,0,-1,2,3,1,2,1,0,-4,-10,1,4,5,-1,0,1,1,-1,1,-1,3,1
KR_6764508296,420,2,60,4,7,3,3,0,-2,1,3,1,2,1,5,6,1,0,2,2,-1,2,1,0,7,7,-1,0,0,-1,1,0,-1,6,1
KR_6675679825,420,1,29,-13,6,0,1,1,-2,3,5,2,2,0,6,7,1,0,0,0,1,6,-4,2,2,4,-3,0,1,1,0,1,1,4,1
KR_6761588814,420,2,21,4,2,-1,1,2,3,3,0,3,3,0,-1,1,2,-2,0,2,0,2,0,2,2,4,-3,0,0,-1,1,0,-1,4,1
KR_6665628809,420,5,53,-7,13,1,3,2,2,6,4,6,6,0,-1,2,3,5,6,1,0,9,118,4,3,7,1,0,2,-1,1,1,-1,3,1
KR_6683375633,420,-2,-5,-36,-2,-3,0,3,1,3,2,1,2,1,-1,1,2,0,0,0,0,2,-12,1,5,6,-1,0,1,-1,0,1,-1,4,1
KR_6759477252,420,0,26,4,5,0,2,2,0,1,1,6,7,1,-3,3,6,2,2,0,2,4,48,3,1,4,-4,0,1,1,1,1,1,3,1
KR_6733191881,420,1,0,0,4,0,2,2,0,3,3,-1,0,1,-1,6,7,6,8,2,0,11,-28,-2,6,4,0,0,1,1,-1,1,1,6,1
KR_6722136970,420,1,23,0,5,2,5,3,3,3,0,-1,1,2,2,4,2,-1,1,2,2,9,-4,1,3,4,1,0,0,1,-1,0,1,2,1
KR_6745568776,420,2,8,-2,4,7,7,0,3,4,1,-7,1,8,1,2,1,0,0,0,-1,0,-20,1,3,4,0,0,0,-1,1,0,-1,5,1
KR_6718911577,420,5,16,-8,12,2,3,1,1,3,2,1,2,1,8,9,1,0,2,2,0,10,35,3,2,5,2,0,0,1,1,1,1,1,1
KR_6649031978,420,-1,-1,30,-5,-2,1,3,-2,1,3,2,3,1,-6,2,8,3,3,0,0,-4,7,2,4,6,-2,0,0,1,1,1,1,6,1
KR_6757444458,420,2,53,-21,2,3,5,2,-5,1,6,0,0,0,4,6,2,0,0,0,0,0,1,5,3,8,-2,0,2,1,-1,1,-1,4,1
KR_6644398793,420,-1,-8,-19,-5,3,3,0,-2,1,3,-1,2,3,-6,1,7,1,1,0,0,-4,-1,-1,5,4,-7,0,0,0,-1,0,-1,0,1
KR_6760171595,420,4,38,-12,5,4,5,1,-2,0,2,-1,0,1,3,5,2,1,1,0,0,1,7,5,1,6,2,0,0,-1,-1,0,-1,6,1
KR_6741456901,420,-1,29,-4,-3,-4,0,4,4,6,2,1,1,0,-4,1,5,0,1,1,0,-3,12,4,2,6,-4,0,-1,1,1,1,-1,2,1
KR_6700154555,420,3,14,12,7,-1,0,1,0,2,2,3,3,0,2,6,4,3,4,1,0,10,5,-1,6,5,2,0,0,-1,-1,0,1,5,1
KR_6738001295,420,2,117,5,-3,-2,1,3,0,5,5,-2,4,6,0,1,1,1,1,0,0,3,-38,4,1,5,-2,0,1,1,-1,1,1,1,1
KR_6760573565,420,2,-16,-4,2,3,3,0,-1,2,3,-1,3,4,1,4,3,0,0,0,0,-1,2,-1,5,4,-1,0,-1,1,-1,-1,1,5,1
KR_6759351062,420,1,37,34,6,5,6,1,0,6,6,6,6,0,-3,4,7,-2,1,3,2,-2,2,1,3,4,2,0,2,1,1,1,1,1,1
KR_6762902946,420,-2,-22,-9,-6,-2,0,2,-1,1,2,-3,2,5,2,3,1,-2,0,2,0,0,18,8,4,12,-6,0,1,1,1,1,1,1,1
KR_6717468711,420,1,28,3,0,1,4,3,6,7,1,-2,1,3,-6,0,6,1,2,1,0,-4,5,3,3,6,-1,0,0,1,-1,0,-1,1,1
KR_6747817140,420,2,-10,31,12,-1,2,3,5,9,4,2,4,2,6,6,0,0,1,1,0,4,-5,0,4,4,0,0,0,0,-1,0,1,0,1
KR_6756615693,420,4,38,16,12,-1,1,2,6,6,0,6,9,3,2,5,3,-1,0,1,-1,4,-2,0,3,3,0,0,1,-1,1,1,-1,5,1
KR_6734133033,420,4,69,6,6,3,5,2,-2,3,5,1,4,3,2,5,3,2,3,1,0,6,-2,-4,8,4,0,0,0,-1,-1,-1,-1,2,1
KR_6648772699,420,4,57,28,7,-2,0,2,1,3,2,0,3,3,5,5,0,3,3,0,0,9,413,4,1,5,0,0,2,1,-1,1,1,4,1
KR_6758542858,420,1,45,-7,6,2,3,1,-1,1,2,4,6,2,0,1,1,1,3,2,0,2,-10,1,3,4,-1,0,2,1,1,1,1,1,1
KR_6762246999,420,0,19,-5,0,0,1,1,-3,2,5,2,5,3,2,2,0,-1,0,1,0,-6,-129,4,4,8,0,0,0,-1,-1,0,-1,6,1
KR_6753858204,420,2,63,-69,7,2,2,0,-3,2,5,7,10,3,-1,1,2,2,3,1,0,4,-8,2,2,4,-1,0,2,1,1,1,1,3,1
KR_6732641255,440,-5,-62,-11,-10,-3,1,4,-6,1,7,3,4,1,-3,0,3,-1,0,1,0,-6,-184,-3,6,3,5,0,-2,-1,1,-1,-1,5,1
KR_6714331448,420,1,90,1,4,0,1,1,5,6,1,0,1,1,-1,1,2,0,0,0,0,12,2,4,5,9,-1,0,0,1,-1,0,-1,5,1
KR_6745598333,420,-5,-115,16,-11,-1,1,2,-1,1,2,-4,1,5,-6,1,7,1,2,1,0,-5,5,0,3,3,0,0,0,-1,0,0,-1,2,1
KR_6727855630,420,4,100,19,14,1,2,1,2,4,2,1,1,0,9,11,2,1,1,0,0,8,3,-1,1,0,2,0,0,1,1,0,1,5,1
KR_6763565230,440,5,32,32,9,2,3,1,4,4,0,3,5,2,0,2,2,0,3,3,0,4,7,4,4,8,-6,0,0,-1,0,0,1,2,1
KR_6732529397,420,4,91,16,4,0,1,1,2,5,3,1,2,1,3,5,2,-2,1,3,0,3,-33,3,5,8,2,0,0,1,1,1,-1,1,1
KR_6647986348,420,2,22,4,0,2,2,0,2,3,1,-5,0,5,0,2,2,1,1,0,0,3,-78,0,6,6,-2,0,0,0,1,0,1,0,1
KR_6739538170,420,-3,57,12,1,-3,1,4,0,3,3,-3,1,4,5,5,0,2,2,0,0,11,-3,-4,9,5,8,0,0,1,-1,-1,1,4,1
KR_6759840071,420,0,19,-21,3,5,6,1,5,9,4,-3,2,5,-4,4,8,0,1,1,0,2,3,1,5,6,1,0,-2,1,-1,-1,-1,6,1
KR_6695354403,420,0,-30,12,4,-2,0,2,1,3,2,3,4,1,1,2,1,1,1,0,-1,6,47,0,4,4,-22,0,1,1,-1,1,-1,1,1
KR_6737260766,420,1,44,33,-5,0,1,1,-9,1,10,0,1,1,3,3,0,1,1,0,0,-7,-3,2,2,4,1,0,1,1,1,1,1,5,1
KR_6753285349,420,2,12,-4,5,3,6,3,0,4,4,-1,4,5,2,3,1,1,1,0,0,4,15,3,3,6,2,0,0,1,1,1,-1,4,1
KR_6689458068,420,2,-86,13,12,1,3,2,5,6,1,-1,1,2,6,8,2,1,1,0,1,17,25,5,5,10,0,0,1,1,-1,-1,1,3,1
KR_6745801802,420,1,72,29,3,5,5,0,-1,5,6,1,2,1,0,2,2,-2,2,4,2,-5,4,4,1,5,3,0,2,0,1,1,1,0,1
KR_6601634709,420,1,8,12,5,0,1,1,0,2,2,2,4,2,3,3,0,0,0,0,0,4,-2,2,3,5,0,0,0,1,-1,0,-1,2,1
KR_6745544385,420,1,-41,12,0,3,4,1,0,1,1,0,3,3,-1,0,1,-2,0,2,0,-2,55,-2,3,1,-24,0,-3,1,-1,-1,-1,4,1
KR_6746532410,420,-1,6,4,2,0,1,1,-5,1,6,-2,1,3,8,9,1,1,1,0,0,0,-7,0,2,2,1,0,2,-1,1,1,1,5,1
KR_6660998134,420,-1,33,-10,-5,-1,0,1,-3,4,7,0,4,4,-1,2,3,0,0,0,0,-1,-8,-5,7,2,3,0,1,-1,-1,1,1,2,1
KR_6763290751,420,0,-58,-27,7,1,1,0,4,6,2,-3,2,5,4,4,0,1,2,1,0,10,21,1,7,8,-5,0,0,1,-1,0,1,4,1
KR_6755512278,420,1,-18,8,1,-5,0,5,7,8,1,2,3,1,-3,3,6,0,0,0,-1,4,6,-1,5,4,-3,0,0,1,1,0,-1,3,1
KR_6727179305,420,0,-72,-16,0,-2,1,3,3,4,1,0,4,4,-3,2,5,2,2,0,0,-1,-3,-3,6,3,0,0,-1,1,-1,-1,1,4,1
KR_6712850078,420,5,70,-9,13,1,2,1,4,6,2,5,6,1,3,4,1,0,1,1,0,9,111,7,2,9,0,0,1,0,1,1,1,0,1
KR_6695066405,420,6,45,1,11,3,4,1,4,4,0,1,2,1,3,3,0,0,1,1,0,9,4,3,2,5,1,0,2,1,1,1,-1,2,1
KR_6720092614,420,4,22,7,12,3,3,0,4,7,3,2,4,2,3,3,0,0,3,3,0,13,-8,6,3,9,3,0,1,-1,-1,1,-1,5,1
KR_6729125213,420,5,110,-32,7,3,4,1,4,8,4,3,6,3,0,3,3,-3,1,4,-2,8,50,-2,6,4,-27,0,1,1,-1,1,1,1,1
KR_6762591257,420,2,-29,15,5,-4,1,5,0,2,2,4,4,0,4,4,0,1,1,0,0,8,-7,-1,4,3,5,0,0,1,1,-1,1,2,1
KR_6671171873,420,4,119,11,7,0,1,1,0,3,3,0,1,1,5,5,0,2,2,0,0,9,50,4,3,7,-22,0,1,1,1,1,1,3,1
KR_6762140611,420,1,-16,24,1,-4,1,5,-2,3,5,3,4,1,4,8,4,0,0,0,0,5,-33,0,4,4,-2,0,0,1,1,1,-1,5,1
KR_6485984986,420,3,123,-16,8,2,2,0,2,2,0,1,2,1,3,5,2,0,0,0,0,7,4,-2,5,3,2,0,1,1,-1,1,1,3,1
KR_6736048875,420,-2,-5,1,-2,-2,0,2,1,3,2,2,4,2,-4,0,4,1,1,0,0,2,-17,1,2,3,1,0,-1,-1,1,-1,-1,4,1
KR_6760544240,420,-2,20,-23,-3,5,5,0,0,2,2,-1,1,2,-3,2,5,-4,0,4,0,-5,0,4,2,6,-3,0,0,-1,0,0,-1,1,1
KR_6754201638,420,1,17,-17,0,2,2,0,-1,2,3,1,2,1,-2,3,5,0,1,1,0,-3,118,-2,5,3,6,0,0,1,-1,1,1,1,1
KR_6763964521,440,11,146,87,16,4,7,3,0,1,1,9,9,0,0,0,0,3,3,0,1,14,5,5,0,5,-1,0,4,1,1,1,1,3,1
KR_6652324683,420,5,103,0,10,1,2,1,6,8,2,1,3,2,2,4,2,0,0,0,0,15,-179,-1,3,2,-1,0,2,-1,1,1,-1,4,1
KR_6758871179,420,1,-85,29,10,3,3,0,4,6,2,-1,0,1,2,3,1,2,4,2,0,8,-6,2,3,5,-2,0,0,-1,1,0,-1,2,1
KR_6530022815,420,5,23,43,6,2,2,0,-3,0,3,6,7,1,0,1,1,1,2,1,1,3,37,-2,4,2,1,0,1,0,1,1,1,0,1
KR_6760584613,420,4,-20,-6,14,2,2,0,0,3,3,3,6,3,9,10,1,0,3,3,1,13,-10,7,1,8,2,0,1,1,-1,1,1,4,1
KR_6662232908,420,3,69,20,1,4,4,0,-3,1,4,0,0,0,2,6,4,-2,0,2,-1,-8,-13,-2,5,3,-1,0,1,1,-1,1,-1,3,1
KR_6406122605,420,-2,80,-8,2,7,7,0,-4,1,5,0,1,1,-4,2,6,3,3,0,1,0,15,3,2,5,-4,0,2,1,1,1,1,3,1
KR_6696517201,420,-4,-34,-12,-8,-2,3,5,-2,3,5,-2,4,6,-1,1,2,-1,1,2,0,-8,9,4,4,8,-1,0,0,-1,1,1,-1,3,1
KR_6759459306,440,2,-44,0,4,-2,0,2,0,2,2,4,6,2,2,6,4,0,2,2,-1,0,10,1,3,4,-3,0,0,-1,1,1,-1,5,1
KR_6763492721,440,3,40,-8,8,0,3,3,3,6,3,2,3,1,2,4,2,1,5,4,0,12,10,4,1,5,-16,0,0,1,-1,1,-1,1,1
KR_6753420770,420,2,44,0,5,1,2,1,0,0,0,-3,1,4,3,3,0,4,4,0,0,1,-70,1,6,7,-2,0,0,1,-1,0,1,3,1
KR_6637606577,420,4,19,-19,5,3,3,0,-3,0,3,2,4,2,3,3,0,0,0,0,0,4,23,-2,6,4,4,0,1,-1,1,1,1,6,1
KR_5533032584,420,3,57,7,9,0,1,1,-1,6,7,3,5,2,6,6,0,1,2,1,0,18,9,1,6,7,3,0,2,-1,1,1,1,3,1
KR_6544981674,420,2,3,-10,-2,4,5,1,-1,3,4,-3,0,3,-2,2,4,0,0,0,0,-9,18,-3,7,4,0,0,-1,1,-1,-1,-1,5,1
KR_6762907304,440,7,45,18,11,0,2,2,2,3,1,6,7,1,1,9,8,2,3,1,0,10,9,4,0,4,-5,0,1,1,-1,1,-1,4,1
KR_6728081429,420,3,-5,20,5,3,5,2,0,1,1,0,2,2,1,2,1,1,1,0,0,3,7,4,5,9,1,0,0,1,1,0,1,6,1
KR_6752824907,440,3,6,34,-1,3,4,1,1,3,2,-2,1,3,-2,0,2,-1,1,2,0,-4,-1,-1,7,6,8,0,0,1,1,0,1,6,1
KR_6756608755,420,-3,-46,-17,4,-6,1,7,0,2,2,4,6,2,5,5,0,1,1,0,0,10,0,1,2,3,2,0,-2,1,-1,-1,-1,4,1
KR_6682758524,420,6,52,39,7,2,3,1,3,5,2,1,3,2,3,7,4,-2,0,2,1,10,-178,9,1,10,-7,0,0,1,-1,0,1,4,1
KR_6698938312,420,-1,0,16,-6,3,3,0,-5,2,7,0,1,1,-1,4,5,-3,0,3,0,-13,9,-1,6,5,0,0,1,-1,1,1,-1,4,1
KR_6698529229,420,1,-34,21,8,-1,0,1,2,4,2,5,5,0,-1,3,4,3,4,1,0,8,80,5,5,10,4,0,0,1,1,1,1,6,1
KR_6751955386,420,0,30,-24,2,2,3,1,1,6,5,2,3,1,-2,0,2,-1,1,2,0,0,-32,-3,5,2,7,0,1,1,-1,1,1,4,1
KR_6690892436,420,9,115,12,17,4,5,1,2,2,0,7,8,1,3,3,0,1,1,0,0,9,2,2,9,11,1,0,1,1,1,1,1,6,1
KR_6594494939,420,1,33,24,6,0,1,1,6,7,1,2,3,1,-2,0,2,0,0,0,0,7,0,2,2,4,-3,0,1,-1,1,1,1,2,1
KR_6723103403,440,3,14,9,8,0,5,5,-1,3,4,1,1,0,7,7,0,1,1,0,0,8,1,2,1,3,0,0,1,0,-1,1,-1,0,1
KR_6737853674,420,3,44,16,2,5,5,0,1,2,1,-6,1,7,1,2,1,1,2,1,0,7,-225,2,1,3,-2,0,2,1,-1,1,-1,2,1
KR_6746282440,420,0,10,-11,0,-1,3,4,3,4,1,-2,0,2,2,4,2,-2,1,3,1,-2,7,-1,3,2,4,0,1,1,-1,1,1,1,1
KR_6755615222,420,0,-53,24,0,3,3,0,3,7,4,-4,1,5,-2,1,3,0,0,0,0,4,-84,2,4,6,-1,0,-1,1,1,-1,1,2,1
KR_6718713694,420,-3,30,-7,0,2,3,1,-1,1,2,-2,2,4,3,3,0,-2,0,2,0,3,4,3,2,5,-1,0,0,0,1,1,-1,0,1
KR_6741422364,420,1,67,4,8,4,5,1,-1,4,5,3,4,1,2,8,6,0,1,1,-1,1,31,0,3,3,1,0,1,-1,1,1,-1,6,1
KR_6691001802,420,1,28,-5,4,0,3,3,0,3,3,1,3,2,3,6,3,0,1,1,0,2,-5,0,5,5,-1,0,0,1,1,1,-1,4,1
KR_6754736482,420,1,75,9,0,2,3,1,2,4,2,1,2,1,-5,1,6,0,1,1,0,-6,-208,-5,6,1,1,0,0,-1,1,-1,-1,6,1
KR_6692389602,440,3,39,3,4,-1,1,2,-3,1,4,2,3,1,6,6,0,0,0,0,1,5,191,-2,5,3,2,0,1,1,1,1,1,4,1
KR_6762846606,420,2,-4,-19,9,-1,1,2,-6,3,9,9,9,0,6,6,0,1,1,0,0,3,7,1,2,3,-2,0,0,-1,-1,-1,-1,1,1
KR_6757419758,420,-2,-7,8,-4,-6,0,6,4,4,0,2,3,1,-4,2,6,0,5,5,0,2,-2,4,2,6,-2,0,-1,1,-1,-1,1,5,1
KR_6745350097,420,3,62,28,6,9,9,0,2,3,1,-2,2,4,-2,0,2,-1,1,2,-1,5,-11,6,1,7,6,0,1,1,1,1,-1,6,1
KR_6665613034,420,4,106,17,7,0,0,0,4,6,2,-5,2,7,7,8,1,1,3,2,0,11,-27,-3,5,2,5,0,3,1,1,1,1,3,1
KR_6741381660,420,1,14,18,1,-1,2,3,3,5,2,1,2,1,3,4,1,-5,0,5,0,8,-3,-2,5,3,0,0,0,1,-1,-1,1,4,1
KR_6654496731,420,1,31,28,-4,2,3,1,-2,2,4,1,1,0,-4,1,5,-1,0,1,0,-9,3,-3,7,4,-5,0,0,-1,1,1,-1,4,1
KR_6743897880,420,1,-34,0,13,1,3,2,8,9,1,1,3,2,1,1,0,2,2,0,0,6,4,-2,8,6,-4,0,0,-1,-1,0,1,2,1
KR_6706521986,420,2,11,-16,5,1,2,1,0,3,3,-2,1,3,4,4,0,2,2,0,0,10,70,6,1,7,-3,0,0,1,1,1,-1,3,1
KR_6735561914,420,7,65,52,12,0,4,4,6,6,0,-2,1,3,7,11,4,1,3,2,0,1,-1,-1,2,1,5,0,3,1,1,1,1,5,1
KR_6761209097,420,-2,-36,-24,-5,-3,0,3,-5,1,6,0,2,2,2,4,2,1,1,0,0,-2,99,-7,10,3,4,0,0,1,-1,0,-1,4,1
KR_6727265106,420,1,32,-20,5,4,6,2,3,6,3,1,1,0,-2,1,3,-1,0,1,-1,1,3,4,3,7,-1,0,1,1,1,1,-1,6,1
KR_6475927149,420,2,73,-2,6,4,5,1,2,6,4,-4,2,6,0,3,3,4,4,0,1,8,-18,2,2,4,-1,0,2,-1,1,1,1,5,1
KR_6746338109,420,8,99,4,13,6,6,0,1,3,2,0,1,1,2,3,1,4,4,0,1,7,-202,3,2,5,-29,0,4,1,1,1,1,2,1
KR_6747479641,440,4,32,28,15,6,6,0,5,9,4,3,3,0,0,6,6,1,1,0,-1,5,1,-2,2,0,3,0,0,1,1,1,-1,6,1
KR_6600777877,420,-4,-66,1,-2,-1,0,1,0,3,3,-1,2,3,-1,3,4,1,1,0,0,4,-1,-1,4,3,1,0,1,1,1,1,-1,5,1
KR_6758927583,420,-2,106,7,1,1,2,1,2,3,1,3,4,1,-3,0,3,-2,0,2,1,-1,-9,-2,3,1,2,0,0,-1,1,0,1,2,1
KR_6698994145,420,6,48,-17,15,0,2,2,4,4,0,4,4,0,7,7,0,0,2,2,0,20,0,4,4,8,2,0,2,-1,1,1,1,3,1
KR_6730808469,420,1,64,19,-4,-5,1,6,2,4,2,-2,4,6,1,3,2,0,1,1,0,-3,18,0,3,3,0,0,0,0,0,1,-1,0,1
KR_6722839566,440,3,-21,-8,7,-3,1,4,1,3,2,0,6,6,8,8,0,1,1,0,0,11,2,0,3,3,3,0,1,1,1,1,1,2,1
KR_6398103785,420,-2,-25,42,-4,6,7,1,-3,3,6,-3,3,6,-3,0,3,-1,1,2,0,-11,1,1,7,8,-1,0,-1,-1,1,-1,1,4,1
KR_6762353123,420,0,-11,-16,1,1,2,1,0,2,2,-2,0,2,0,1,1,2,2,0,0,4,-3,2,3,5,0,0,0,0,-1,0,1,0,1
KR_6752726470,420,5,17,27,9,5,5,0,0,3,3,3,3,0,2,3,1,-1,0,1,0,5,-24,-1,5,4,1,0,1,1,0,1,1,6,1
KR_6658612758,420,3,35,14,3,1,1,0,0,2,2,1,2,1,4,5,1,-3,0,3,0,5,5,2,3,5,-1,0,1,-1,1,1,1,5,1
KR_6754804605,440,4,38,4,8,-1,1,2,0,3,3,6,7,1,3,4,1,0,1,1,-1,1,-5,2,1,3,1,0,2,1,1,1,-1,3,1
KR_6741763248,420,1,85,7,1,5,6,1,-1,2,3,-9,1,10,3,3,0,3,4,1,0,4,-5,-1,4,3,-1,0,1,-1,-1,1,-1,6,1
KR_6760539140,440,0,-21,8,2,3,3,0,-4,1,5,-1,0,1,3,3,0,1,1,0,0,-2,4,1,3,4,-2,0,0,-1,1,0,1,4,1
KR_6763429913,420,-1,25,-20,-2,-1,1,2,-1,2,3,0,0,0,-1,1,2,1,1,0,0,-6,-14,1,1,2,2,0,0,-1,1,-1,1,3,1
KR_6758889755,420,0,10,1,3,6,7,1,0,2,2,-5,4,9,-2,1,3,4,6,2,0,-1,6,4,3,7,0,0,2,1,1,1,1,2,1
KR_6705886176,420,4,89,35,7,5,10,5,2,3,1,5,9,4,-4,0,4,-1,0,1,0,0,0,8,3,11,3,0,2,-1,1,1,1,5,1
KR_6721765164,440,5,105,-20,14,2,2,0,4,4,0,3,3,0,4,6,2,1,1,0,0,18,4,3,1,4,0,0,0,-1,0,1,1,3,1
KR_6758490990,420,2,35,12,4,2,4,2,4,8,4,3,4,1,-4,1,5,-1,0,1,0,-5,-7,-1,3,2,4,0,2,1,1,1,1,5,1
KR_6688921881,420,5,139,42,8,-2,3,5,-3,5,8,4,4,0,7,7,0,2,3,1,0,10,9,-2,3,1,-2,0,1,1,1,1,-1,2,1
KR_6695888479,420,1,54,20,1,-3,1,4,-1,0,1,5,7,2,1,2,1,-1,0,1,1,3,113,2,4,6,4,0,1,-1,1,1,1,3,1
KR_6630615010,420,-1,44,20,-3,4,4,0,-1,2,3,3,4,1,-6,2,8,-3,1,4,0,-19,272,-4,5,1,-2,0,1,-1,1,1,1,2,1
KR_6761709361,440,3,21,19,15,4,4,0,1,3,2,4,5,1,6,7,1,0,0,0,0,13,8,5,2,7,-1,0,1,1,1,1,1,5,1
KR_6762098421,420,1,26,12,1,4,6,2,-3,0,3,2,3,1,-1,1,2,-1,0,1,0,-4,-58,-1,8,7,36,0,2,-1,1,1,1,2,1
KR_6758125955,420,-1,-75,3,-1,-3,4,7,2,2,0,1,4,3,0,3,3,-1,0,1,0,7,1,-3,7,4,0,0,-1,1,-1,-1,-1,2,1
KR_6760430808,420,1,0,0,1,1,2,1,-2,0,2,-3,0,3,5,6,1,0,1,1,0,2,13,1,2,3,-6,0,1,-1,1,1,-1,4,1
KR_6683601617,420,0,67,0,1,3,4,1,0,4,4,-2,1,3,-1,0,1,1,1,0,0,2,1,1,2,3,0,0,0,1,1,0,-1,3,1
KR_6742966246,420,0,-70,25,-1,1,3,2,0,6,6,0,1,1,-3,1,4,1,1,0,0,-2,46,-3,5,2,1,0,0,-1,1,1,1,6,1
KR_6615503268,420,6,124,-9,16,5,7,2,5,5,0,4,4,0,0,3,3,2,2,0,0,9,-57,3,3,6,2,1,4,1,-1,1,1,5,1
KR_6725943880,420,6,11,21,10,5,5,0,0,2,2,1,2,1,4,5,1,0,0,0,0,11,-8,-1,4,3,4,0,3,1,1,1,1,4,1
KR_6761982817,420,3,7,1,6,-1,1,2,0,2,2,3,7,4,2,6,4,2,2,0,-1,3,28,-4,8,4,-5,0,1,0,0,1,-1,0,1
KR_6736371614,420,2,48,36,3,0,2,2,1,4,3,2,3,1,0,1,1,0,1,1,1,2,-1,-4,6,2,3,0,2,1,-1,1,1,4,1
KR_6747397523,420,4,30,14,11,5,6,1,2,4,2,2,3,1,3,4,1,-1,2,3,0,6,2,-1,2,1,2,0,2,0,1,1,1,0,1
KR_6763044650,440,3,1,-4,9,4,4,0,-1,2,3,6,6,0,-1,2,3,1,3,2,1,3,1,1,5,6,2,0,1,0,1,1,1,0,1
KR_6762405616,420,1,0,-13,10,2,3,1,3,3,0,-2,1,3,4,4,0,3,3,0,0,12,-3,2,4,6,5,0,2,1,0,1,1,3,1
KR_6738233499,440,7,94,44,13,3,3,0,7,10,3,-2,3,5,5,11,6,0,0,0,-1,12,-97,4,2,6,7,0,2,1,1,1,-1,5,1
KR_6728504710,420,5,41,-8,11,-4,2,6,3,4,1,9,10,1,2,3,1,1,2,1,0,13,48,-5,7,2,-24,0,-1,1,-1,-1,-1,4,1
KR_6641153552,420,2,-23,-21,10,6,6,0,1,3,2,-2,2,4,5,5,0,0,0,0,0,17,-30,1,2,3,3,0,1,1,0,1,-1,5,1
KR_6751940531,420,3,19,49,6,-2,0,2,2,3,1,6,6,0,0,2,2,0,0,0,1,2,5,1,4,5,3,0,2,1,1,1,1,3,1
KR_6709851668,420,8,92,43,17,0,2,2,5,7,2,3,3,0,10,10,0,-1,1,2,2,20,1,-1,4,3,-1,0,2,1,0,1,1,2,1
KR_6757640065,440,-1,14,-12,-3,2,2,0,0,0,0,-13,0,13,7,8,1,1,1,0,1,2,-15,-1,2,1,2,0,0,0,0,-1,1,0,1
KR_6759635655,420,6,90,26,10,2,4,2,2,4,2,4,4,0,3,3,0,-1,0,1,1,17,9,-1,4,3,-3,0,2,1,1,1,1,4,1
KR_6737196746,420,1,23,4,3,0,1,1,-1,3,4,5,5,0,-2,1,3,1,1,0,0,-3,27,-1,7,6,-8,0,1,1,-1,1,1,6,1
KR_6747078560,420,0,-69,-8,1,0,3,3,0,4,4,2,3,1,-2,1,3,1,4,3,0,-1,0,-1,3,2,0,0,0,-1,0,0,1,4,1
KR_6764556115,440,3,40,7,11,-1,3,4,2,3,1,-1,2,3,9,9,0,2,2,0,3,17,24,8,0,8,1,0,3,-1,1,1,1,3,1
KR_6714305061,420,-1,-65,-4,1,-5,0,5,3,4,1,3,5,2,0,2,2,0,0,0,0,5,3,3,3,6,-2,0,0,1,1,0,-1,6,1
KR_6759618663,440,4,5,21,13,1,3,2,7,7,0,1,3,2,0,2,2,4,4,0,0,16,-170,1,5,6,0,0,0,1,0,0,1,4,1
KR_6658894914,420,2,-23,-16,7,-2,2,4,4,6,2,0,2,2,3,4,1,2,2,0,0,5,19,2,3,5,-2,0,-1,1,-1,-1,-1,5,1
KR_6650679326,420,4,7,-5,7,0,2,2,-2,4,6,3,4,1,3,4,1,3,3,0,0,4,0,-2,6,4,-1,0,-1,-1,1,-1,1,5,1
KR_6750108839,420,0,51,-25,-1,-1,2,3,1,5,4,1,2,1,-3,1,4,1,3,2,0,2,-12,0,3,3,0,0,2,-1,1,1,1,6,1
KR_6742002083,420,3,65,-4,10,1,1,0,7,8,1,2,2,0,1,3,2,-1,1,2,0,7,-1,-4,6,2,1,0,0,1,-1,1,1,5,1
KR_6743174734,420,3,27,24,4,2,4,2,5,9,4,0,3,3,-2,2,4,-1,5,6,0,4,4,0,2,2,0,0,2,-1,1,1,1,4,1
KR_6744837405,420,2,-14,8,3,1,3,2,2,2,0,-1,0,1,1,3,2,0,2,2,0,5,-31,1,6,7,1,0,0,-1,1,0,-1,3,1
KR_6699747415,420,4,18,24,10,-2,3,5,5,7,2,0,3,3,2,2,0,5,6,1,0,13,35,1,3,4,-1,0,1,1,0,1,1,2,1
KR_6706751652,440,2,25,20,8,2,3,1,2,4,2,6,6,0,-2,3,5,0,0,0,0,5,-3,-2,4,2,3,0,0,1,-1,0,1,3,1
KR_6689825271,420,1,13,10,4,-3,0,3,5,6,1,5,6,1,-1,4,5,-2,0,2,1,-4,0,0,3,3,-1,0,1,-1,1,1,1,4,1
KR_6760820864,420,2,13,-4,9,2,4,2,1,3,2,1,4,3,6,7,1,-1,3,4,1,15,6,0,3,3,-2,0,1,0,1,1,1,0,1
KR_6566815737,420,1,31,24,1,-5,1,6,4,5,1,-2,2,4,0,1,1,4,4,0,1,9,23,1,3,4,3,0,0,1,-1,0,1,3,1
KR_6738399083,440,0,-7,0,4,1,2,1,-1,1,2,3,4,1,0,3,3,1,2,1,0,9,3,-3,8,5,5,0,0,-1,1,0,1,4,1
KR_6719270275,440,2,-13,-7,6,3,4,1,4,4,0,-1,1,2,0,2,2,0,2,2,0,9,-2,-1,5,4,5,0,1,0,1,1,1,0,1
KR_6698283928,420,0,81,-2,-2,1,2,1,-1,2,3,4,5,1,2,7,5,-8,0,8,-1,-11,-8,-5,8,3,3,0,1,-1,-1,1,-1,1,1
KR_6762638342,420,2,-64,-19,16,-2,0,2,2,4,2,5,5,0,8,10,2,3,6,3,0,7,64,1,2,3,3,0,0,1,1,1,1,4,1
KR_6752871949,420,6,90,32,12,3,3,0,7,9,2,5,10,5,-3,0,3,0,1,1,1,8,-10,1,4,5,-1,0,1,1,1,1,1,1,1
KR_6680124795,420,1,-59,28,4,0,0,0,5,8,3,2,2,0,-1,1,2,-2,0,2,1,12,-4,2,7,9,1,0,-1,1,-1,-1,1,3,1
KR_6763516692,440,3,17,4,12,1,3,2,2,4,2,6,7,1,3,5,2,0,3,3,0,6,2,2,3,5,-3,0,1,-1,1,1,1,5,1
KR_6648119370,420,-2,-43,8,-3,-2,1,3,-4,1,5,1,1,0,4,5,1,-2,0,2,0,-3,35,1,5,6,5,0,1,1,1,1,-1,1,1
KR_6760995135,420,4,1,20,15,4,4,0,8,8,0,5,6,1,-2,4,6,0,0,0,0,12,4,2,4,6,0,0,-1,1,1,-1,1,2,1
KR_6723772226,440,2,34,24,0,2,3,1,3,6,3,-1,1,2,-3,2,5,-1,0,1,0,2,4,2,3,5,-3,0,0,1,0,0,-1,2,1
KR_6659742952,420,1,30,7,0,2,4,2,-1,3,4,0,0,0,-1,1,2,0,1,1,0,-2,2,0,3,3,0,0,0,1,-1,0,1,5,1
KR_6730345324,420,6,87,29,14,5,5,0,3,4,1,-1,1,2,4,9,5,3,3,0,0,7,41,-3,5,2,-11,0,4,1,-1,1,1,3,1
KR_6690463429,420,4,70,-32,11,1,1,0,0,4,4,3,3,0,6,6,0,1,1,0,0,15,-107,-2,5,3,2,0,1,1,1,1,-1,4,1
KR_6650958601,420,0,-8,7,-5,2,4,2,-3,2,5,0,1,1,-4,2,6,0,2,2,0,-6,-5,-3,6,3,-1,0,0,-1,-1,1,1,1,1
KR_6762239420,420,4,-56,30,6,0,1,1,3,4,1,-1,1,2,2,3,1,2,2,0,0,6,20,-1,2,1,-1,0,0,1,0,1,1,5,1
KR_6701529282,440,1,1,16,4,-2,0,2,0,7,7,3,3,0,-1,4,5,4,5,1,0,4,-5,1,4,5,-2,0,0,1,1,0,1,3,1
KR_6752591407,420,-1,18,9,0,0,2,2,1,2,1,0,0,0,-1,4,5,0,2,2,0,-5,15,2,5,7,-6,0,-1,1,-1,-1,1,4,1
KR_6760118526,420,2,56,1,12,3,7,4,4,6,2,1,4,3,6,8,2,-2,3,5,1,16,8,1,3,4,5,0,0,1,-1,1,1,1,1
KR_6635468309,420,2,-55,27,4,1,2,1,-6,1,7,5,5,0,4,5,1,0,0,0,1,10,0,-4,8,4,0,0,-1,-1,-1,-1,1,6,1
KR_6757305014,420,2,66,30,2,-1,2,3,2,4,2,1,1,0,2,5,3,-2,1,3,-1,0,125,1,2,3,-3,0,0,-1,-1,1,-1,4,1
KR_6761857890,420,0,-37,81,-4,-2,1,3,-1,2,3,1,2,1,1,5,4,-3,0,3,0,0,0,1,5,6,5,0,1,0,0,1,-1,0,1
KR_6756470585,420,0,-7,14,6,-3,0,3,-2,2,4,3,3,0,1,1,0,7,7,0,1,5,-6,-2,6,4,1,0,0,1,-1,1,1,4,1
KR_6658038780,420,0,27,43,-4,-4,1,5,8,9,1,-3,0,3,-3,0,3,-2,2,4,0,-5,14,1,3,4,-8,0,-1,1,-1,-1,-1,1,1
KR_6764082500,440,3,32,21,9,-1,2,3,1,1,0,1,2,1,5,6,1,3,3,0,0,12,43,5,3,8,-20,0,2,1,1,1,1,5,1
KR_6674727163,420,0,13,19,0,4,4,0,3,4,1,-1,2,3,-4,1,5,-2,1,3,0,-5,-4,-3,6,3,4,0,0,1,1,1,-1,2,1
KR_6685857850,420,3,45,41,4,3,3,0,0,5,5,-1,5,6,2,4,2,0,1,1,0,3,16,-4,7,3,3,0,0,-1,-1,-1,-1,1,1
KR_6756309893,420,-1,20,16,-12,-1,3,4,-1,1,2,-3,1,4,-8,1,9,1,3,2,1,-13,26,-2,5,3,-22,0,-1,1,-1,-1,1,4,1
KR_6655786235,420,1,-17,19,3,1,2,1,-2,2,4,1,1,0,1,1,0,2,2,0,1,6,-2,4,6,10,-3,0,1,-1,0,1,1,5,1
KR_6746715061,420,3,67,7,8,3,4,1,1,4,3,2,3,1,1,1,0,1,1,0,0,2,9,1,5,6,3,0,1,1,-1,1,1,3,1
KR_6763605436,420,0,-35,-42,7,2,2,0,0,2,2,4,4,0,1,4,3,0,1,1,0,9,-8,-3,6,3,2,0,0,-1,-1,0,1,3,1
KR_6749576153,420,2,86,0,2,-2,0,2,2,3,1,-2,0,2,3,3,0,1,2,1,0,7,0,1,1,2,0,0,0,1,-1,0,1,6,1
KR_6706509464,420,0,13,4,-2,4,4,0,3,4,1,-3,0,3,-4,0,4,-2,0,2,0,-10,5,0,4,4,-2,0,-1,1,-1,-1,-1,4,1
KR_6647989730,420,0,-30,32,-3,0,3,3,3,4,1,-1,0,1,-3,1,4,-2,0,2,-1,-7,-40,-2,6,4,-4,0,0,1,-1,0,-1,6,1
KR_6763302334,440,2,-20,-15,4,4,4,0,0,0,0,1,4,3,1,1,0,-2,0,2,1,7,20,4,5,9,1,0,0,-1,1,1,1,6,1
KR_6684907579,420,0,-3,-13,0,4,5,1,1,3,2,-4,1,5,2,5,3,-3,0,3,-1,-3,-10,-3,6,3,3,0,-1,1,-1,-1,-1,5,1
KR_6763634676,420,3,23,4,6,-3,0,3,0,2,2,5,5,0,0,1,1,4,4,0,0,12,7,4,0,4,1,0,2,1,1,1,-1,2,1
KR_6762100735,440,1,-68,-4,9,-1,1,2,2,3,1,1,2,1,5,5,0,2,3,1,0,7,2,0,2,2,-3,0,1,0,1,1,1,0,1
KR_6762985410,420,1,18,20,0,-1,3,4,-1,1,2,1,2,1,2,3,1,-1,0,1,0,2,-41,0,5,5,6,0,0,0,0,0,-1,0,1
KR_6733198781,420,6,87,7,11,4,4,0,-4,0,4,-1,2,3,8,10,2,4,4,0,0,13,13,1,2,3,4,0,1,1,0,1,-1,5,1
KR_6722625062,420,2,33,-3,5,1,3,2,2,4,2,-1,0,1,3,3,0,0,0,0,0,7,287,-2,5,3,19,0,1,-1,1,1,-1,5,1
KR_6747900707,420,0,6,-8,-3,1,1,0,0,4,4,5,5,0,-5,0,5,-4,0,4,0,-9,-14,-7,8,1,3,0,0,1,1,1,-1,3,1
KR_6725121783,440,0,-12,-6,1,-2,2,4,-4,2,6,2,2,0,7,7,0,-2,1,3,0,7,-15,3,3,6,-2,0,-1,1,-1,-1,1,2,1
KR_6763342004,420,1,23,8,4,5,6,1,-3,0,3,2,2,0,2,4,2,-2,0,2,0,-5,-4,-3,7,4,-3,0,1,1,-1,1,-1,1,1
KR_6758071161,420,3,-13,15,3,5,5,0,2,5,3,-3,2,5,2,2,0,-3,0,3,0,1,-2,-6,7,1,3,0,0,1,-1,1,1,3,1
KR_6719077147,420,7,162,35,15,0,2,2,2,4,2,7,9,2,7,8,1,-1,1,2,0,13,36,-1,5,4,3,0,1,1,-1,1,1,4,1
KR_6698608048,420,1,-42,3,-2,5,5,0,1,1,0,2,2,0,-9,3,12,-1,0,1,0,-7,-325,4,4,8,3,0,-3,1,-1,-1,-1,3,1
KR_6752166145,420,3,4,10,4,4,5,1,3,3,0,-1,0,1,0,2,2,-2,0,2,0,3,-15,3,2,5,-3,0,0,-1,1,1,-1,1,1
KR_6764392159,420,5,82,4,14,5,7,2,5,5,0,2,5,3,2,3,1,0,0,0,2,14,-16,0,4,4,5,0,1,1,1,1,1,2,1
KR_6764362739,440,0,-18,20,10,2,6,4,1,1,0,7,7,0,-2,2,4,2,2,0,0,8,13,4,0,4,-3,0,0,1,1,-1,1,3,1
KR_6763926615,420,1,65,-30,5,0,2,2,3,4,1,2,6,4,2,4,2,-2,1,3,0,14,10,2,5,7,3,0,1,-1,-1,1,-1,2,1
KR_6754319409,420,6,63,20,15,8,8,0,4,5,1,3,4,1,2,7,5,-2,1,3,0,6,1,5,0,5,3,0,3,1,1,1,1,4,1
KR_6761607506,420,-3,-53,-16,-6,-2,1,3,2,5,3,0,0,0,-4,2,6,-2,1,3,0,-4,-4,-1,7,6,1,0,-1,1,-1,-1,1,3,1
KR_6763775342,420,3,56,28,6,4,4,0,5,5,0,-2,3,5,-2,0,2,1,1,0,0,2,-3,-4,6,2,-1,0,0,1,1,1,1,4,1
KR_6414962066,420,2,24,20,-2,1,4,3,-2,2,4,-1,2,3,-1,2,3,1,4,3,0,0,-8,-3,6,3,4,0,0,-1,-1,0,-1,3,1
KR_6735245611,420,7,36,-16,13,1,3,2,6,9,3,0,4,4,3,4,1,3,4,1,1,10,14,2,5,7,-3,0,3,1,1,1,1,6,1
KR_6726832041,420,0,46,24,-1,2,3,1,1,1,0,0,1,1,-3,0,3,-1,1,2,0,-4,-1,-1,2,1,-1,0,0,-1,1,1,-1,3,1
KR_6756372558,440,4,-24,-1,9,3,7,4,5,6,1,1,3,2,2,3,1,-2,2,4,0,5,-10,-3,4,1,-1,0,1,-1,1,1,1,3,1
KR_6752320052,420,1,48,-4,-5,0,1,1,-3,0,3,-5,0,5,3,3,0,0,2,2,0,-6,-6,-2,5,3,0,0,0,1,-1,-1,-1,4,1
KR_6763112335,420,2,25,31,1,2,2,0,-4,3,7,-1,1,2,2,4,2,2,2,0,0,8,-321,6,2,8,1,0,0,1,-1,1,1,1,1
KR_6730808933,420,5,46,9,5,1,2,1,3,6,3,-3,1,4,7,8,1,-3,0,3,0,4,9,4,3,7,0,0,1,1,-1,1,1,6,1
KR_6758894619,420,0,-18,-12,2,-2,0,2,0,2,2,0,5,5,4,8,4,0,1,1,0,10,5,1,3,4,0,0,0,-1,1,1,-1,1,1
KR_6762383300,420,4,-44,5,7,0,2,2,5,6,1,0,2,2,0,4,4,2,3,1,0,7,-15,3,1,4,0,0,1,-1,1,1,-1,1,1
KR_6755792559,420,0,-18,0,4,-3,0,3,-2,5,7,2,3,1,8,11,3,-1,0,1,0,3,24,0,6,6,-3,0,-1,-1,1,-1,1,4,1
KR_6620881806,420,4,47,-8,12,4,4,0,7,8,1,-2,2,4,0,3,3,3,3,0,0,14,19,1,4,5,0,0,-1,1,-1,-1,-1,5,1
KR_6764479737,420,0,5,5,-4,1,1,0,-5,2,7,0,1,1,1,4,3,-1,2,3,1,-6,-19,2,2,4,-4,0,0,-1,1,0,1,5,1
KR_6735338472,420,-3,-54,-12,-10,-4,0,4,0,2,2,3,3,0,-8,2,10,-1,0,1,0,-7,6,1,2,3,-2,0,-2,-1,-1,-1,-1,2,1
KR_6755694716,440,7,42,56,9,4,5,1,-2,1,3,3,5,2,4,5,1,0,2,2,0,7,-1,7,3,10,-3,0,1,1,1,1,1,1,1
KR_6734271351,440,2,66,15,3,1,2,1,-4,0,4,1,1,0,4,6,2,1,1,0,0,-4,10,0,3,3,-3,0,0,1,0,0,1,4,1
KR_6638492322,420,2,41,-3,4,-1,1,2,-2,2,4,3,6,3,4,4,0,0,1,1,0,1,-5,4,2,6,-2,0,0,1,-1,-1,-1,3,1
KR_6760146970,420,2,-68,8,4,3,3,0,1,3,2,0,3,3,-4,2,6,4,4,0,0,3,-1,1,6,7,0,0,-1,1,0,-1,1,5,1
KR_6709607496,440,6,64,41,11,6,7,1,2,4,2,1,2,1,2,3,1,0,0,0,0,4,3,3,3,6,0,1,3,0,1,1,1,0,1
KR_6749051370,440,1,-26,-4,6,2,3,1,0,1,1,2,4,2,1,2,1,1,2,1,2,8,4,2,3,5,-3,0,0,-1,1,0,1,3,1
KR_6744236634,420,-1,-4,2,-5,2,3,1,-4,1,5,-2,0,2,-1,2,3,0,2,2,0,-7,113,-4,6,2,1,0,1,-1,1,1,1,4,1
KR_6740564887,420,1,1,-4,4,2,3,1,4,5,1,0,3,3,-4,3,7,2,3,1,0,2,-23,-5,10,5,5,0,1,1,0,1,1,3,1
KR_6735208444,420,2,55,9,4,-2,1,3,0,2,2,-2,1,3,6,9,3,2,3,1,0,4,5,-2,4,2,-2,0,0,-1,1,1,1,5,1
KR_6753692534,420,3,7,34,6,-1,1,2,0,2,2,7,10,3,-1,0,1,1,2,1,0,4,7,1,3,4,-2,0,3,1,1,1,1,6,1
KR_6596832852,420,3,-14,12,2,2,3,1,5,8,3,-1,1,2,-2,1,3,-2,0,2,-1,-1,1,-3,5,2,-1,0,3,-1,1,1,-1,3,1
KR_6746868167,420,1,-42,-17,7,3,3,0,1,3,2,-3,0,3,6,6,0,0,0,0,0,7,-4,1,4,5,4,0,1,-1,1,1,1,3,1
KR_6748193143,420,3,-16,24,6,2,4,2,3,3,0,1,2,1,-2,0,2,2,3,1,0,5,-1,-1,5,4,-3,0,0,0,1,-1,1,0,1
KR_6740164316,420,3,28,8,0,1,2,1,3,4,1,-2,0,2,-3,0,3,1,2,1,0,2,121,1,4,5,-2,0,0,1,1,0,-1,1,1
KR_6698425403,420,6,119,48,9,2,3,1,0,6,6,6,7,1,0,5,5,1,1,0,2,8,-6,-6,10,4,6,0,2,1,1,1,1,3,1
KR_6760665363,440,-1,-3,6,1,1,1,0,-4,1,5,1,1,0,-3,1,4,6,6,0,0,3,5,-3,6,3,-4,0,1,-1,-1,-1,1,5,1
KR_6695720645,420,-1,26,31,1,-1,1,2,0,2,2,-3,4,7,2,2,0,3,5,2,0,4,50,-2,6,4,-35,0,0,1,0,0,1,6,1
KR_6739073788,420,2,-26,24,5,-2,0,2,-3,5,8,4,5,1,5,5,0,1,1,0,0,7,6,-1,5,4,8,0,1,1,0,1,1,5,1
KR_6574513389,420,-1,-22,7,-4,-2,2,4,-3,2,5,1,1,0,-3,1,4,3,3,0,0,-3,-1,0,6,6,0,0,0,-1,0,-1,-1,1,1
KR_6660121388,420,1,80,-1,1,0,0,0,-6,1,7,1,3,2,6,7,1,0,0,0,0,2,-20,-1,5,4,4,0,2,1,-1,1,-1,3,1
KR_6680210809,420,0,25,-52,1,-2,0,2,-5,4,9,-1,1,2,7,9,2,2,2,0,-1,8,3,-7,11,4,2,0,3,-1,1,1,-1,2,1
KR_6764233317,420,0,-71,-28,2,3,4,1,3,4,1,1,1,0,-4,0,4,-1,0,1,0,0,-2,-1,6,5,2,0,-1,0,1,-1,-1,0,1
KR_6745700054,420,3,26,4,9,-3,0,3,0,2,2,11,11,0,-1,1,2,2,3,1,1,12,-2,3,4,7,-4,0,0,1,-1,-1,1,6,1
KR_6751489280,420,1,13,20,-1,-5,0,5,3,3,0,-1,0,1,1,2,1,1,2,1,0,4,-28,-5,6,1,2,0,0,0,-1,-1,1,0,1
KR_6705747865,420,3,22,8,4,-1,2,3,-1,0,1,3,4,1,3,3,0,0,0,0,-1,1,3,4,2,6,2,0,2,1,1,1,-1,1,1
KR_6762285084,420,1,81,-21,1,1,1,0,-1,3,4,2,2,0,-1,2,3,0,1,1,0,0,-30,1,5,6,2,0,0,-1,1,0,1,4,1
KR_6756168547,420,0,3,-22,-11,-1,2,3,-3,3,6,-1,1,2,-6,3,9,0,2,2,0,-9,-5,-6,6,0,-2,0,0,-1,0,0,-1,3,1
KR_6619709394,420,0,33,-16,5,-4,0,4,0,2,2,2,4,2,6,7,1,1,2,1,-1,9,12,5,4,9,-1,0,0,1,0,0,-1,6,1
KR_6741635141,420,1,25,8,1,0,0,0,-4,2,6,1,1,0,3,4,1,1,1,0,0,0,3,4,2,6,0,0,1,1,1,1,1,1,1
KR_6739901431,420,5,102,13,8,-5,1,6,4,6,2,3,3,0,2,4,2,4,5,1,3,11,0,-3,7,4,0,0,3,-1,1,1,1,5,1
KR_6744425439,420,4,31,18,1,-4,1,5,1,2,1,0,1,1,4,6,2,0,3,3,1,3,-2,4,4,8,-3,0,1,1,-1,1,1,5,1
KR_6672613811,420,4,18,56,2,0,3,3,8,9,1,-2,3,5,-2,1,3,-2,1,3,0,-12,17,-4,5,1,-2,0,1,0,1,1,1,0,1
KR_6742055451,440,0,103,20,-3,6,6,0,-3,1,4,0,2,2,-4,3,7,-2,2,4,0,-7,-9,-2,3,1,2,0,0,1,0,-1,-1,6,1
KR_6652835316,420,4,39,4,10,3,3,0,4,5,1,1,1,0,1,3,2,1,1,0,0,6,17,-1,6,5,0,0,0,-1,1,1,1,2,1
KR_6761831465,440,5,85,33,19,4,5,1,4,4,0,0,6,6,10,14,4,1,1,0,3,19,-3,4,1,5,6,0,3,1,1,1,1,5,1
KR_6688768403,420,2,-34,32,2,1,1,0,1,4,3,-5,7,12,2,3,1,3,4,1,0,7,-8,2,4,6,21,0,0,-1,1,1,1,6,1
KR_6729032374,440,3,42,30,6,1,1,0,-2,2,4,1,5,4,-1,3,4,7,8,1,3,18,-5,-6,7,1,5,0,1,1,-1,1,1,6,1
KR_6761482460,420,0,27,4,2,7,7,0,-5,2,7,0,4,4,1,2,1,-1,0,1,1,-7,20,2,1,3,2,0,1,1,0,1,1,4,1
KR_6760207109,420,2,20,24,4,2,3,1,4,6,2,0,3,3,-1,1,2,-1,0,1,0,2,0,-2,6,4,1,0,1,1,1,1,1,6,1
KR_6733307004,440,3,46,-9,13,-2,1,3,2,4,2,4,6,2,3,6,3,6,8,2,0,8,-2,0,3,3,2,0,0,0,-1,0,-1,0,1
KR_6739799893,420,1,-46,-19,7,4,6,2,0,3,3,3,4,1,-1,2,3,1,3,2,-1,8,-30,-5,8,3,9,0,-1,-1,-1,-1,-1,2,1
KR_6763112985,420,4,25,-16,7,4,5,1,-2,0,2,1,5,4,3,3,0,1,2,1,1,6,2,4,5,9,-4,0,1,1,1,1,1,2,1
KR_6739243961,420,-1,-10,-8,1,2,3,1,-1,1,2,-3,2,5,3,6,3,0,3,3,0,4,5,0,3,3,-2,0,1,1,1,1,-1,2,1
KR_6755474264,420,2,71,17,8,0,2,2,2,5,3,1,1,0,6,7,1,-1,1,2,1,8,-6,2,1,3,1,0,0,0,1,1,-1,0,1
KR_6728078343,420,1,-20,5,4,-1,2,3,-1,2,3,1,1,0,5,7,2,0,1,1,0,8,-1,0,5,5,3,0,-1,0,-1,-1,1,0,1
KR_6706161152,420,2,3,-4,7,-1,1,2,3,3,0,-1,3,4,1,2,1,5,5,0,0,5,9,3,2,5,-2,0,1,1,-1,1,-1,6,1
KR_6763227268,420,-3,-26,-28,-2,-5,0,5,3,3,0,-1,0,1,1,1,0,0,0,0,0,-1,3,-2,7,5,0,0,0,-1,-1,0,1,4,1
KR_6683581297,440,6,129,26,11,-2,1,3,2,5,3,5,8,3,4,5,1,2,3,1,3,12,-5,-5,7,2,2,0,0,1,1,1,1,2,1
KR_6763534633,420,-1,33,-20,-3,-3,1,4,-3,1,4,-1,2,3,4,6,2,0,1,1,0,-7,8,-1,8,7,-2,0,0,-1,1,1,1,3,1
KR_6694794386,420,-4,-69,-20,0,-2,1,3,2,3,1,0,3,3,1,3,2,-1,1,2,0,0,6,-2,4,2,2,0,0,1,1,0,1,4,1
KR_6639369046,420,1,64,24,2,2,2,0,2,8,6,0,1,1,-2,1,3,0,0,0,0,-6,65,2,4,6,-2,0,1,-1,-1,1,1,5,1
KR_6752218922,420,4,82,19,8,0,4,4,-2,2,4,3,3,0,4,5,1,3,3,0,0,7,1,4,2,6,3,0,2,1,1,1,1,4,1
KR_6704107937,420,3,87,13,5,7,7,0,-1,3,4,0,2,2,-2,4,6,1,2,1,0,-9,-7,-2,5,3,1,0,2,1,1,1,-1,3,1
KR_6763541958,420,5,44,0,4,3,4,1,0,1,1,-1,4,5,1,3,2,1,2,1,-1,7,56,2,4,6,2,0,0,-1,1,1,-1,4,1
KR_6758967267,440,5,-14,13,16,6,6,0,-2,3,5,1,3,2,10,10,0,1,2,1,0,11,-1,1,2,3,2,0,1,1,1,1,-1,2,1
KR_6762496647,420,0,23,-56,0,7,7,0,-4,0,4,-3,2,5,0,1,1,0,0,0,0,4,8,3,3,6,-4,0,1,1,-1,1,1,6,1
KR_6761105721,420,1,40,12,2,-1,1,2,0,3,3,4,4,0,-1,2,3,0,1,1,1,6,12,-1,9,8,3,0,0,1,-1,0,1,6,1
KR_6653179789,420,-2,12,-4,1,1,2,1,2,2,0,-3,1,4,2,2,0,-1,0,1,0,6,-22,4,1,5,2,0,1,1,1,1,1,4,1
KR_6357082756,420,0,6,4,2,0,1,1,0,5,5,-1,1,2,3,3,0,0,0,0,0,8,0,0,0,0,13,0,0,1,-1,0,-1,3,1
KR_6761716139,420,1,3,7,6,9,10,1,1,4,3,1,2,1,-6,2,8,1,2,1,-1,1,4,2,4,6,1,0,1,1,1,1,-1,2,1
KR_6749216060,420,3,117,4,-1,-1,2,3,0,5,5,-1,1,2,2,2,0,-1,0,1,0,0,2,-1,4,3,1,0,0,1,0,0,-1,4,1
KR_6603758924,420,5,71,-30,10,3,3,0,1,1,0,-1,3,4,5,7,2,2,3,1,0,16,-148,4,2,6,1,0,-1,1,-1,-1,1,2,1
KR_6762368982,420,-2,-19,12,-5,-1,3,4,1,4,3,-3,1,4,-2,0,2,0,0,0,0,-8,12,3,4,7,0,0,0,-1,1,0,-1,5,1
KR_6757064737,420,-1,18,32,8,0,2,2,2,4,2,2,2,0,5,7,2,-1,4,5,1,12,-2,3,1,4,0,0,0,1,0,0,1,3,1
KR_6710279339,420,5,94,4,9,4,4,0,3,3,0,2,2,0,3,5,2,-3,0,3,0,6,0,0,5,5,5,0,1,0,1,1,1,0,1
KR_6740615898,420,0,23,12,3,-2,2,4,1,6,5,-1,4,5,0,3,3,5,6,1,0,5,5,1,3,4,-2,0,1,-1,-1,1,1,1,1
KR_6414475037,420,6,84,25,18,7,7,0,-1,0,1,4,5,1,7,7,0,1,1,0,0,12,12,-2,2,0,0,0,3,1,0,1,1,4,1
KR_6720134990,420,1,4,18,1,2,3,1,-1,2,3,-1,2,3,2,4,2,-1,1,2,0,-1,20,-1,2,1,3,0,0,1,1,-1,1,1,1
KR_6759545047,420,0,-19,13,1,-2,0,2,0,1,1,5,5,0,-1,0,1,-1,0,1,0,6,-1,-3,8,5,2,0,-1,-1,1,-1,1,6,1
KR_6756539208,420,1,-60,22,4,1,2,1,-1,1,2,-2,3,5,4,8,4,2,3,1,0,-8,1,-1,4,3,-4,0,0,-1,1,0,-1,5,1
KR_6749563264,420,7,61,10,13,-1,1,2,4,4,0,3,3,0,5,6,1,2,2,0,0,11,9,3,3,6,-5,0,1,-1,1,1,1,4,1
KR_6713966568,420,4,119,17,5,-2,0,2,4,4,0,3,5,2,1,2,1,-1,0,1,0,1,-26,-1,4,3,8,0,1,1,0,1,1,2,1
KR_6747489906,440,-3,-23,10,0,-6,0,6,2,4,2,5,7,2,-2,3,5,1,1,0,0,1,45,-1,4,3,-19,0,0,1,0,0,-1,1,1
KR_6639406463,420,4,77,-10,3,2,4,2,0,3,3,-1,0,1,1,2,1,1,3,2,0,1,4,2,5,7,3,0,1,1,0,1,1,6,1
KR_6648345959,420,3,10,12,2,-1,2,3,-1,2,3,1,2,1,3,4,1,0,1,1,0,5,8,5,2,7,-2,0,0,1,-1,0,1,2,1
KR_6665272254,420,1,-25,-1,-2,-2,0,2,-2,1,3,0,2,2,1,2,1,1,1,0,0,4,-6,-3,7,4,-4,0,0,-1,-1,-1,-1,3,1
KR_6746069738,420,1,6,8,4,1,1,0,7,8,1,2,4,2,-3,0,3,-3,1,4,0,8,3,0,6,6,-5,0,-1,1,-1,-1,-1,2,1
KR_6671639942,420,-1,45,6,2,-2,2,4,1,4,3,-2,1,3,3,4,1,2,2,0,0,3,-205,-1,3,2,-14,0,0,-1,1,1,1,4,1
KR_6757964879,420,1,-4,0,1,0,1,1,-2,1,3,2,3,1,5,8,3,-4,0,4,0,-10,-6,-2,6,4,2,0,0,1,1,1,1,3,1
KR_6758377065,420,1,35,27,1,1,3,2,-2,1,3,2,5,3,0,7,7,0,0,0,0,-4,-2,-1,4,3,3,0,0,-1,1,1,-1,4,1
KR_6728945022,440,2,28,16,3,2,2,0,-1,3,4,1,2,1,-1,2,3,2,6,4,0,3,-1,3,3,6,-1,0,0,-1,1,0,1,2,1
KR_6752293653,420,-1,9,20,7,0,2,2,4,5,1,3,4,1,2,6,4,-2,0,2,0,13,1,3,2,5,-1,0,-1,1,-1,-1,1,3,1
KR_6760482815,420,2,24,0,5,1,3,2,4,4,0,2,3,1,3,6,3,-5,2,7,0,8,-5,-1,5,4,9,0,0,-1,1,-1,1,1,1
KR_6731186315,420,1,29,36,0,2,2,0,2,4,2,1,1,0,-4,2,6,-1,0,1,0,2,119,6,3,9,-2,0,0,1,1,1,1,6,1
KR_6666429759,420,1,6,-11,4,1,5,4,-3,0,3,3,7,4,2,4,2,1,1,0,0,12,4,0,8,8,-3,0,-1,1,-1,-1,1,1,1
KR_6754430823,420,5,32,-19,9,-1,2,3,0,1,1,8,8,0,4,5,1,-2,1,3,0,3,8,3,4,7,3,0,1,1,1,1,1,5,1
KR_6763697824,420,2,2,24,7,0,2,2,0,1,1,3,5,2,2,3,1,2,4,2,0,13,-54,-6,10,4,36,0,2,-1,1,1,1,6,1
KR_6761160994,420,1,36,6,12,1,2,1,4,4,0,3,6,3,3,3,0,1,1,0,1,14,0,-2,5,3,2,0,0,-1,1,0,1,4,1
KR_6688313050,420,-2,61,-23,-4,-4,0,4,-1,3,4,-1,2,3,2,2,0,0,2,2,1,-9,-178,1,5,6,-11,0,0,1,-1,-1,1,1,1
KR_6522325443,420,5,80,44,12,2,3,1,0,2,2,2,3,1,6,8,2,2,2,0,0,13,-9,-2,2,0,-1,0,2,1,1,1,1,3,1
KR_6757623018,420,-3,-25,-72,-8,1,5,4,0,2,2,-5,1,6,-2,1,3,-2,0,2,0,-6,4,2,0,2,-2,0,0,-1,-1,1,1,5,1
KR_6728711748,440,1,-29,17,-1,3,4,1,4,5,1,0,1,1,-4,0,4,-4,1,5,0,1,-12,-1,4,3,3,0,0,1,0,-1,-1,5,1
KR_6761575753,420,4,34,32,1,1,3,2,0,2,2,-3,0,3,6,7,1,-3,0,3,0,1,-321,-1,2,1,1,0,2,1,1,1,-1,6,1
KR_6438739965,420,2,59,15,7,0,2,2,4,5,1,-1,0,1,2,3,1,2,2,0,0,10,308,0,4,4,2,0,0,1,1,-1,1,6,1
KR_6677246400,420,9,141,59,21,5,5,0,2,4,2,4,6,2,2,3,1,8,9,1,0,16,47,1,4,5,-22,0,3,1,1,1,1,5,1
KR_6765015287,420,0,80,-4,-3,2,2,0,-4,0,4,1,1,0,-4,0,4,2,2,0,0,-5,4,1,3,4,-8,0,1,1,1,1,1,4,1
KR_6757824748,420,4,64,8,-1,1,2,1,-1,1,2,-2,2,4,0,4,4,1,2,1,0,-6,5,-3,8,5,3,0,0,1,-1,0,1,3,1
KR_6756912242,420,-3,-38,-8,-15,-2,1,3,-6,0,6,-3,2,5,-2,2,4,-2,2,4,0,-18,4,-6,7,1,0,0,-1,-1,0,-1,-1,2,1
KR_6724934182,420,1,57,-12,5,-3,1,4,0,2,2,3,4,1,-1,1,2,6,7,1,0,5,47,1,3,4,-28,0,1,-1,1,1,1,1,1
KR_6755411246,420,2,1,-5,7,3,6,3,-2,2,4,5,6,1,2,4,2,-1,1,2,0,11,-12,6,2,8,0,0,3,1,1,1,1,1,1
KR_6764373256,420,-1,33,-20,1,3,4,1,-3,0,3,-1,1,2,2,4,2,0,1,1,0,0,0,-3,5,2,-2,0,1,1,-1,1,1,1,1
KR_6763482680,440,4,78,53,7,1,3,2,2,6,4,0,2,2,1,5,4,3,6,3,0,4,3,2,1,3,0,0,0,0,0,1,1,0,1
KR_6747408112,420,5,31,12,4,-3,2,5,2,3,1,1,1,0,5,7,2,-1,1,2,0,4,7,-2,4,2,-1,0,1,1,1,1,-1,4,1
KR_6739803995,420,0,-82,33,5,3,3,0,4,7,3,0,1,1,0,3,3,-2,0,2,0,6,6,1,6,7,-2,0,-1,1,-1,-1,-1,4,1
KR_6622583110,420,-1,30,5,3,-2,1,3,1,3,2,2,4,2,2,3,1,0,3,3,0,0,-3,0,3,3,1,0,0,1,-1,0,1,5,1
KR_6714037227,420,2,28,25,6,-1,0,1,4,7,3,3,4,1,-1,0,1,1,1,0,0,2,29,0,6,6,-2,0,0,1,-1,1,1,6,1
KR_6763359066,440,3,31,8,7,1,3,2,1,4,3,4,5,1,0,1,1,1,3,2,0,12,2,2,1,3,-2,0,0,1,0,0,-1,5,1
KR_6748539469,420,1,47,5,-2,0,1,1,-5,1,6,1,3,2,2,5,3,0,0,0,0,3,-5,-4,10,6,0,0,1,-1,1,1,-1,6,1
KR_6734991528,420,4,13,12,11,1,2,1,-1,0,1,9,9,0,2,3,1,0,1,1,0,10,-110,0,4,4,2,0,1,-1,1,1,1,4,1
KR_6662063872,420,3,-54,17,4,1,1,0,4,5,1,1,2,1,-2,0,2,0,0,0,0,7,101,0,2,2,2,0,0,0,1,1,1,0,1
KR_6763339233,420,-1,57,24,1,0,0,0,-1,2,3,0,0,0,3,5,2,-1,0,1,0,2,2,3,3,6,-3,0,0,-1,1,0,-1,1,1
KR_6763319448,420,-1,2,8,2,2,2,0,2,3,1,-2,0,2,-1,1,2,1,6,5,0,6,-2,-1,4,3,19,0,0,1,0,0,-1,4,1
KR_6692160281,420,6,46,28,8,-1,2,3,4,4,0,5,6,1,1,2,1,-1,3,4,0,8,8,2,2,4,4,0,-1,1,-1,-1,1,3,1
KR_6758060499,420,1,-25,28,6,3,4,1,0,2,2,-1,1,2,4,4,0,0,1,1,0,2,6,0,6,6,0,0,0,0,1,1,1,0,1
KR_6721857980,440,0,-39,-4,-8,-2,1,3,-5,1,6,1,2,1,-1,2,3,-1,2,3,0,-1,255,2,3,5,-4,0,0,-1,-1,-1,-1,4,1
KR_6741839440,420,4,87,24,13,-1,1,2,8,10,2,2,3,1,4,5,1,0,1,1,0,19,-18,3,4,7,-1,0,2,1,1,1,1,5,1
KR_6764686976,420,-1,-56,0,-2,3,3,0,-6,1,7,2,3,1,-2,2,4,1,1,0,0,-7,-3,6,3,9,-1,0,0,-1,-1,0,-1,3,1
KR_6728825516,440,-1,-54,3,0,-1,1,2,0,6,6,2,2,0,3,5,2,-4,1,5,0,11,2,3,1,4,-1,0,0,1,1,-1,-1,2,1
KR_6760859213,420,2,-8,4,9,1,2,1,-1,3,4,8,8,0,1,2,1,0,1,1,0,3,8,2,2,4,-3,0,1,1,1,1,1,5,1
KR_6764378706,420,3,-37,17,6,0,2,2,6,8,2,4,4,0,-4,4,8,0,1,1,-1,1,1,0,6,6,3,0,2,-1,1,1,-1,3,1
KR_6673520220,420,3,22,56,0,1,3,2,-1,3,4,-3,0,3,1,2,1,2,3,1,1,-1,1,2,4,6,3,0,2,0,1,1,1,0,1
KR_6757160549,420,0,5,-7,2,-2,2,4,1,4,3,2,4,2,0,4,4,1,2,1,1,6,-77,0,4,4,21,0,-1,1,-1,-1,1,5,1
KR_6747416212,420,-1,-23,1,1,0,1,1,0,1,1,-3,2,5,7,9,2,-3,0,3,0,13,2,-2,6,4,1,0,-1,-1,-1,-1,-1,6,1
KR_6689180594,420,3,36,24,-3,1,4,3,-1,2,3,0,4,4,-3,1,4,0,3,3,0,-6,-9,-4,8,4,4,0,0,1,-1,-1,-1,2,1
KR_6671796064,420,2,73,-11,7,-1,1,2,2,5,3,4,4,0,2,4,2,0,0,0,0,7,-1,0,4,4,2,0,0,0,0,0,1,0,1
KR_6746378338,420,4,102,-16,11,-1,2,3,1,1,0,0,0,0,6,6,0,5,7,2,0,16,-1,-6,8,2,3,0,2,1,-1,1,1,2,1
KR_6752034750,420,3,47,32,0,-2,1,3,5,5,0,-1,0,1,-3,1,4,1,2,1,0,-4,-6,-8,8,0,-1,0,0,1,1,0,1,4,1
KR_6676815313,440,1,-43,38,4,-1,0,1,1,2,1,2,4,2,4,8,4,-2,0,2,0,4,26,0,5,5,-21,0,1,1,1,1,1,2,1
KR_6742159022,420,3,105,16,1,0,1,1,-2,0,2,-4,2,6,6,6,0,1,1,0,0,1,3,0,3,3,4,0,0,1,-1,-1,1,4,1
KR_6740160229,420,1,39,-23,6,0,0,0,2,3,1,-1,3,4,3,4,1,2,2,0,0,1,-7,1,4,5,3,0,1,1,0,1,1,3,1
KR_6519319546,420,0,69,-5,3,4,5,1,0,2,2,-1,2,3,1,5,4,-1,0,1,0,10,7,6,2,8,-2,0,-1,-1,-1,-1,1,2,1
KR_6695088695,420,0,63,13,1,-1,0,1,-1,1,2,2,2,0,0,2,2,1,1,0,0,1,1,5,2,7,-1,0,0,1,-1,0,1,4,1
KR_6681149415,420,2,-20,-12,3,0,2,2,0,1,1,1,3,2,1,1,0,1,2,1,0,3,-5,-1,9,8,2,0,0,-1,-1,0,1,1,1
KR_6737584905,420,-5,-91,-4,-11,-1,2,3,-1,2,3,-5,0,5,-1,5,6,-3,0,3,-1,-6,-231,1,1,2,-1,0,-1,1,-1,-1,-1,6,1
KR_6747509493,420,9,110,57,17,2,2,0,2,4,2,9,11,2,4,7,3,0,0,0,0,24,-111,-1,5,4,6,0,2,1,-1,1,1,5,1
KR_6740950158,420,1,80,-32,13,1,3,2,3,5,2,8,9,1,3,5,2,-2,0,2,2,11,-226,4,2,6,-4,0,1,1,-1,1,1,1,1
KR_6759982583,420,2,53,16,-1,-2,0,2,0,1,1,-5,0,5,4,6,2,2,2,0,0,3,-39,5,3,8,5,0,-1,1,-1,-1,1,4,1
KR_6667716720,420,-1,-49,-8,5,-3,0,3,0,2,2,2,4,2,3,3,0,3,4,1,0,11,-107,-3,10,7,3,0,0,0,1,0,-1,0,1
KR_6744664702,420,1,-29,8,-1,-1,1,2,1,4,3,-2,0,2,0,3,3,1,2,1,0,0,-90,-8,15,7,-1,0,0,-1,1,0,-1,2,1
KR_6731405339,420,5,113,13,13,-1,1,2,3,3,0,1,2,1,6,6,0,4,4,0,0,12,456,3,1,4,3,0,0,1,-1,-1,1,3,1
KR_6634101168,420,1,39,8,2,0,1,1,0,4,4,-2,2,4,2,4,2,2,2,0,0,2,144,2,3,5,2,0,1,1,1,1,1,1,1
KR_6753726939,420,1,2,68,-1,-2,0,2,4,4,0,2,3,1,-4,1,5,-1,1,2,1,-3,-217,-2,4,2,0,0,0,1,-1,1,1,5,1
KR_6659949276,420,2,-14,16,2,4,5,1,0,2,2,3,4,1,-5,1,6,0,0,0,-1,-2,-2,-1,5,4,6,0,2,1,1,1,-1,4,1
KR_6741276252,440,3,-14,16,11,0,2,2,1,3,2,2,5,3,6,8,2,2,2,0,-1,7,4,3,0,3,0,0,1,-1,1,1,-1,2,1
KR_6724702779,440,0,59,65,4,0,1,1,2,3,1,0,3,3,2,2,0,0,1,1,0,13,-7,-1,4,3,1,0,2,1,1,1,-1,1,1
KR_6733593618,420,1,-7,24,2,-2,0,2,1,2,1,-1,2,3,2,3,1,2,2,0,0,0,-7,1,2,3,0,0,1,1,1,1,1,4,1
KR_6759408185,420,5,104,-10,10,-1,0,1,4,5,1,3,4,1,1,2,1,3,3,0,0,10,198,1,3,4,-1,0,1,-1,1,1,1,6,1
KR_6713280674,420,2,19,-28,2,3,3,0,-1,2,3,-1,1,2,2,6,4,-1,0,1,-2,4,-2,3,6,9,1,0,1,-1,1,-1,-1,4,1
KR_6742855957,420,2,21,16,9,0,2,2,2,4,2,4,5,1,3,3,0,0,0,0,0,12,8,6,3,9,1,0,1,1,1,1,1,1,1
KR_6764936411,440,4,98,-8,8,2,2,0,1,4,3,2,2,0,0,3,3,3,4,1,0,9,-8,-5,8,3,4,0,1,1,1,1,-1,1,1
KR_6634794220,420,3,47,14,5,-2,0,2,3,3,0,2,2,0,1,2,1,1,2,1,0,4,-6,-2,6,4,0,0,0,1,1,1,1,1,1
KR_6734894434,420,1,-2,4,0,-2,1,3,3,4,1,0,3,3,-3,2,5,2,2,0,0,0,111,6,3,9,1,0,0,1,1,0,-1,1,1
KR_6662601505,420,1,-33,-14,3,-2,2,4,1,1,0,3,6,3,0,2,2,1,1,0,0,3,-2,-1,6,5,4,0,-1,0,0,-1,-1,0,1
KR_6683015632,420,1,0,-8,-3,1,1,0,0,2,2,1,2,1,-3,1,4,-2,1,3,0,-2,-128,-6,7,1,2,0,0,-1,1,-1,-1,1,1
KR_6704872371,420,-3,-31,-20,-1,0,1,1,3,4,1,-4,0,4,-1,3,4,1,2,1,-1,-2,-5,-4,6,2,-4,0,-2,-1,-1,-1,-1,4,1
KR_6695045601,420,5,96,-4,7,2,3,1,1,1,0,2,4,2,0,0,0,2,2,0,-1,9,119,4,2,6,3,0,2,1,1,1,-1,4,1
KR_6738387830,420,5,80,0,10,0,2,2,0,1,1,0,1,1,6,7,1,4,5,1,0,9,41,0,5,5,2,0,1,1,1,1,1,3,1
KR_6661814915,440,1,17,-24,6,-3,2,5,2,3,1,3,6,3,-1,6,7,5,7,2,-1,9,5,2,4,6,4,0,2,1,-1,1,-1,2,1
KR_6668271422,420,3,32,-8,4,2,2,0,-9,0,9,7,11,4,3,3,0,1,1,0,0,-1,-141,1,4,5,-3,0,2,1,1,1,1,3,1
KR_6731516964,420,3,-29,4,12,3,3,0,4,5,1,2,2,0,1,6,5,2,2,0,0,12,-8,4,3,7,1,0,0,1,0,0,1,3,1
KR_6668829839,420,-4,-52,-17,-5,4,5,1,-2,1,3,1,2,1,-8,0,8,0,0,0,0,-11,275,0,3,3,-2,0,-2,-1,-1,-1,1,3,1
KR_6612227687,420,-1,-11,4,-1,-1,0,1,5,7,2,0,1,1,-6,1,7,1,2,1,0,-1,-1,-1,3,2,-1,0,-1,1,-1,-1,1,3,1
KR_6757063434,440,0,-43,17,5,-5,1,6,14,14,0,1,3,2,-3,0,3,-2,0,2,0,1,3,-2,7,5,-4,0,-1,1,1,1,1,4,1
KR_6644032423,420,0,-17,28,4,-1,2,3,0,3,3,-1,3,4,4,6,2,2,2,0,0,11,13,-2,7,5,-2,0,0,1,1,1,-1,2,1
KR_6733968537,420,2,26,9,-1,-2,0,2,0,2,2,1,4,3,-2,3,5,2,4,2,0,-11,10,1,2,3,-3,0,2,1,1,1,-1,2,1
KR_6741458988,420,4,28,-11,13,2,2,0,3,5,2,1,2,1,6,8,2,1,1,0,0,8,-3,-8,10,2,6,0,2,-1,1,1,1,2,1
KR_6720101859,420,3,11,16,1,3,3,0,-2,1,3,0,1,1,1,1,0,-1,1,2,0,-3,124,-1,3,2,0,0,0,1,-1,0,-1,6,1
KR_6612447490,420,-2,64,-28,-6,-2,1,3,-1,0,1,-3,0,3,0,2,2,0,1,1,1,-2,9,1,2,3,0,0,-1,-1,-1,-1,1,6,1
KR_6718095195,420,4,52,4,1,0,2,2,-3,3,6,2,4,2,2,3,1,0,1,1,0,-1,-38,-5,7,2,14,0,1,1,1,1,1,4,1
KR_6756627619,420,3,-16,7,1,2,3,1,7,8,1,0,5,5,-7,1,8,-1,0,1,-2,6,-4,-1,4,3,-3,0,-1,1,-1,-1,-1,1,1
KR_6752286635,420,3,60,22,5,5,7,2,0,0,0,-3,2,5,1,4,3,2,2,0,0,6,3,4,1,5,3,0,2,1,1,1,1,4,1
KR_6761632636,420,0,32,4,0,-1,2,3,-1,0,1,-2,0,2,2,6,4,2,3,1,-1,4,12,-1,8,7,3,0,1,-1,0,1,-1,1,1
KR_6736059742,420,2,85,24,7,0,1,1,5,7,2,1,4,3,3,4,1,-2,1,3,1,6,-131,5,1,6,-6,0,1,1,1,1,1,1,1
KR_6652856831,420,1,-15,29,7,2,2,0,1,4,3,3,5,2,1,1,0,0,0,0,0,3,-3,0,3,3,-2,0,1,1,1,1,1,2,1
KR_6676715678,440,4,104,43,9,-1,1,2,7,8,1,3,3,0,0,2,2,0,1,1,-1,2,5,-1,7,6,3,0,1,1,0,1,-1,5,1
KR_6764384910,420,4,81,28,11,2,3,1,8,9,1,0,4,4,2,5,3,-1,0,1,0,1,23,-1,7,6,5,0,0,1,-1,-1,-1,5,1
KR_6694403133,420,2,-3,-8,4,-1,1,2,5,6,1,1,4,3,1,3,2,-2,1,3,0,3,-1,2,3,5,-1,0,0,-1,1,-1,-1,6,1
KR_6762827650,440,1,35,24,-1,-4,1,5,0,5,5,1,2,1,0,0,0,2,2,0,0,-1,0,1,3,4,0,0,1,-1,1,1,-1,5,1
KR_6730734847,420,-2,11,-4,-5,-5,2,7,-1,0,1,4,5,1,-2,1,3,-1,0,1,0,-5,5,2,6,8,1,0,1,1,1,-1,1,3,1
KR_6728443559,420,-1,-7,-29,-2,-2,2,4,0,6,6,-1,1,2,1,4,3,0,1,1,0,0,96,6,3,9,-1,0,-1,1,-1,-1,1,2,1
KR_6735257502,420,0,-6,-8,2,3,3,0,0,5,5,-1,0,1,-3,2,5,3,3,0,0,3,8,1,7,8,-1,0,0,-1,1,0,1,5,1
KR_6735319387,420,1,52,-4,4,-1,1,2,1,5,4,-2,0,2,2,4,2,4,4,0,0,5,51,-3,6,3,0,0,1,1,-1,1,-1,3,1
KR_6732635181,420,4,43,-5,11,3,3,0,1,1,0,-1,1,2,2,4,2,6,7,1,0,5,4,0,2,2,-3,0,0,-1,-1,1,1,6,1
KR_6763564621,420,-2,-20,-9,-3,-3,0,3,-2,2,4,-2,1,3,2,5,3,2,2,0,0,1,-9,5,2,7,0,0,0,-1,1,0,1,5,1
KR_6697053137,420,1,27,0,-6,-3,1,4,1,5,4,-2,1,3,-1,2,3,-1,0,1,0,-10,16,-3,6,3,-20,0,-1,-1,-1,-1,-1,2,1
KR_6757039651,420,3,82,19,6,1,2,1,4,4,0,1,5,4,2,4,2,-2,1,3,0,8,2,2,3,5,1,0,0,1,1,1,1,6,1
KR_6752231731,420,-2,-5,-10,-4,0,2,2,-2,1,3,-5,2,7,2,3,1,1,1,0,-1,-2,-1,-1,6,5,-2,0,0,-1,1,0,-1,4,1
KR_6625888616,420,5,42,16,11,3,5,2,-2,3,5,5,5,0,2,7,5,3,3,0,1,5,222,-3,8,5,4,0,1,1,1,1,1,1,1
KR_6745320248,420,0,-10,-15,5,0,2,2,1,2,1,4,5,1,1,2,1,-1,1,2,0,6,-9,-1,7,6,4,0,0,-1,0,0,1,1,1
KR_6755364460,420,1,36,-9,1,0,1,1,0,2,2,0,2,2,-2,1,3,3,3,0,0,2,-3,-2,6,4,-5,0,0,-1,1,-1,1,1,1
KR_6725805326,420,1,-14,-7,2,1,2,1,1,4,3,1,3,2,-2,2,4,1,1,0,-1,-4,-7,5,3,8,-2,0,0,1,1,0,-1,6,1
KR_6749307524,420,1,0,20,5,4,4,0,-3,0,3,7,8,1,-1,1,2,-2,0,2,0,0,6,0,8,8,3,0,0,1,1,-1,1,3,1
KR_6695149139,420,4,56,12,4,4,5,1,-1,4,5,0,1,1,0,2,2,1,1,0,0,-6,-8,-2,3,1,1,0,1,1,-1,1,-1,1,1
KR_6692150101,420,0,-15,-8,-2,0,2,2,-2,2,4,2,4,2,-2,2,4,0,4,4,1,-6,235,-3,4,1,-2,0,-1,-1,-1,-1,1,1,1
KR_6746467011,420,1,-9,24,6,-1,3,4,-1,1,2,-2,1,3,7,7,0,3,3,0,0,7,-6,1,2,3,-1,0,1,-1,-1,-1,-1,6,1
KR_6758561775,440,4,51,8,11,4,4,0,7,10,3,3,5,2,-2,0,2,-1,0,1,0,7,-41,2,1,3,28,0,1,-1,1,1,1,1,1
KR_6761653922,420,-3,-53,-7,-4,-5,2,7,0,4,4,2,3,1,0,3,3,-1,0,1,0,2,-55,1,5,6,-4,0,-1,1,-1,-1,1,3,1
KR_6736531095,420,3,75,15,9,1,3,2,0,5,5,2,3,1,5,5,0,1,1,0,3,13,-3,2,3,5,4,0,2,-1,1,1,1,2,1
KR_6718002317,440,2,71,16,6,2,4,2,0,3,3,7,8,1,-3,2,5,0,1,1,1,14,-4,2,2,4,1,0,1,1,-1,-1,1,4,1
KR_6745617244,420,0,-57,8,-6,0,3,3,-2,1,3,-2,3,5,0,1,1,-2,3,5,0,-1,-1,1,2,3,1,0,-2,0,0,-1,1,0,1
KR_6675381342,420,2,1,8,6,-2,1,3,8,8,0,-2,1,3,2,4,2,0,1,1,-1,11,2,1,5,6,1,0,0,1,-1,-1,-1,6,1
KR_6758841506,420,4,51,0,11,5,5,0,0,3,3,3,3,0,3,3,0,0,0,0,0,11,-2,-2,5,3,3,0,2,1,1,1,-1,6,1
KR_6737882353,420,3,6,-26,9,0,2,2,5,9,4,-2,3,5,6,10,4,0,0,0,-2,5,-10,2,3,5,2,0,0,0,1,1,-1,0,1
KR_6395267860,420,4,96,9,11,0,2,2,5,6,1,-1,1,2,4,6,2,3,3,0,0,12,10,3,1,4,0,0,1,1,1,1,-1,5,1
KR_6762755203,420,3,65,12,4,1,3,2,-1,2,3,6,7,1,-2,0,2,0,0,0,0,-8,-2,-1,4,3,3,0,2,1,1,1,1,1,1
KR_6700531053,420,-2,15,10,-8,-3,3,6,0,4,4,-4,2,6,-1,1,2,0,0,0,-2,-9,14,6,3,9,-1,0,0,0,0,0,-1,0,1
KR_6747340600,420,9,48,25,14,0,0,0,4,8,4,6,6,0,2,3,1,2,3,1,0,18,82,4,3,7,0,0,1,-1,-1,1,-1,2,1
KR_6695012671,420,6,72,0,14,2,2,0,-1,2,3,3,4,1,10,10,0,0,1,1,0,14,2,-1,4,3,1,0,0,1,1,1,1,5,1
KR_6758234003,420,2,14,24,-2,-3,1,4,0,2,2,-3,0,3,3,6,3,1,2,1,0,-3,0,1,4,5,2,0,2,1,1,1,1,6,1
KR_6737266790,420,1,32,-33,4,5,5,0,-2,2,4,0,1,1,1,2,1,0,0,0,0,1,-6,-2,5,3,-1,0,0,1,1,1,1,3,1
KR_6709565856,440,0,-10,-16,1,-4,0,4,-1,1,2,2,6,4,3,3,0,1,2,1,0,7,0,1,6,7,-1,0,1,1,-1,1,1,1,1
KR_6732098210,420,2,23,3,0,1,1,0,2,2,0,5,6,1,-7,2,9,-1,0,1,0,2,-1,0,4,4,-1,0,0,1,0,1,1,3,1
KR_6691847105,420,3,117,-12,6,1,1,0,-3,2,5,4,5,1,3,9,6,1,1,0,0,1,33,-2,9,7,-1,0,1,1,-1,1,1,1,1
KR_6758157092,420,1,26,0,4,4,4,0,3,3,0,0,3,3,-2,2,4,-1,0,1,0,-4,-1,1,6,7,2,0,-1,1,-1,-1,-1,3,1
KR_6729656544,420,1,21,-16,5,1,2,1,-2,3,5,-1,0,1,6,6,0,1,2,1,0,12,105,3,2,5,0,0,0,0,0,1,1,0,1
KR_6763323999,420,1,21,-4,1,0,1,1,1,5,4,-1,4,5,3,3,0,-2,1,3,1,-4,-83,1,3,4,-1,0,0,-1,1,1,1,1,1
KR_6674488568,420,2,27,-1,12,2,4,2,3,5,2,0,0,0,2,4,2,5,5,0,0,8,-2,-1,7,6,5,0,0,1,1,1,1,6,1
KR_6743170105,420,-1,-85,-26,1,3,3,0,-4,2,6,1,1,0,0,4,4,1,2,1,-1,0,10,0,5,5,2,0,0,1,-1,-1,-1,4,1
KR_6727645049,420,0,17,3,8,5,8,3,6,8,2,-3,1,4,1,5,4,-1,0,1,0,-2,-113,5,0,5,1,0,2,1,1,1,1,1,1
KR_6754934596,420,6,82,36,9,2,4,2,1,2,1,1,2,1,5,8,3,0,1,1,0,-1,-15,4,1,5,-1,0,0,1,-1,0,1,5,1
KR_6763880257,420,-1,-57,7,5,3,5,2,-3,2,5,0,1,1,4,5,1,1,1,0,0,3,-5,0,3,3,4,0,2,0,1,1,1,0,1
KR_6743171836,440,-3,-108,-32,-6,0,1,1,-2,1,3,1,4,3,-2,2,4,-3,0,3,-2,-6,-8,-4,7,3,9,0,0,-1,1,-1,-1,1,1
KR_6753932333,420,4,-17,19,9,3,3,0,-2,2,4,3,4,1,3,3,0,2,2,0,0,4,-1,1,3,4,-1,0,1,0,1,1,1,0,1
KR_6619227865,420,2,70,-4,4,-2,4,6,0,1,1,4,5,1,1,6,5,1,1,0,-1,-4,56,1,2,3,2,0,2,1,1,1,-1,6,1
KR_6684210022,420,3,23,-24,4,3,3,0,-4,0,4,4,4,0,3,4,1,-2,0,2,0,-2,11,4,2,6,-3,0,0,-1,-1,1,1,2,1
KR_6668934300,420,1,11,20,7,3,5,2,0,2,2,5,7,2,-1,1,2,0,0,0,0,5,139,5,2,7,-7,0,1,0,1,1,-1,0,1
KR_6763494238,440,0,43,11,3,-1,2,3,1,1,0,1,3,2,3,3,0,-1,2,3,0,3,-2,5,0,5,3,0,1,1,1,1,1,6,1
KR_6743778232,440,-2,-68,29,-5,-1,3,4,2,4,2,-1,2,3,-4,1,5,-1,2,3,-2,-7,8,-2,4,2,-1,0,0,1,1,-1,1,2,1
KR_6647563924,420,5,19,29,10,9,9,0,2,4,2,4,4,0,-3,0,3,-2,0,2,0,2,3,3,1,4,-2,0,3,1,1,1,1,4,1
KR_6731063981,420,6,85,39,9,-2,1,3,6,8,2,5,6,1,2,3,1,-2,0,2,1,9,41,3,2,5,-1,0,2,1,1,1,1,5,1
KR_6751909995,420,3,-5,1,0,4,4,0,0,2,2,-3,0,3,-1,1,2,0,0,0,0,-2,-52,0,6,6,1,0,0,-1,0,0,-1,4,1
KR_6761003377,420,5,73,32,10,5,7,2,2,4,2,4,7,3,-1,2,3,0,1,1,2,6,-5,-2,6,4,4,0,1,0,1,1,1,0,1
KR_6601251734,420,1,32,8,5,1,1,0,4,9,5,0,2,2,-2,0,2,2,2,0,0,-3,5,2,2,4,3,0,3,1,1,1,1,5,1
KR_6761949916,420,0,12,-2,5,-2,1,3,-1,0,1,1,8,7,7,10,3,0,0,0,0,1,-21,-1,4,3,-1,0,0,1,1,1,1,2,1
KR_6762551252,420,5,45,61,9,2,3,1,8,8,0,-3,1,4,0,3,3,2,5,3,0,10,33,2,5,7,-2,0,2,1,1,1,-1,2,1
KR_6725802903,420,4,11,29,8,0,1,1,1,3,2,4,5,1,2,5,3,1,1,0,0,7,-4,2,3,5,6,0,0,1,-1,0,-1,2,1
KR_6744204180,420,1,-9,12,5,1,1,0,-2,2,4,4,5,1,2,3,1,0,1,1,0,-7,-3,1,7,8,-1,0,1,1,1,1,1,6,1
KR_6756621274,420,1,28,2,-1,0,3,3,-2,2,4,-1,2,3,3,4,1,-1,1,2,0,-5,-12,1,4,5,-2,0,-1,0,-1,-1,-1,0,1
KR_6763478647,420,0,-11,-12,2,-2,1,3,1,3,2,2,3,1,0,4,4,1,3,2,0,1,-145,-2,6,4,5,0,-1,0,-1,-1,1,0,1
KR_6749091938,420,0,27,4,-2,2,2,0,-2,1,3,0,2,2,1,3,2,-3,0,3,0,-7,0,2,4,6,3,0,0,1,-1,0,1,6,1
KR_6758941326,420,2,59,16,7,4,5,1,0,5,5,0,1,1,1,3,2,2,3,1,0,5,0,1,4,5,4,0,0,1,-1,1,1,2,1
KR_6636111769,420,-1,13,0,-9,1,2,1,-1,5,6,-5,2,7,-2,1,3,-2,2,4,0,-22,-386,0,2,2,0,0,0,1,-1,-1,-1,4,1
KR_6696011633,420,1,-18,-4,7,-5,1,6,3,4,1,8,9,1,0,0,0,1,1,0,0,8,-169,0,3,3,1,0,2,0,0,-1,-1,0,1
KR_6723042374,440,0,13,6,1,1,2,1,1,2,1,-2,2,4,1,1,0,0,0,0,0,3,3,0,2,2,1,0,0,1,1,0,-1,4,1
KR_6680272455,440,9,81,43,14,4,7,3,3,4,1,-1,2,3,5,6,1,3,3,0,-1,12,4,-2,4,2,3,0,4,-1,1,1,-1,2,1
KR_6714952469,420,1,-16,-12,14,0,0,0,4,4,0,2,4,2,6,7,1,2,2,0,0,13,62,1,2,3,1,0,-2,-1,-1,-1,1,3,1
KR_6726612687,420,3,77,12,5,0,3,3,-2,2,4,2,2,0,4,6,2,1,2,1,1,1,4,6,3,9,0,0,2,1,1,1,1,1,1
KR_6741978896,440,1,55,-7,8,-2,2,4,1,2,1,1,3,2,7,7,0,1,1,0,0,14,25,-1,6,5,0,0,0,-1,1,-1,1,4,1
KR_6650587190,420,-1,-28,-8,2,0,2,2,5,8,3,-2,1,3,0,4,4,-1,2,3,1,-6,-3,3,2,5,-2,0,0,-1,0,0,1,5,1
KR_6762867329,440,3,47,16,9,3,4,1,3,3,0,1,2,1,0,0,0,2,2,0,0,10,34,-5,9,4,-1,0,2,-1,1,1,1,1,1
KR_6738036969,420,0,60,-10,1,4,4,0,3,4,1,-1,4,5,-1,2,3,-4,0,4,1,-7,-14,1,4,5,5,0,1,-1,1,1,1,4,1
KR_6731391284,420,3,44,17,14,-2,0,2,5,7,2,2,2,0,6,6,0,3,3,0,0,13,19,2,5,7,-3,0,1,1,1,1,1,3,1
KR_6762225350,420,4,69,20,13,1,2,1,1,3,2,5,11,6,5,6,1,1,1,0,0,14,8,6,6,12,2,0,2,0,1,1,1,0,1
KR_6739127051,420,0,2,23,6,-4,1,5,2,4,2,4,5,1,4,4,0,0,0,0,0,12,21,2,3,5,0,0,0,1,-1,1,1,5,1
KR_6749432551,420,0,-19,-4,-1,-2,2,4,-2,1,3,-1,1,2,2,3,1,2,3,1,0,2,-20,-4,7,3,1,0,1,-1,1,1,1,1,1
KR_6652455646,420,2,18,-1,2,1,2,1,-2,2,4,-1,2,3,1,4,3,3,5,2,0,2,10,2,0,2,-2,0,0,-1,1,-1,-1,1,1
KR_6739175524,420,1,-47,24,2,-3,0,3,4,4,0,0,2,2,1,4,3,0,1,1,0,5,-113,1,3,4,1,0,0,-1,1,0,1,2,1
KR_6691923716,420,3,87,18,9,-3,1,4,4,5,1,1,4,3,8,8,0,-1,1,2,1,10,13,0,3,3,2,0,2,1,1,1,1,6,1
KR_6763569747,420,1,-8,-1,-1,0,1,1,-2,1,3,-5,3,8,4,5,1,2,4,2,0,-2,60,-2,5,3,-20,0,0,0,-1,0,1,0,1
KR_6756802110,440,-2,-40,-36,1,-3,0,3,1,2,1,0,2,2,3,3,0,0,0,0,0,7,60,0,4,4,-4,0,-1,-1,0,-1,1,1,1
KR_6739247528,420,5,31,26,12,2,2,0,6,6,0,1,4,3,2,2,0,1,3,2,1,17,-2,-4,6,2,0,0,1,1,1,1,1,3,1
KR_6756682155,420,1,43,14,0,4,5,1,-2,2,4,-3,1,4,1,1,0,0,0,0,1,-3,19,3,5,8,5,0,1,-1,1,1,1,5,1
KR_6705686505,420,1,44,4,0,4,6,2,-3,3,6,-3,2,5,2,5,3,0,0,0,1,5,-12,-8,11,3,1,0,0,-1,-1,-1,1,6,1
KR_6742163548,420,4,31,24,10,5,5,0,-3,2,5,3,4,1,5,6,1,0,0,0,0,9,-35,-7,8,1,4,0,2,0,1,1,1,0,1
KR_6713512523,420,4,27,3,4,0,2,2,-3,3,6,1,3,2,6,6,0,0,0,0,0,5,42,1,4,5,-10,0,1,0,1,1,1,0,1
KR_6749282291,420,2,89,-24,8,0,1,1,2,3,1,1,2,1,5,5,0,0,1,1,0,7,140,2,4,6,-1,0,0,-1,-1,0,1,3,1
KR_6644646909,420,2,-24,22,6,0,2,2,6,7,1,5,6,1,-2,0,2,-3,1,4,-2,3,-5,6,1,7,1,0,-1,1,1,-1,-1,3,1
KR_6644109518,420,1,60,-17,1,0,2,2,4,5,1,-1,4,5,-4,1,5,2,2,0,0,-2,0,-5,6,1,0,0,2,1,-1,1,1,5,1
KR_6716007919,440,-2,23,21,-6,-2,1,3,3,4,1,-2,1,3,-3,0,3,-2,2,4,0,-3,-200,-6,8,2,4,0,-1,0,0,-1,-1,0,1
KR_6756769394,420,0,-107,12,4,2,6,4,-1,1,2,1,5,4,2,2,0,0,0,0,0,18,-14,1,4,5,2,0,-2,1,1,-1,-1,5,1
KR_6739354260,420,1,22,0,3,3,3,0,1,6,5,3,5,2,-6,1,7,2,5,3,0,-4,-29,-1,5,4,-1,0,1,-1,1,1,-1,1,1
KR_6726475784,420,4,-22,21,10,2,2,0,2,4,2,6,6,0,-2,0,2,2,2,0,1,14,-51,0,4,4,0,0,0,1,1,1,1,5,1
KR_6749442993,420,3,43,44,8,1,3,2,2,4,2,1,5,4,3,3,0,1,2,1,0,1,7,1,2,3,-2,0,1,1,1,1,-1,5,1
KR_6734165058,440,4,-4,16,10,-6,0,6,2,3,1,2,3,1,11,11,0,1,1,0,0,11,1,0,4,4,-1,0,2,1,-1,1,1,5,1
KR_6724965551,420,6,23,28,16,0,0,0,3,6,3,6,9,3,4,5,1,3,3,0,0,17,-2,-3,6,3,-1,0,1,1,-1,1,-1,5,1
KR_6746310487,420,4,36,-4,11,0,3,3,4,5,1,0,0,0,6,7,1,1,1,0,1,16,12,3,4,7,-1,0,2,1,1,1,1,1,1
KR_6626163613,420,-1,-31,-21,0,-2,0,2,3,4,1,-1,3,4,2,3,1,-2,0,2,0,-5,-9,-4,8,4,0,0,-1,0,-1,-1,1,0,1
KR_6762999709,420,7,97,54,18,4,4,0,2,4,2,7,8,1,4,8,4,1,3,2,0,13,1,0,3,3,1,0,1,1,-1,1,1,5,1
KR_6732101225,420,5,36,35,9,2,2,0,-2,1,3,7,8,1,2,2,0,0,0,0,0,5,1,0,4,4,1,0,1,-1,1,1,1,2,1
KR_6752641130,420,3,69,0,4,3,3,0,1,2,1,-2,0,2,2,4,2,0,0,0,0,5,-54,1,3,4,-2,0,1,-1,1,1,1,2,1
KR_6752912050,420,1,118,22,5,0,1,1,-1,3,4,2,5,3,1,4,3,3,4,1,2,4,133,-4,7,3,-2,0,1,1,-1,1,1,2,1
KR_6713216018,420,3,40,11,6,3,3,0,2,6,4,0,1,1,0,2,2,1,1,0,0,-3,2,-1,5,4,1,0,0,1,1,1,1,3,1
KR_6722360661,420,0,42,24,0,1,5,4,-3,2,5,-2,0,2,5,5,0,-1,0,1,1,-11,39,-1,6,5,-16,0,1,1,1,1,-1,1,1
KR_6759115165,420,4,35,23,11,-3,1,4,4,5,1,2,5,3,4,6,2,4,6,2,0,11,-2,-5,6,1,1,0,2,1,1,1,1,2,1
KR_6673451929,420,0,25,4,-2,1,4,3,0,3,3,-1,1,2,-1,3,4,-1,1,2,0,1,-6,1,6,7,-3,0,-1,-1,-1,-1,-1,5,1
KR_6748015116,420,2,20,16,10,2,2,0,4,4,0,0,1,1,1,2,1,3,3,0,0,19,16,3,4,7,4,0,0,1,1,0,1,3,1
KR_6695807242,420,2,20,0,5,1,3,2,5,6,1,-1,2,3,0,1,1,0,2,2,1,7,-5,0,3,3,-1,0,0,1,-1,-1,1,3,1
KR_6709222228,420,5,48,-43,9,3,4,1,2,4,2,-2,1,3,5,9,4,1,1,0,3,10,2,7,2,9,6,0,0,1,-1,1,1,5,1
KR_6758675518,420,5,74,45,12,5,6,1,2,3,1,2,4,2,0,0,0,3,3,0,0,4,21,1,3,4,-2,0,1,1,1,1,1,4,1
KR_6684936635,420,0,25,8,8,0,3,3,-1,3,4,7,7,0,2,4,2,0,1,1,0,5,4,0,4,4,-4,0,0,1,-1,0,1,6,1
KR_6698870478,420,-1,-3,16,-8,1,4,3,-1,1,2,-2,0,2,-3,2,5,-3,1,4,0,-5,16,0,4,4,-2,0,1,0,-1,1,1,0,1
KR_6751464397,420,1,-31,16,6,-1,0,1,7,7,0,-1,1,2,1,2,1,0,1,1,0,12,-129,-3,4,1,0,0,-1,1,0,-1,1,2,1
KR_6620229434,440,1,13,-8,-6,4,7,3,-1,1,2,-3,2,5,-5,2,7,-1,2,3,-1,-12,-5,0,1,1,1,0,1,0,0,1,-1,0,1
KR_6764938717,420,-1,38,-32,4,1,5,4,-1,0,1,-1,1,2,4,5,1,1,1,0,0,1,3,-3,6,3,3,0,0,-1,1,1,-1,4,1
KR_6762877583,440,3,58,0,9,1,2,1,1,3,2,1,3,2,8,8,0,-2,0,2,0,7,8,-3,3,0,0,0,0,0,0,1,-1,0,1
KR_6764895590,420,-1,9,17,4,-2,1,3,5,6,1,4,5,1,-2,1,3,-1,0,1,0,6,41,-1,3,2,-26,0,-1,1,-1,-1,1,5,1
KR_6706351226,420,0,-19,3,3,-1,0,1,2,4,2,-5,1,6,0,3,3,7,7,0,2,3,-44,-1,7,6,33,0,1,-1,1,1,1,5,1
KR_6751058155,420,2,37,0,7,1,1,0,-2,0,2,3,3,0,4,4,0,1,3,2,0,4,-45,2,1,3,1,0,2,1,1,1,1,1,1
KR_6663100982,420,-1,14,-44,-1,-2,0,2,-2,2,4,0,5,5,5,5,0,-2,0,2,0,-1,2,3,3,6,2,0,0,1,-1,0,1,6,1
KR_6632026532,420,7,108,18,19,2,4,2,2,2,0,2,3,1,12,13,1,1,1,0,0,17,-4,1,3,4,1,0,4,1,1,1,1,1,1
KR_6756928190,420,1,72,-26,10,3,3,0,9,10,1,0,2,2,-2,1,3,0,1,1,0,3,-10,-5,6,1,8,0,1,-1,1,1,-1,5,1
KR_6760057426,420,1,74,-24,3,-3,0,3,0,1,1,-3,1,4,7,8,1,2,2,0,1,0,2,4,4,8,2,0,1,-1,-1,1,1,2,1
KR_6758278621,420,3,10,-2,4,0,0,0,0,1,1,1,2,1,4,8,4,-1,1,2,0,8,3,1,4,5,-1,0,0,1,-1,0,-1,6,1
KR_6721294991,420,-2,-40,-23,-1,-1,2,3,4,5,1,-2,4,6,-1,0,1,-1,1,2,0,7,-1,3,4,7,5,0,0,0,0,0,1,0,1
KR_6759985001,420,-2,-37,15,-1,-3,0,3,2,3,1,-1,0,1,1,6,5,0,0,0,-1,7,28,0,4,4,2,0,-1,1,-1,-1,-1,3,1
KR_6715621327,420,5,40,28,9,-1,1,2,0,3,3,4,4,0,3,6,3,3,6,3,-1,2,-4,-6,11,5,4,0,3,1,1,1,-1,3,1
KR_6762541463,420,1,12,4,2,2,3,1,3,4,1,-1,0,1,-1,5,6,-1,0,1,1,3,0,0,6,6,-1,0,0,1,1,0,1,4,1
KR_6737953659,420,3,59,-4,6,-2,1,3,4,5,1,2,4,2,0,3,3,2,2,0,0,2,4,-3,6,3,1,0,0,-1,1,0,1,1,1
KR_6764479576,420,-4,10,-6,-11,0,3,3,-2,1,3,-3,2,5,-4,2,6,-2,2,4,-1,-30,278,0,3,3,1,0,1,1,1,1,-1,6,1
KR_6757601684,440,3,8,31,-2,-3,1,4,-5,0,5,4,7,3,1,1,0,1,2,1,0,-7,-1,-2,2,0,1,0,-1,1,1,-1,1,3,1
KR_6640421318,420,-1,-126,-4,4,0,2,2,5,6,1,1,1,0,-1,2,3,-1,2,3,0,12,1,1,4,5,0,0,0,-1,1,0,1,1,1
KR_6678080439,420,2,-47,30,4,1,3,2,3,4,1,1,2,1,-2,0,2,1,1,0,-1,1,-5,-5,10,5,0,0,-1,1,-1,-1,-1,6,1
KR_6750974167,440,1,26,17,-5,0,3,3,1,2,1,-2,0,2,-2,6,8,-2,0,2,0,-5,-23,-4,7,3,2,0,0,-1,1,0,-1,3,1
KR_6756139363,420,3,28,18,1,-3,2,5,3,7,4,1,5,4,-1,5,6,1,1,0,1,-3,-2,4,6,10,5,0,2,-1,-1,1,1,4,1
KR_6737565500,420,1,-17,-12,-1,-1,0,1,-1,4,5,-1,2,3,2,3,1,0,1,1,0,2,-5,1,7,8,8,0,0,-1,1,1,-1,6,1
KR_6712006955,420,2,32,-12,9,-2,0,2,3,5,2,0,1,1,8,9,1,0,0,0,1,18,9,6,2,8,-1,0,0,1,-1,0,1,1,1
KR_6725869488,420,6,40,20,5,2,5,3,0,2,2,3,3,0,1,2,1,-1,1,2,0,1,-5,1,4,5,3,0,-1,-1,-1,-1,-1,4,1
KR_6763064406,440,2,31,-11,7,1,1,0,6,9,3,-2,1,3,1,1,0,1,1,0,0,7,-68,4,3,7,1,0,1,-1,1,1,1,6,1
KR_6693386994,440,1,4,-35,2,0,3,3,-1,2,3,0,1,1,4,8,4,-1,0,1,0,2,-2,1,3,4,1,0,0,1,-1,0,-1,4,1
KR_6755148808,420,0,26,-20,-5,0,2,2,-1,3,4,-3,1,4,0,2,2,-1,1,2,0,-8,-8,-1,5,4,0,0,-1,-1,1,-1,1,2,1
KR_6739501444,420,4,123,-6,7,6,7,1,2,2,0,-4,2,6,0,3,3,3,5,2,0,6,2,2,4,6,4,0,1,1,1,1,1,4,1
KR_6761271844,420,-2,-11,-16,1,-1,0,1,1,2,1,0,3,3,1,2,1,0,0,0,0,3,10,3,5,8,1,0,1,1,-1,1,1,3,1
KR_6751036696,440,1,89,4,4,2,3,1,-8,3,11,3,4,1,10,10,0,-3,0,3,0,-4,-2,0,3,3,0,0,1,-1,1,1,1,2,1
KR_6756718076,420,0,44,-20,12,6,7,1,3,4,1,2,3,1,4,8,4,-3,0,3,1,6,3,7,3,10,-3,0,2,-1,1,1,1,3,1
KR_6759823276,420,5,61,36,15,7,7,0,7,8,1,2,3,1,-2,3,5,1,2,1,0,11,-20,6,2,8,4,0,0,1,1,1,-1,1,1
KR_6511426959,420,0,32,24,6,0,1,1,4,4,0,0,7,7,3,4,1,-1,1,2,1,14,5,-4,7,3,2,0,2,1,1,1,1,4,1
KR_6735819755,420,0,1,-4,2,0,2,2,0,2,2,5,6,1,-3,5,8,0,0,0,0,7,-14,0,2,2,-1,0,0,-1,1,-1,1,5,1
KR_6690655524,420,3,100,30,4,-1,2,3,1,4,3,3,3,0,1,1,0,0,1,1,0,-2,-6,0,4,4,0,0,1,1,1,1,-1,3,1
KR_6759832125,440,1,32,28,-1,-2,0,2,1,4,3,-3,1,4,0,4,4,3,3,0,0,7,13,3,1,4,-2,0,2,-1,0,1,-1,6,1
KR_6754156304,440,3,-3,47,3,4,5,1,-1,4,5,-1,1,2,1,5,4,0,0,0,-1,3,-1,-1,1,0,1,0,1,0,1,1,-1,0,1
KR_6577469288,420,1,26,4,4,-1,0,1,-1,0,1,0,1,1,6,8,2,0,0,0,0,8,23,2,3,5,3,0,1,0,0,1,-1,0,1
KR_6691572136,420,4,-11,6,10,5,5,0,5,7,2,3,6,3,-5,3,8,2,3,1,0,3,-5,2,2,4,2,0,2,1,1,1,1,5,1
KR_6720747128,420,2,15,-4,1,2,2,0,-1,3,4,2,2,0,-4,4,8,2,2,0,0,10,-104,3,0,3,20,0,1,1,-1,1,-1,5,1
KR_6741480786,420,4,10,48,7,6,6,0,4,6,2,-1,3,4,-3,2,5,1,2,1,0,0,39,1,6,7,-4,0,1,-1,1,1,-1,1,1
KR_6587832167,440,4,40,3,15,-1,0,1,1,2,1,0,1,1,13,14,1,2,2,0,1,23,5,-1,4,3,-3,0,2,1,-1,-1,1,6,1
KR_6757188729,420,4,32,43,9,-2,1,3,0,1,1,8,9,1,4,5,1,-1,1,2,0,7,-13,1,0,1,0,0,1,1,-1,1,-1,1,1
KR_6725767912,420,3,150,-19,6,2,2,0,-3,2,5,3,4,1,2,4,2,2,3,1,0,4,13,3,2,5,0,0,1,-1,1,1,-1,5,1
KR_6684737139,420,6,125,4,8,2,2,0,5,6,1,0,4,4,3,3,0,-2,0,2,0,4,-10,6,0,6,4,0,2,1,1,1,1,4,1
KR_6754940621,420,7,112,4,15,4,5,1,11,13,2,0,1,1,-2,3,5,2,3,1,0,11,11,-1,6,5,1,0,2,-1,1,1,-1,3,1
KR_6740214684,440,1,17,-12,5,6,8,2,-2,1,3,1,1,0,0,2,2,0,3,3,0,0,1,1,4,5,2,0,0,1,1,1,1,6,1
KR_6744440970,420,4,42,7,6,0,3,3,0,1,1,3,5,2,3,3,0,0,0,0,1,11,7,-1,5,4,-5,0,1,-1,1,1,1,3,1
KR_6757701673,440,4,68,44,9,-9,1,10,-1,3,4,8,8,0,7,7,0,4,4,0,-1,0,71,-3,6,3,7,0,3,1,1,1,-1,5,1
KR_6671090543,420,2,51,4,5,1,1,0,4,6,2,2,4,2,1,4,3,-3,0,3,-1,-4,20,6,1,7,-5,0,1,-1,1,1,-1,5,1
KR_6764874451,420,3,31,16,13,0,1,1,1,1,0,6,6,0,6,9,3,0,1,1,0,11,13,6,2,8,-1,0,0,0,1,1,-1,0,1
KR_6718980902,420,1,55,4,0,-2,0,2,-1,1,2,5,6,1,0,2,2,-2,2,4,0,-4,2,1,6,7,0,0,0,-1,-1,0,1,2,1
KR_6723346033,420,7,30,28,15,7,7,0,2,2,0,6,8,2,-1,1,2,1,1,0,0,10,-38,1,4,5,27,0,0,1,1,0,1,5,1
KR_6748155396,420,1,42,4,5,1,3,2,1,2,1,2,2,0,2,2,0,-1,0,1,0,10,-14,-2,5,3,2,0,0,-1,-1,0,1,6,1
KR_6643058007,420,4,52,34,4,2,4,2,1,3,2,2,5,3,-3,1,4,2,2,0,0,-2,-39,4,2,6,24,0,1,-1,-1,1,-1,2,1
KR_6745207502,440,3,21,13,7,0,3,3,5,6,1,1,4,3,3,5,2,-2,0,2,-1,2,-135,-1,6,5,-3,0,1,1,-1,1,-1,1,1
KR_6756159070,420,1,3,4,10,-1,2,3,6,7,1,5,7,2,-5,2,7,5,6,1,0,12,24,6,0,6,0,0,-2,1,-1,-1,1,2,1
KR_6668375706,420,2,26,20,0,-2,3,5,2,5,3,1,3,2,0,5,5,-1,0,1,1,4,251,2,6,8,2,0,-1,1,1,1,1,1,1
KR_6447703832,420,-2,-8,-10,-4,1,2,1,-3,1,4,4,4,0,-4,1,5,-2,1,3,1,-8,-23,1,7,8,1,0,1,-1,1,1,1,4,1
KR_6760548326,420,5,42,4,10,8,8,0,0,1,1,-1,0,1,3,3,0,0,0,0,0,4,22,2,4,6,2,0,1,1,1,1,1,5,1
KR_6713918837,420,4,14,32,3,1,2,1,-1,2,3,0,2,2,2,3,1,1,2,1,0,-2,-1,-3,8,5,3,0,1,1,1,1,1,1,1
KR_6647087569,420,0,64,-5,5,1,1,0,-3,0,3,1,4,3,3,6,3,3,4,1,0,2,45,3,2,5,-25,0,2,-1,-1,1,1,4,1
KR_6722276113,420,2,2,4,0,2,2,0,-4,0,4,1,3,2,1,3,2,0,0,0,0,-4,-10,-6,7,1,3,0,0,1,1,0,1,4,1
KR_6668349585,420,0,24,-35,-8,-8,1,9,-1,4,5,0,2,2,2,4,2,-1,0,1,0,-3,-1,0,3,3,0,0,0,-1,0,0,-1,4,1
KR_6736262890,440,-4,-27,4,-17,1,2,1,-10,1,11,-4,2,6,-4,3,7,0,2,2,-1,-16,-3,-5,6,1,3,0,0,-1,-1,-1,-1,1,1
KR_6600839919,420,4,37,-26,19,4,5,1,3,4,1,8,10,2,5,6,1,-1,0,1,0,26,7,2,1,3,4,0,4,1,1,1,-1,6,1
KR_6754221017,420,-3,-50,1,-5,-2,0,2,1,2,1,-4,1,5,-2,4,6,2,2,0,0,-3,110,0,5,5,0,0,1,1,1,1,1,4,1
KR_6762961681,420,0,-16,6,1,0,1,1,-1,1,2,-1,0,1,-2,0,2,5,5,0,0,-2,295,5,1,6,0,0,0,0,-1,0,1,0,1
KR_6715131128,420,0,-29,-27,-2,3,4,1,1,2,1,-2,1,3,-1,3,4,-3,0,3,0,-3,-14,0,4,4,-2,0,1,1,1,1,1,5,1
KR_6735621172,420,2,3,0,-1,-2,0,2,-2,0,2,2,7,5,0,2,2,1,2,1,0,-1,-22,-3,3,0,-1,0,1,1,-1,1,1,1,1
KR_6710820887,420,2,6,8,3,1,2,1,2,4,2,-1,0,1,3,6,3,-2,0,2,-1,8,-198,4,3,7,3,0,1,-1,1,-1,-1,2,1
KR_6736863706,420,4,72,3,7,-5,0,5,-1,5,6,5,6,1,5,5,0,3,4,1,0,13,-29,0,4,4,15,0,2,-1,1,1,1,2,1
KR_6684447761,420,0,29,4,-3,-1,2,3,0,1,1,0,2,2,-4,1,5,2,2,0,1,-7,32,-4,4,0,3,0,0,-1,0,0,1,1,1
KR_6591393991,420,0,49,19,0,6,6,0,-2,3,5,0,3,3,-3,2,5,-1,1,2,-1,-7,-24,2,4,6,-3,0,3,1,1,1,-1,4,1
KR_6643214055,420,-1,-9,35,-6,-1,3,4,-4,1,5,5,7,2,-3,0,3,-3,0,3,0,-13,-113,-1,7,6,3,0,1,1,1,-1,1,5,1
KR_6734224467,440,0,44,-30,5,3,5,2,1,2,1,1,4,3,0,2,2,0,1,1,0,10,18,-1,7,6,-2,0,0,1,1,-1,1,1,1
KR_6753896090,420,2,-2,16,5,2,3,1,-1,3,4,1,1,0,1,1,0,2,2,0,0,1,59,0,4,4,2,0,1,0,1,1,1,0,1
KR_6675631100,420,-2,38,0,-5,-2,0,2,-2,2,4,3,4,1,-4,1,5,0,1,1,0,-6,12,3,2,5,-2,0,1,-1,1,1,1,3,1
KR_6756491530,420,1,-6,16,6,-2,0,2,5,6,1,1,3,2,-1,2,3,3,4,1,0,8,144,1,4,5,-5,0,1,-1,0,1,1,4,1
KR_6726543735,420,2,1,19,9,-3,0,3,0,1,1,4,4,0,4,7,3,4,4,0,0,11,-2,-3,5,2,4,0,0,1,-1,1,1,5,1
KR_6730143819,420,0,22,-3,-8,0,4,4,-5,2,7,1,1,0,-4,2,6,0,1,1,0,-19,10,5,1,6,-5,0,1,-1,1,1,-1,6,1
KR_6746081075,420,-5,-37,-14,-14,1,2,1,-1,1,2,-9,1,10,-4,4,8,-1,0,1,0,0,176,-3,6,3,-15,0,-2,-1,-1,-1,-1,2,1
KR_6466680944,420,2,-54,43,4,0,0,0,4,7,3,2,4,2,-1,3,4,-1,0,1,0,3,36,1,2,3,2,0,1,1,1,1,-1,5,1
KR_6676319169,420,3,59,-8,10,2,3,1,4,6,2,5,5,0,-2,3,5,1,1,0,1,17,275,6,0,6,-5,0,3,1,1,1,-1,4,1
KR_6764299496,440,5,53,36,11,1,3,2,2,3,1,8,10,2,-1,2,3,1,3,2,0,-6,4,5,1,6,-1,0,2,1,1,1,1,5,1
KR_6197052788,420,3,28,5,10,0,2,2,2,3,1,1,1,0,4,4,0,3,3,0,0,14,13,6,3,9,4,0,2,1,1,1,1,1,1
KR_6739111947,420,-3,-11,0,-6,3,5,2,-3,1,4,0,1,1,-4,3,7,-2,1,3,0,-10,-7,1,7,8,-10,0,0,1,-1,-1,-1,5,1
KR_6764898063,440,4,25,8,4,-3,1,4,-1,4,5,2,2,0,9,11,2,-3,2,5,0,5,-5,4,2,6,-3,0,0,0,1,1,1,0,1
KR_6733278284,420,1,26,-4,0,0,2,2,-1,2,3,0,1,1,1,5,4,0,1,1,0,0,0,-4,6,2,2,0,0,-1,1,0,-1,4,1
KR_6716113483,440,-3,-23,-15,0,-3,1,4,-1,2,3,0,0,0,1,1,0,3,4,1,0,0,9,5,4,9,-2,0,0,1,1,0,1,2,1
KR_6761948662,420,3,3,6,6,0,1,1,0,5,5,2,3,1,4,6,2,0,1,1,0,11,18,-5,8,3,5,0,0,1,1,0,-1,6,1
KR_6760407394,420,4,15,20,4,3,4,1,-3,1,4,2,4,2,2,3,1,0,1,1,0,2,4,-2,5,3,2,0,0,1,-1,0,1,2,1
KR_6658777257,420,-2,-49,0,1,0,3,3,1,5,4,8,10,2,-7,1,8,-1,1,2,1,-1,-7,-4,9,5,6,0,-1,-1,1,-1,1,6,1
KR_6731826622,420,2,54,8,6,-1,1,2,0,5,5,1,3,2,3,7,4,3,5,2,0,1,12,-2,3,1,0,0,2,1,-1,1,-1,2,1
KR_6759579430,440,3,20,8,8,-3,0,3,3,3,0,2,3,1,4,5,1,2,4,2,0,10,379,-5,7,2,13,0,0,1,1,1,1,2,1
KR_6648246420,420,-1,-23,-20,-5,2,5,3,1,2,1,-2,2,4,-7,0,7,1,2,1,0,4,-9,3,6,9,2,0,-1,1,1,-1,1,2,1
KR_6743915620,440,4,51,16,8,1,2,1,0,1,1,5,6,1,-2,4,6,4,5,1,0,-6,5,-1,3,2,1,0,0,1,1,-1,-1,3,1
KR_6759673520,420,-1,-5,-9,-1,0,1,1,-3,1,4,-1,1,2,2,3,1,1,2,1,0,-6,8,2,1,3,1,0,0,-1,1,1,-1,6,1
KR_6756104578,420,3,57,-24,6,-2,1,3,2,4,2,3,3,0,2,3,1,1,3,2,0,9,0,-2,5,3,0,0,0,-1,1,0,1,3,1
KR_6763052586,420,1,4,19,5,0,1,1,-1,2,3,6,6,0,1,2,1,-1,3,4,0,3,-12,-1,4,3,0,0,1,1,1,1,1,1,1
KR_6759958976,420,6,74,44,16,3,4,1,5,5,0,-1,0,1,7,7,0,2,2,0,0,16,14,5,1,6,1,0,3,1,1,1,1,3,1
KR_6715980072,420,9,48,62,15,2,2,0,3,5,2,5,7,2,3,4,1,2,2,0,0,11,-153,3,2,5,2,0,2,1,1,1,1,3,1
KR_6759655917,440,3,40,28,6,2,3,1,-2,2,4,11,12,1,-2,2,4,-3,2,5,0,-3,-5,2,3,5,0,0,2,1,-1,1,1,4,1
KR_6620118252,420,0,48,-3,2,1,5,4,-1,1,2,0,1,1,4,5,1,-2,2,4,1,0,136,-1,4,3,-3,0,0,1,1,1,1,3,1
KR_6743676146,440,5,45,21,11,1,2,1,2,4,2,5,5,0,2,4,2,1,1,0,1,7,212,-2,6,4,2,0,2,1,1,1,1,4,1
KR_6445317747,420,-1,-16,16,2,1,1,0,-2,4,6,-4,0,4,7,9,2,0,0,0,1,2,-1,3,6,9,2,0,0,-1,1,0,1,3,1
KR_6733930342,420,6,-4,20,15,1,3,2,4,6,2,2,3,1,7,9,2,1,3,2,0,17,-1,2,5,7,3,0,3,-1,1,1,-1,5,1
KR_6646164130,420,4,39,-3,6,3,3,0,0,2,2,-1,1,2,1,3,2,3,3,0,-1,2,5,0,5,5,0,0,3,1,1,1,-1,5,1
KR_6754376829,420,2,56,4,13,1,1,0,-5,3,8,10,10,0,6,6,0,1,2,1,1,19,8,4,1,5,1,0,1,1,0,1,1,1,1
KR_6693139555,420,7,67,12,12,1,1,0,4,5,1,1,3,2,5,6,1,1,3,2,0,10,1,-2,5,3,3,0,1,1,1,1,-1,6,1
KR_6763199032,420,1,31,-32,4,1,4,3,0,2,2,2,3,1,1,1,0,0,0,0,0,8,-112,0,1,1,1,0,1,-1,1,1,1,1,1
KR_6764456433,420,2,47,-28,2,2,4,2,-2,1,3,4,4,0,-1,1,2,-1,0,1,0,4,-10,1,5,6,1,0,2,0,1,1,-1,0,1
KR_6763361567,420,4,43,12,9,7,7,0,-1,0,1,2,3,1,4,6,2,-3,0,3,1,5,0,3,3,6,4,0,1,1,1,1,1,4,1
KR_6756305047,420,4,112,31,9,-1,1,2,3,3,0,4,4,0,3,6,3,0,1,1,0,9,-7,2,2,4,1,0,1,1,-1,1,-1,6,1
KR_6730241827,420,3,21,35,2,4,5,1,-2,3,5,-3,1,4,2,2,0,1,1,0,0,-1,-6,-2,6,4,4,0,1,-1,1,1,1,1,1
KR_6730006886,420,-2,-12,-1,-8,-4,0,4,1,2,1,-2,2,4,-2,2,4,-1,0,1,0,-4,-13,-1,4,3,-2,0,0,-1,-1,0,-1,3,1
KR_6726535116,420,2,29,8,1,5,6,1,0,4,4,-1,1,2,-4,0,4,1,4,3,0,7,-179,-4,5,1,4,0,0,-1,1,1,-1,2,1
KR_6733960544,420,-2,-24,-10,-4,0,1,1,-2,2,4,-2,2,4,0,1,1,0,2,2,-1,1,-12,-1,4,3,3,0,-1,-1,-1,-1,-1,2,1
KR_6761802569,420,3,28,4,4,1,1,0,0,1,1,4,4,0,-3,1,4,2,2,0,0,2,32,-1,5,4,5,0,1,0,1,1,-1,0,1
KR_6662621680,420,3,62,5,-3,3,3,0,-3,1,4,-5,2,7,3,5,2,-1,0,1,0,0,95,2,2,4,2,0,1,1,0,1,1,5,1
KR_6691240758,420,4,65,-42,13,5,5,0,4,5,1,3,5,2,-1,1,2,2,2,0,0,7,-25,-2,4,2,1,0,1,-1,-1,1,1,6,1
KR_6738984140,420,3,33,20,4,-1,1,2,7,8,1,-3,2,5,-1,2,3,2,2,0,0,15,4,-3,6,3,4,0,1,1,1,1,-1,5,1
KR_6727062976,420,6,102,14,12,4,4,0,1,4,3,5,6,1,-1,2,3,3,3,0,1,16,-3,-5,6,1,1,0,2,1,-1,1,1,2,1
KR_6663472332,420,0,55,-4,6,-3,2,5,1,6,5,-3,2,5,7,8,1,4,5,1,0,11,0,-5,6,1,5,0,2,-1,1,1,1,6,1
KR_6760987400,420,1,46,21,0,-2,2,4,0,1,1,-1,0,1,3,3,0,0,1,1,0,0,-3,-2,6,4,-1,0,0,1,-1,0,1,2,1
KR_6763439531,440,1,44,67,4,-1,1,2,3,6,3,-3,1,4,5,5,0,0,0,0,0,6,2,3,2,5,2,0,0,1,1,0,1,3,1
KR_6718777043,420,8,76,36,-5,-2,1,3,-2,0,2,0,2,2,-1,0,1,0,0,0,-1,-3,19,0,2,2,-1,0,1,1,-1,1,-1,4,1
KR_6763555631,440,-3,-59,0,-4,-3,1,4,0,0,0,0,0,0,-1,0,1,0,1,1,0,-2,2,3,4,7,-5,0,-2,0,1,-1,-1,0,1
KR_6753728276,420,4,20,4,15,1,3,2,1,1,0,8,8,0,2,2,0,3,3,0,0,20,0,2,1,3,2,0,0,1,0,1,1,5,1
KR_6757038924,420,1,53,4,7,-1,1,2,2,5,3,3,3,0,2,4,2,1,1,0,0,11,0,1,5,6,-3,0,2,1,0,1,1,6,1
KR_6761723766,440,-1,-46,0,-10,-3,0,3,-5,0,5,4,6,2,-6,0,6,0,0,0,0,-6,-4,0,7,7,-3,0,0,0,1,0,-1,0,1
KR_6752080987,420,-1,28,-20,-1,2,2,0,0,1,1,-1,1,2,-4,3,7,2,4,2,0,0,1,6,1,7,0,0,0,1,-1,0,1,2,1
KR_6729502033,420,-1,-60,-23,1,-3,1,4,0,5,5,0,2,2,2,6,4,2,3,1,0,9,0,-1,4,3,3,0,0,1,-1,0,-1,3,1
KR_6707625085,420,1,-13,-4,6,1,4,3,0,2,2,4,7,3,2,4,2,-1,0,1,0,2,-4,3,8,11,1,0,0,-1,1,1,1,6,1
KR_6762844229,440,3,12,-12,7,-1,0,1,9,10,1,4,6,2,-2,2,4,-3,0,3,0,13,-45,7,0,7,35,0,2,1,-1,1,1,1,1
KR_6746294501,420,1,86,-8,-3,-2,1,3,1,4,3,-1,1,2,-1,1,2,0,0,0,0,-5,381,1,2,3,4,0,2,1,-1,1,-1,3,1
KR_6662837543,420,-1,-9,2,9,-1,3,4,-1,1,2,10,10,0,1,4,3,0,0,0,0,5,-7,3,6,9,-1,0,-1,1,0,-1,1,6,1
KR_6689296106,420,2,4,-8,4,0,1,1,5,5,0,1,2,1,-1,2,3,-1,2,3,0,3,110,1,1,2,-2,0,0,-1,1,-1,-1,3,1
KR_6706656440,420,3,26,-8,0,3,3,0,-3,4,7,-4,0,4,3,6,3,1,1,0,0,-8,9,1,3,4,1,0,0,-1,-1,1,1,2,1
KR_6751197248,440,2,15,-13,10,0,2,2,-2,1,3,5,6,1,8,9,1,-1,0,1,0,3,-9,0,6,6,1,0,2,-1,-1,1,1,4,1
KR_6740835325,420,-1,-32,27,-4,-3,0,3,-2,0,2,4,6,2,-2,2,4,-1,0,1,0,-7,2,-3,5,2,0,0,0,-1,1,0,-1,4,1
KR_6693571109,420,4,18,-8,10,4,4,0,5,6,1,1,2,1,0,1,1,0,1,1,0,7,0,-1,3,2,3,0,1,-1,1,1,1,1,1
KR_6458129416,420,-4,-1,-28,-5,-2,0,2,-3,2,5,-6,3,9,5,6,1,1,1,0,-1,-6,-7,-1,4,3,6,0,1,-1,-1,1,-1,5,1
KR_6752781207,420,-2,30,-16,-8,0,1,1,0,1,1,-5,0,5,-3,1,4,0,0,0,0,-7,-26,-1,4,3,0,0,0,0,-1,0,-1,0,1
KR_6671903036,420,3,8,43,15,0,3,3,3,5,2,3,6,3,3,7,4,6,6,0,3,18,0,0,2,2,4,0,0,1,1,1,1,1,1
KR_6720736429,420,0,29,9,1,-3,2,5,-1,0,1,2,2,0,3,3,0,0,0,0,-1,0,-204,2,4,6,-3,0,1,1,-1,1,-1,4,1
KR_6757961978,420,4,38,13,-4,2,2,0,-1,3,4,-1,2,3,-6,1,7,2,3,1,0,-6,3,-1,5,4,-1,0,0,1,0,0,-1,4,1
KR_6650245479,420,0,-21,8,1,-3,1,4,-3,1,4,2,2,0,4,4,0,1,1,0,0,6,-9,-4,8,4,3,0,0,1,1,0,-1,6,1
KR_6718024990,440,-3,14,0,-4,-4,2,6,3,4,1,2,5,3,-5,0,5,0,1,1,-1,-10,-49,-3,6,3,16,0,-1,-1,0,-1,-1,3,1
KR_6723215945,420,3,55,12,0,5,6,1,-3,0,3,1,1,0,-2,0,2,-1,0,1,0,2,8,-4,6,2,1,0,2,-1,1,1,-1,3,1
KR_6758606065,420,2,71,-12,11,1,2,1,2,2,0,-1,1,2,9,9,0,0,0,0,0,11,3,4,2,6,4,0,1,1,0,1,1,2,1
KR_6725100052,420,2,6,27,5,5,5,0,0,4,4,-5,0,5,6,7,1,-1,1,2,0,5,-5,1,3,4,1,0,1,1,-1,1,1,4,1
KR_6625383374,420,3,126,32,4,4,4,0,-3,1,4,-5,3,8,5,5,0,3,3,0,0,0,-10,-2,3,1,9,0,1,1,0,1,1,1,1
KR_6751672829,420,-1,-14,8,4,0,1,1,2,4,2,0,3,3,2,5,3,0,2,2,0,4,6,6,4,10,0,0,0,1,1,0,1,6,1
KR_6649444308,420,-1,-56,-32,0,0,1,1,3,3,0,3,3,0,-6,0,6,0,1,1,0,-5,6,-2,5,3,0,0,1,-1,1,1,-1,1,1
KR_6605994804,420,4,50,36,8,3,4,1,4,4,0,-3,0,3,3,4,1,1,1,0,0,11,26,2,4,6,1,0,2,1,1,1,1,3,1
KR_6689539254,420,1,75,10,-2,0,2,2,1,2,1,-2,2,4,-1,1,2,0,3,3,0,0,13,0,2,2,-5,0,1,1,-1,1,-1,3,1
KR_6762461641,420,-1,-61,-40,3,1,4,3,0,1,1,2,4,2,0,4,4,0,2,2,-1,0,167,2,4,6,-2,0,-3,-1,-1,-1,-1,2,1
KR_6761806677,420,1,-36,-12,10,4,4,0,0,2,2,3,5,2,5,8,3,-2,0,2,0,3,-25,3,2,5,7,0,0,0,0,-1,1,0,1
KR_6761640866,420,2,48,63,6,1,2,1,3,8,5,-1,2,3,3,5,2,0,2,2,0,2,-15,-4,5,1,1,0,2,1,1,1,-1,4,1
KR_6697537006,420,-1,25,-32,0,-2,2,4,-1,3,4,1,1,0,2,2,0,0,2,2,-1,4,-340,5,3,8,-2,0,1,-1,1,1,-1,4,1
KR_6751296275,440,0,-76,32,-7,1,2,1,0,1,1,-3,0,3,-4,0,4,-1,2,3,0,-8,42,1,5,6,-29,0,1,1,1,1,-1,4,1
KR_6748509756,420,5,19,40,1,-1,1,2,-1,1,2,1,5,4,1,1,0,1,1,0,0,3,9,1,7,8,0,0,0,1,0,0,-1,5,1
KR_6762602522,420,0,-1,-9,5,-1,1,2,0,5,5,2,2,0,2,3,1,2,2,0,0,4,-174,0,3,3,2,0,1,1,-1,1,-1,1,1
KR_6716905488,420,4,32,28,9,0,1,1,3,4,1,-2,0,2,8,12,4,0,1,1,0,12,-31,1,2,3,15,0,0,1,1,1,-1,2,1
KR_6709496461,420,2,17,-5,3,4,4,0,-4,1,5,1,2,1,2,4,2,0,0,0,0,0,-3,3,2,5,-4,0,0,1,1,1,-1,6,1
KR_6748700557,420,1,35,43,2,4,4,0,-1,0,1,2,5,3,-2,1,3,-1,2,3,0,1,-2,4,4,8,-4,0,1,1,-1,-1,1,5,1
KR_6762327265,420,1,-14,20,2,4,4,0,1,2,1,-1,3,4,-1,0,1,-1,0,1,0,0,-2,-1,3,2,5,0,0,1,1,1,1,3,1
KR_6618169979,420,2,39,-24,2,1,1,0,-2,1,3,1,4,3,2,3,1,0,1,1,0,4,-5,1,4,5,4,0,0,-1,1,1,-1,6,1
KR_6754436823,420,0,-23,24,-1,0,0,0,3,4,1,0,1,1,-3,1,4,-1,1,2,0,-5,-28,4,3,7,2,0,0,-1,1,0,1,6,1
KR_6764934295,420,-1,9,4,-3,-5,2,7,-3,1,4,-2,0,2,5,8,3,2,2,0,-1,0,6,-2,6,4,-2,0,0,1,-1,-1,-1,5,1
KR_6735702039,420,1,84,8,3,1,1,0,-1,0,1,-1,1,2,3,5,2,1,1,0,0,4,-8,2,5,7,5,0,0,-1,1,0,1,2,1
KR_6764001608,440,0,50,-12,-4,1,4,3,0,3,3,-3,2,5,-1,2,3,-1,2,3,0,-2,10,-1,5,4,1,0,1,1,1,1,1,5,1
KR_6749923053,420,1,86,-28,6,-4,0,4,-2,1,3,2,5,3,7,7,0,3,6,3,0,5,1,3,1,4,2,0,2,1,1,1,1,5,1
KR_6720204049,420,1,43,23,1,4,4,0,0,1,1,4,6,2,-5,1,6,-2,0,2,0,-6,-13,-3,6,3,6,0,1,1,1,1,-1,2,1
KR_6620147129,440,-1,-33,27,2,-6,2,8,1,2,1,-2,0,2,7,7,0,2,2,0,0,6,3,1,2,3,1,0,1,1,-1,1,-1,5,1
KR_6711800292,420,3,32,17,6,-1,4,5,1,3,2,3,5,2,0,4,4,3,6,3,-1,12,6,-1,4,3,6,0,0,-1,1,0,-1,5,1
KR_6758520946,420,1,31,1,0,-3,0,3,-1,3,4,0,1,1,1,1,0,3,3,0,0,2,-3,5,3,8,-1,0,2,1,1,1,1,4,1
KR_6749575327,420,6,28,13,17,-3,0,3,10,10,0,8,8,0,2,2,0,0,0,0,0,21,1,-1,6,5,-4,0,0,0,-1,1,1,0,1
KR_6717229893,420,1,-6,0,5,3,4,1,5,6,1,0,2,2,-3,1,4,0,2,2,0,4,-8,-2,5,3,1,0,0,1,1,0,1,2,1
KR_6659839604,440,3,-13,20,5,1,2,1,0,2,2,2,2,0,0,3,3,2,2,0,0,-2,6,3,3,6,-4,0,0,-1,1,0,-1,6,1
KR_6662931190,420,4,28,0,6,0,4,4,6,8,2,-1,1,2,-1,1,2,2,3,1,-2,1,0,3,4,7,2,0,1,1,1,1,-1,3,1
KR_6196056743,420,-1,-74,30,3,0,2,2,-1,2,3,1,2,1,4,4,0,-1,0,1,0,6,-94,7,3,10,-3,0,0,1,1,1,1,3,1
KR_6447402147,420,6,-68,48,13,1,1,0,7,9,2,2,5,3,2,3,1,1,1,0,0,15,-34,2,3,5,20,0,0,1,-1,0,-1,5,1
KR_6462584454,420,3,-18,-16,6,3,5,2,2,5,3,-1,0,1,2,3,1,0,1,1,0,4,3,2,4,6,4,0,1,1,1,1,1,4,1
KR_6603624353,420,1,-29,2,4,-2,1,3,6,7,1,5,7,2,-3,1,4,-2,0,2,0,2,-6,1,5,6,4,0,-1,1,-1,-1,1,5,1
KR_6754386760,420,3,106,35,11,3,3,0,3,5,2,4,6,2,0,4,4,1,1,0,0,10,0,5,1,6,0,0,1,0,1,1,1,0,1
KR_6764117899,420,1,15,24,2,-1,1,2,7,8,1,1,1,0,-5,0,5,0,0,0,0,-2,-7,-4,8,4,4,0,0,1,1,0,1,1,1
KR_6745776196,440,6,83,24,10,6,6,0,1,3,2,1,3,2,2,4,2,0,3,3,0,3,-3,5,4,9,0,0,2,1,-1,1,1,2,1
KR_6530297112,420,0,13,2,-2,-1,2,3,-1,4,5,-2,2,4,2,4,2,0,0,0,-1,-4,4,3,6,9,-3,0,-1,-1,1,-1,-1,2,1
KR_6669402704,420,0,0,24,5,0,4,4,-1,8,9,2,2,0,2,6,4,2,2,0,0,15,4,0,6,6,0,0,0,-1,1,-1,-1,5,1
KR_6756629853,420,4,35,27,-4,0,1,1,1,4,3,0,3,3,-2,4,6,-3,0,3,0,-4,257,-2,3,1,-2,0,4,1,-1,1,-1,4,1
KR_6689918318,420,1,-8,1,0,1,1,0,-1,5,6,3,3,0,-3,3,6,0,2,2,-2,-5,-14,-4,7,3,1,0,1,1,1,1,-1,2,1
KR_6758776620,420,0,-87,52,1,-1,2,3,0,3,3,-2,0,2,1,6,5,3,3,0,0,8,26,7,3,10,-1,0,-2,1,1,-1,-1,5,1
KR_6761024076,420,-2,-47,0,2,-2,0,2,1,3,2,-4,0,4,3,6,3,4,5,1,-1,7,5,-4,7,3,3,0,0,-1,1,0,-1,1,1
KR_6714158145,420,2,-13,40,2,3,3,0,1,4,3,-2,3,5,-2,0,2,2,3,1,0,-19,2,0,4,4,-4,0,0,0,-1,0,-1,0,1
KR_6700541235,420,2,73,11,9,0,3,3,3,3,0,11,13,2,3,5,2,-8,1,9,0,11,14,7,0,7,2,0,1,0,-1,1,1,0,1
KR_6698934031,420,2,74,8,7,5,5,0,3,4,1,-1,1,2,-1,1,2,1,3,2,0,5,50,4,3,7,-25,0,3,1,1,1,1,5,1
KR_6764328975,440,1,1,-9,-1,3,8,5,-1,0,1,-8,0,8,1,1,0,4,4,0,0,0,6,1,4,5,-3,0,0,1,1,1,-1,2,1
KR_6681494538,420,3,81,-9,0,2,3,1,-3,0,3,-1,1,2,1,3,2,1,3,2,-1,-10,32,5,1,6,-17,0,1,-1,1,1,-1,1,1
KR_6763381420,420,3,44,2,6,1,1,0,0,2,2,3,3,0,-1,5,6,3,3,0,-1,5,3,-2,7,5,2,0,0,-1,1,1,-1,3,1
KR_6762181878,420,2,18,4,-3,2,5,3,-6,0,6,-2,0,2,3,5,2,0,0,0,0,-12,-4,1,4,5,1,0,-1,-1,-1,-1,-1,2,1
KR_6692459198,420,3,50,48,-1,-1,4,5,1,4,3,0,1,1,-4,2,6,3,6,3,1,-1,-24,-3,8,5,4,0,3,1,1,1,1,5,1
KR_6756768223,420,2,-12,23,5,-1,1,2,8,8,0,1,1,0,-2,2,4,-1,1,2,0,5,0,-4,6,2,26,0,0,1,-1,-1,1,5,1
KR_6739988755,420,-4,32,-50,-6,-1,2,3,-3,1,4,3,4,1,-3,2,5,-2,0,2,0,-2,-4,1,4,5,-4,0,-1,0,1,-1,-1,0,1
KR_6757659342,440,-3,-39,-4,-7,2,2,0,-1,1,2,0,2,2,0,3,3,-8,0,8,-1,-5,0,-2,4,2,0,0,-1,-1,1,-1,1,2,1
KR_6749419697,420,5,32,32,14,1,4,3,3,5,2,4,5,1,7,7,0,-1,3,4,0,13,-9,-3,5,2,4,0,0,1,1,0,1,5,1
KR_6743152520,440,-2,15,5,2,1,3,2,2,3,1,4,5,1,0,2,2,-5,3,8,-1,-8,5,0,3,3,1,0,1,-1,1,1,-1,2,1
KR_6763238424,420,3,13,-5,5,2,5,3,3,3,0,-4,0,4,4,4,0,0,0,0,0,6,11,3,2,5,2,0,2,1,1,1,1,5,1
KR_6730062769,420,7,44,20,7,4,5,1,1,1,0,3,3,0,2,5,3,-3,0,3,-1,1,0,4,3,7,3,0,3,1,1,1,-1,3,1
KR_6763964925,420,3,70,0,3,-2,1,3,1,1,0,5,6,1,-2,2,4,1,3,2,0,-4,3,0,7,7,-8,0,1,1,-1,-1,-1,1,1
KR_6649912275,420,0,-31,16,-1,2,3,1,-1,6,7,4,6,2,-3,1,4,-3,0,3,-1,-12,1,0,5,5,0,0,0,1,1,0,-1,3,1
KR_6738591878,420,1,8,2,1,0,0,0,1,3,2,1,3,2,-2,2,4,1,3,2,-1,3,26,3,2,5,5,0,0,0,0,0,-1,0,1
KR_6690980436,420,-1,-95,-28,-3,-5,0,5,0,3,3,0,2,2,1,1,0,1,2,1,-1,-4,16,0,5,5,-2,0,0,-1,1,-1,-1,3,1
KR_6196862330,420,5,58,33,10,3,3,0,-1,2,3,2,2,0,5,5,0,1,1,0,0,9,2,2,4,6,-2,0,1,1,-1,1,1,1,1
KR_6758438827,440,2,30,8,3,-1,1,2,-3,4,7,-1,1,2,7,8,1,1,1,0,0,2,15,5,2,7,-6,0,1,1,1,1,1,1,1
KR_6751278122,420,0,12,12,4,5,5,0,-2,0,2,-1,1,2,2,2,0,0,0,0,0,-2,1,3,4,7,7,0,0,1,1,0,1,1,1
KR_6743345430,420,3,21,8,1,3,4,1,1,6,5,-2,3,5,-3,2,5,2,2,0,0,4,-6,-5,8,3,6,0,1,-1,1,1,-1,4,1
KR_6749270977,420,-1,38,-12,1,-2,2,4,0,3,3,1,2,1,3,4,1,-1,0,1,0,1,-7,-1,3,2,2,0,0,1,1,1,1,1,1
KR_6701314269,420,4,33,16,6,-3,2,5,0,1,1,3,3,0,7,7,0,-1,1,2,-1,11,-245,2,3,5,4,0,1,1,-1,1,-1,5,1
KR_6740957782,420,-2,-25,6,-5,0,1,1,-1,1,2,1,1,0,-3,1,4,-2,1,3,-1,-8,0,0,5,5,2,0,0,-1,1,-1,-1,6,1
KR_6706661887,440,0,8,-8,1,-4,0,4,-2,2,4,3,6,3,3,4,1,1,2,1,-1,5,4,-2,6,4,2,0,0,1,-1,1,-1,1,1
KR_6763098483,420,4,62,15,6,1,3,2,0,2,2,3,6,3,2,3,1,0,2,2,0,4,114,4,0,4,1,0,2,1,1,1,-1,5,1
KR_6715159686,420,1,9,16,6,2,2,0,4,4,0,-1,1,2,0,3,3,1,1,0,1,8,10,2,4,6,0,0,1,1,1,1,1,2,1
KR_6762311397,420,6,92,40,11,5,7,2,1,2,1,1,4,3,2,3,1,2,3,1,-2,-2,6,2,4,6,-1,0,4,1,-1,1,-1,1,1
KR_6672291840,420,3,97,32,6,2,3,1,1,2,1,1,1,0,3,4,1,-1,0,1,0,6,8,4,2,6,-1,0,1,1,1,1,1,1,1
KR_6761530973,420,3,21,4,8,-2,0,2,3,6,3,-1,5,6,9,10,1,-1,0,1,0,8,3,1,7,8,0,0,0,-1,1,1,1,6,1
KR_6517680688,420,2,9,4,-1,0,1,1,0,1,1,1,3,2,-1,0,1,-1,0,1,0,-4,-30,-1,4,3,-3,0,0,1,1,0,-1,5,1
KR_6757103633,440,3,8,18,5,-2,1,3,3,3,0,0,1,1,4,6,2,0,1,1,0,2,19,-1,7,6,-3,0,0,-1,1,0,1,6,1
KR_6745123797,440,0,23,-8,1,-3,1,4,3,3,0,-2,2,4,0,1,1,3,3,0,0,9,9,1,3,4,2,0,0,1,-1,0,1,2,1
KR_6759315972,440,-2,20,-5,1,1,2,1,0,2,2,0,3,3,3,6,3,-3,0,3,1,-5,-18,1,7,8,1,0,0,-1,1,1,1,2,1
KR_6609067969,420,3,27,8,12,-1,1,2,1,2,1,7,10,3,5,6,1,0,1,1,1,17,223,2,1,3,1,0,3,1,1,1,1,2,1
KR_6748797610,420,-2,11,-12,-3,2,3,1,-1,4,5,-1,4,5,-4,1,5,1,2,1,-1,-16,9,0,3,3,-6,0,0,-1,0,0,-1,1,1
KR_6761865874,420,1,-23,5,-1,5,6,1,-2,4,6,-2,0,2,-3,2,5,1,2,1,0,-3,-10,0,3,3,-4,0,-2,1,-1,-1,1,1,1
KR_6684321839,420,-1,-44,12,-6,0,0,0,0,1,1,-3,0,3,-2,2,4,-1,1,2,1,-12,-9,-4,5,1,-1,0,0,-1,1,-1,1,6,1
KR_6760493832,420,3,8,-1,9,0,0,0,5,6,1,4,6,2,0,4,4,0,1,1,0,11,144,-2,5,3,5,0,0,1,1,0,1,5,1
KR_6740506827,420,3,62,7,10,1,3,2,7,7,0,1,3,2,3,7,4,-2,0,2,0,9,2,0,2,2,4,0,1,-1,-1,1,1,2,1
KR_6754754414,420,3,31,38,4,1,5,4,3,6,3,0,1,1,2,2,0,-2,2,4,0,3,135,2,4,6,3,0,1,1,1,1,-1,6,1
KR_6697856451,420,2,47,14,6,-1,4,5,-1,3,4,5,5,0,1,3,2,2,3,1,0,9,1,0,6,6,0,0,2,1,0,1,-1,2,1
KR_6743858719,420,-1,-45,28,-6,1,1,0,2,4,2,-1,1,2,-7,0,7,-1,2,3,0,0,7,3,4,7,-6,0,-1,-1,1,-1,-1,1,1
KR_6761871587,420,1,-17,0,6,-2,1,3,1,1,0,7,8,1,0,2,2,0,0,0,0,5,7,-1,6,5,4,0,0,1,1,0,1,5,1
KR_6740450176,420,-1,-6,-4,-3,1,1,0,0,3,3,3,6,3,-5,2,7,-2,0,2,-1,-7,-2,1,2,3,0,0,0,1,1,1,-1,1,1
KR_6720794898,420,-2,-37,-16,-7,-3,1,4,-3,2,5,-3,3,6,3,8,5,-1,0,1,0,4,-16,-1,4,3,3,0,-1,1,-1,-1,-1,4,1
KR_6740617247,420,7,112,8,14,1,2,1,7,7,0,-3,1,4,6,9,3,3,3,0,0,13,-4,6,1,7,0,0,2,0,1,1,1,0,1
KR_6753911343,420,3,32,20,11,2,2,0,1,1,0,0,3,3,7,7,0,1,2,1,0,17,-9,-1,4,3,4,0,0,1,1,1,1,5,1
KR_6735665835,420,3,-1,16,5,-3,2,5,0,1,1,-1,1,2,8,8,0,1,2,1,0,8,-20,3,6,9,2,0,0,1,1,0,-1,3,1
KR_6728777124,420,-1,34,0,-1,0,2,2,0,3,3,-1,1,2,0,4,4,0,0,0,1,0,-14,-3,7,4,3,0,0,0,-1,1,1,0,1
KR_6763853312,440,5,78,28,9,-6,0,6,5,7,2,6,6,0,3,3,0,1,1,0,0,10,-5,-1,3,2,3,0,2,1,1,1,-1,5,1
KR_6741695102,420,3,2,33,3,-2,0,2,4,5,1,2,3,1,-1,2,3,0,0,0,0,9,121,0,4,4,1,0,0,1,-1,0,1,2,1
KR_6747445750,420,3,-5,-8,2,0,3,3,-2,2,4,2,4,2,2,5,3,0,1,1,0,0,-15,5,5,10,-1,0,1,1,-1,1,-1,5,1
KR_6763163075,420,4,79,20,1,2,2,0,0,0,0,-2,0,2,0,2,2,1,1,0,0,2,-2,-3,5,2,0,0,0,0,1,0,-1,0,1
KR_6721907619,420,0,-14,-2,6,-7,0,7,1,2,1,1,3,2,7,10,3,4,4,0,0,16,6,1,5,6,-1,0,1,1,-1,-1,1,2,1
KR_6691799333,420,-3,-6,-46,0,-7,1,8,1,3,2,2,3,1,2,4,2,2,2,0,0,7,-2,-2,4,2,1,0,0,-1,-1,-1,1,5,1
KR_6715383746,420,4,77,-20,9,1,1,0,4,6,2,2,5,3,-1,2,3,3,3,0,1,11,-1,6,3,9,-3,0,0,-1,0,0,1,5,1
KR_6760950371,420,3,-41,-4,5,2,4,2,-5,2,7,7,7,0,-4,3,7,5,6,1,-2,-1,329,-1,6,5,1,0,1,1,1,1,-1,5,1
KR_6710519750,440,2,89,44,7,0,2,2,3,3,0,2,4,2,3,3,0,-1,0,1,1,11,-5,-2,6,4,-4,0,0,1,1,1,1,5,1
KR_6761510637,420,3,90,-28,8,0,3,3,2,4,2,3,5,2,2,2,0,1,2,1,0,5,-6,7,3,10,1,0,1,1,1,1,1,6,1
KR_6699602800,420,0,33,5,1,4,4,0,-1,5,6,-1,0,1,-1,2,3,0,0,0,0,-1,-146,-4,8,4,-5,0,0,-1,0,1,-1,5,1
KR_6747960784,420,3,9,7,3,3,4,1,-2,2,4,2,4,2,0,4,4,0,0,0,0,-8,0,0,4,4,-1,0,1,1,-1,1,1,5,1
KR_6714128306,420,-3,-5,-12,-4,0,0,0,3,5,2,2,3,1,-8,2,10,-1,3,4,0,-4,1,-1,2,1,-1,0,0,-1,1,1,-1,3,1
KR_6689786369,420,-1,20,0,-3,-2,1,3,-1,1,2,-3,3,6,3,4,1,0,0,0,0,-4,50,2,4,6,-18,0,3,1,1,1,-1,2,1
KR_6675219595,420,1,27,0,-3,-3,1,4,-2,0,2,0,1,1,2,4,2,0,2,2,0,-6,-9,-4,5,1,-3,0,-1,-1,-1,-1,1,2,1
KR_6732260453,420,0,-62,4,-1,-2,2,4,4,7,3,-2,0,2,-1,3,4,0,5,5,0,7,-4,1,3,4,1,0,-2,1,-1,-1,1,5,1
KR_6686483051,420,1,-14,10,1,4,6,2,-1,0,1,4,7,3,-5,2,7,-1,0,1,-1,-9,15,-1,6,5,-2,0,0,1,0,1,-1,6,1
KR_6761482535,420,2,-2,30,4,-3,3,6,2,3,1,2,4,2,1,4,3,2,2,0,0,4,-9,-4,6,2,3,0,0,-1,-1,-1,1,2,1
KR_6757162441,420,-3,50,6,4,0,3,3,-3,1,4,3,3,0,4,6,2,0,2,2,0,-3,41,4,1,5,-5,0,0,-1,1,1,-1,2,1
KR_6620199302,420,5,81,7,10,0,1,1,1,1,0,1,1,0,6,10,4,2,2,0,0,11,-6,1,6,7,2,0,1,-1,1,1,1,5,1
KR_6444731519,420,-1,5,-11,-7,-6,1,7,-1,1,2,2,2,0,-3,3,6,1,1,0,0,-4,7,3,3,6,-6,0,-2,0,0,-1,-1,0,1
KR_6653434115,420,-1,-63,-23,2,0,3,3,-1,3,4,5,7,2,-3,4,7,1,2,1,0,-2,117,-2,4,2,-1,0,-1,1,-1,-1,1,6,1
KR_6626784977,420,2,86,-1,2,1,3,2,-2,0,2,1,3,2,3,4,1,-1,1,2,0,-2,4,4,3,7,-3,0,1,1,-1,1,1,5,1
KR_6752651876,420,8,61,22,24,2,3,1,6,8,2,7,9,2,7,9,2,2,2,0,4,29,11,-1,4,3,-1,0,1,1,1,1,1,4,1
KR_6751024966,420,9,97,46,16,0,3,3,4,7,3,6,7,1,6,6,0,0,3,3,0,11,10,3,1,4,4,0,4,1,1,1,1,4,1
KR_6656042689,440,6,68,15,14,0,2,2,1,1,0,5,10,5,2,2,0,6,7,1,1,15,1,6,4,10,-1,0,0,1,1,1,1,1,1
KR_6742392026,440,-1,-19,24,-7,-1,1,2,-1,0,1,1,2,1,-2,3,5,-4,0,4,0,-9,-15,-2,6,4,-4,0,1,-1,1,1,-1,5,1
KR_6763144732,420,2,-3,23,2,3,4,1,-2,0,2,3,3,0,-2,0,2,0,0,0,1,-3,-16,1,4,5,-5,0,-1,0,1,-1,1,0,1
KR_6748433846,420,0,-78,20,0,0,2,2,1,2,1,4,4,0,-2,2,4,-3,0,3,0,-3,0,-1,4,3,-1,0,-2,-1,1,-1,-1,6,1
KR_6763948201,420,4,-12,-9,9,-1,0,1,4,6,2,1,1,0,5,5,0,0,0,0,0,12,-8,3,2,5,-1,0,2,-1,1,1,1,6,1
KR_6566887930,420,0,-87,-8,4,1,1,0,1,1,0,2,3,1,1,3,2,-1,0,1,0,3,-2,3,4,7,0,0,0,1,1,0,1,3,1
KR_6670710648,420,-2,10,-11,3,0,4,4,-2,2,4,0,1,1,4,5,1,1,1,0,0,1,-1,6,1,7,-2,0,0,1,-1,0,1,3,1
KR_6634031509,420,0,1,-1,-2,-2,1,3,1,3,2,-1,3,4,1,3,2,-1,0,1,-2,0,13,2,6,8,1,0,0,1,1,0,-1,1,1
KR_6734001165,420,1,-13,4,-1,-1,1,2,-1,3,4,1,5,4,1,6,5,-1,0,1,2,2,1,0,8,8,3,0,0,-1,1,1,1,1,1
KR_6757681257,420,3,-56,30,3,3,3,0,-1,3,4,-3,1,4,4,4,0,0,1,1,0,0,98,-4,6,2,31,0,1,-1,1,1,1,6,1
KR_6676025465,420,1,2,5,0,5,5,0,-1,3,4,3,5,2,-4,1,5,-3,0,3,-1,-8,8,1,4,5,-3,0,2,-1,1,1,-1,5,1
KR_6752235443,420,3,75,28,12,2,5,3,2,6,4,9,9,0,1,6,5,-2,0,2,-1,1,-3,1,2,3,2,0,3,1,1,1,-1,2,1
KR_6641752280,420,2,19,-11,7,1,1,0,-2,2,4,4,6,2,2,2,0,2,7,5,0,7,0,-1,5,4,0,0,0,1,-1,0,1,1,1
KR_6373477054,440,2,78,52,-1,3,3,0,-5,3,8,6,6,0,-5,4,9,0,1,1,1,-17,0,0,0,0,1,0,2,1,1,1,1,3,1
KR_6762397514,420,3,25,19,6,2,6,4,2,4,2,-1,3,4,0,4,4,3,4,1,3,9,328,1,5,6,2,0,0,1,1,1,1,1,1
KR_6633238886,420,3,113,49,2,-2,0,2,2,3,1,5,5,0,-3,4,7,0,2,2,0,-2,2,-1,3,2,0,0,1,0,1,1,1,0,1
KR_6620126261,420,2,24,8,-1,4,4,0,-7,3,10,-1,1,2,4,6,2,-1,0,1,-1,-5,-11,-5,6,1,1,0,1,-1,1,1,-1,2,1
KR_6694390223,420,5,-25,9,7,0,2,2,3,6,3,0,1,1,5,5,0,-1,0,1,0,6,4,-1,6,5,5,0,2,1,-1,1,1,2,1
KR_6661207282,420,3,5,4,-4,-1,1,2,-2,3,5,-1,2,3,-3,0,3,3,6,3,0,-7,20,3,3,6,-6,0,0,1,-1,0,-1,5,1
KR_6719169033,420,2,30,20,3,0,2,2,1,3,2,-3,0,3,4,5,1,1,1,0,0,-1,8,-2,7,5,-1,0,1,0,-1,1,1,0,1
KR_6661258875,420,0,-20,31,-3,-1,3,4,0,2,2,-1,1,2,-1,2,3,0,0,0,0,-2,108,-7,11,4,0,0,1,1,-1,1,-1,4,1
KR_6736447925,420,4,41,44,11,0,0,0,8,8,0,4,5,1,-2,3,5,1,1,0,0,10,-213,-4,6,2,23,0,1,1,1,1,1,5,1
KR_6759404007,420,3,78,20,9,3,3,0,1,1,0,-3,2,5,5,8,3,3,3,0,0,15,4,2,4,6,1,0,3,1,1,1,1,5,1
KR_6749350439,420,-6,-28,-16,-16,-1,3,4,-3,0,3,1,3,2,-10,0,10,-3,0,3,0,-15,-24,-2,6,4,-4,0,-2,-1,-1,-1,-1,4,1
KR_6347648344,420,1,26,12,6,3,3,0,0,3,3,0,1,1,1,4,3,2,2,0,0,6,-2,2,6,8,1,0,1,1,1,1,1,5,1
KR_6719474252,420,-2,-16,19,-6,1,1,0,-6,1,7,-5,1,6,8,10,2,-4,0,4,0,-6,-22,-3,6,3,-2,0,0,-1,-1,-1,1,1,1
KR_6721227832,420,0,50,-3,7,3,3,0,7,10,3,-5,4,9,2,5,3,0,0,0,0,7,-12,-4,8,4,0,0,1,-1,1,1,1,6,1
KR_6650153364,440,1,31,5,7,3,3,0,-2,2,4,0,4,4,3,4,1,3,4,1,1,9,-11,0,5,5,18,0,0,1,-1,-1,1,5,1
KR_6733877515,420,-1,-79,3,-3,-2,0,2,-1,3,4,1,5,4,-1,2,3,0,0,0,0,1,-18,0,5,5,-1,0,0,1,1,0,-1,2,1
KR_6749463122,420,5,119,-25,9,3,3,0,5,8,3,-1,0,1,3,3,0,-1,0,1,0,7,6,0,2,2,1,0,0,1,1,1,1,3,1
KR_6488544425,440,0,-90,11,2,2,5,3,-5,4,9,1,4,3,2,5,3,2,4,2,-4,-3,4,4,7,11,-3,0,-3,-1,-1,-1,-1,4,1
KR_6730807322,420,3,33,18,12,3,4,1,4,4,0,0,2,2,5,6,1,0,1,1,3,21,-43,1,3,4,2,0,1,1,1,-1,1,3,1
KR_6757145832,420,3,24,16,10,0,0,0,3,5,2,1,2,1,5,8,3,1,1,0,1,16,4,3,1,4,0,0,1,0,-1,1,1,0,1
KR_6751295766,440,3,-4,1,1,-2,1,3,0,0,0,0,2,2,-1,2,3,4,5,1,0,-3,3,3,3,6,1,0,-1,1,-1,1,-1,4,1
KR_6494842982,420,6,93,-24,21,1,1,0,12,13,1,0,3,3,6,6,0,2,2,0,3,30,76,2,3,5,2,0,2,-1,1,1,1,5,1
KR_6732128050,420,-2,-24,-16,2,-3,0,3,0,3,3,2,3,1,3,3,0,0,1,1,0,0,0,5,1,6,2,0,-1,-1,1,-1,1,3,1
KR_6711015533,420,1,11,10,4,-3,1,4,0,2,2,4,6,2,3,3,0,0,0,0,0,3,34,-3,5,2,-24,0,1,1,0,1,-1,2,1
KR_6736740784,420,1,16,27,-2,-2,0,2,2,5,3,-1,2,3,-1,2,3,0,0,0,0,-3,-13,-5,8,3,-2,0,0,-1,0,0,-1,3,1
KR_6762535800,420,-1,-59,25,2,-2,2,4,0,3,3,2,3,1,2,4,2,0,1,1,0,1,50,1,6,7,-20,0,0,-1,1,0,1,1,1
KR_6492132115,420,1,49,-16,-3,1,2,1,-2,1,3,-3,0,3,0,7,7,1,2,1,0,-3,7,4,3,7,-4,0,0,0,1,1,-1,0,1
KR_6755055477,420,2,46,7,-2,2,5,3,-3,1,4,-2,1,3,0,1,1,1,1,0,0,-1,-142,1,2,3,-7,0,0,1,-1,1,1,3,1
KR_6721233518,420,1,30,18,0,1,1,0,-3,4,7,3,4,1,1,3,2,-2,1,3,0,-2,-10,-4,7,3,4,0,0,-1,-1,0,1,5,1
KR_6764293623,420,1,45,24,-1,3,4,1,0,5,5,-1,2,3,-3,1,4,0,1,1,0,-5,-2,-4,8,4,2,0,1,1,1,1,1,2,1
KR_6735940949,420,-4,-79,-28,-5,1,3,2,-1,2,3,-5,1,6,0,0,0,0,1,1,0,-2,2,1,5,6,1,0,-1,-1,-1,-1,-1,2,1
KR_6339119470,440,2,-10,-23,8,2,3,1,1,5,4,2,2,0,3,4,1,0,2,2,0,11,8,-1,6,5,2,0,0,-1,1,0,-1,4,1
KR_6759683377,420,2,-42,-13,-4,-2,2,4,1,3,2,2,2,0,-4,2,6,-1,0,1,-1,4,-7,3,3,6,-2,0,1,-1,1,-1,-1,4,1
KR_6446969733,420,5,30,12,8,4,4,0,1,1,0,0,2,2,0,2,2,3,3,0,0,3,10,1,5,6,0,0,0,-1,1,0,1,2,1
KR_6709646158,420,-2,-36,8,1,2,2,0,3,5,2,-4,1,5,0,3,3,0,0,0,0,2,-2,2,3,5,3,0,0,-1,1,0,1,3,1
KR_6756073358,420,2,51,24,7,0,3,3,5,7,2,3,3,0,-2,2,4,1,2,1,0,-2,5,1,4,5,0,0,2,0,1,1,-1,0,1
KR_6700934176,420,3,8,4,2,-1,2,3,2,2,0,0,3,3,1,1,0,0,2,2,0,5,30,4,4,8,1,0,1,-1,1,1,-1,5,1
KR_6744444344,420,2,-45,40,-1,0,1,1,0,0,0,5,6,1,-5,1,6,-1,2,3,0,-6,-5,-1,8,7,1,0,0,-1,1,0,-1,4,1
KR_6756541159,420,4,-20,47,9,2,2,0,10,10,0,2,4,2,-5,1,6,0,2,2,0,-1,10,0,5,5,1,0,0,1,1,1,1,3,1
KR_6591619855,420,-1,16,-12,-7,0,2,2,-4,0,4,0,3,3,0,3,3,-3,0,3,0,-8,-1,-3,4,1,1,0,0,-1,0,0,-1,2,1
KR_6447903718,420,4,70,-11,12,2,4,2,-3,4,7,4,4,0,3,5,2,6,6,0,1,10,1,-1,5,4,2,0,1,1,0,1,1,5,1
KR_6760429901,420,2,-42,-8,1,1,3,2,5,5,0,4,4,0,-9,0,9,0,3,3,0,-12,-3,4,0,4,-4,0,0,-1,1,-1,1,3,1
KR_6762460663,420,2,49,12,-1,1,1,0,1,3,2,-1,3,4,-3,3,6,1,1,0,-2,-4,3,1,6,7,-7,0,0,1,-1,0,-1,4,1
KR_6700201067,420,3,71,4,6,3,4,1,2,3,1,2,3,1,1,3,2,-2,0,2,0,5,6,2,2,4,-1,0,3,-1,1,1,1,3,1
KR_6661784939,420,-1,-50,7,-2,0,0,0,-3,6,9,-1,3,4,4,5,1,-2,2,4,-1,-10,3,3,7,10,-6,0,0,1,1,-1,-1,5,1
KR_6761989352,420,6,102,36,12,5,6,1,-1,2,3,5,6,1,2,4,2,1,2,1,1,4,52,-1,3,2,-21,0,1,0,0,1,1,0,1
KR_6682020974,420,4,70,-16,12,8,9,1,4,4,0,3,5,2,-1,2,3,-2,1,3,0,5,6,-1,5,4,1,0,3,1,1,1,1,3,1
KR_6667310322,420,0,39,-4,2,3,4,1,0,0,0,-1,2,3,0,0,0,0,0,0,1,3,-252,-2,5,3,1,0,0,-1,1,1,1,4,1
KR_6761575041,420,-2,13,-4,-4,0,0,0,0,2,2,-1,1,2,-2,3,5,-1,0,1,1,-12,12,0,7,7,-6,0,1,-1,1,1,1,4,1
KR_6757021596,420,1,61,-16,1,1,5,4,-3,1,4,-2,1,3,4,7,3,1,1,0,0,3,-173,-6,9,3,-2,0,1,1,-1,1,-1,3,1
KR_6584954146,440,4,-6,3,2,1,1,0,5,5,0,-3,1,4,-3,3,6,2,2,0,0,5,2,0,2,2,0,0,0,-1,1,-1,1,4,1
KR_6759925981,420,2,53,-3,3,3,4,1,-1,1,2,3,3,0,-1,2,3,-1,0,1,0,-4,-8,0,6,6,2,0,0,1,1,1,1,5,1
KR_6649497110,420,-2,-88,53,7,7,8,1,2,2,0,-1,4,5,-1,2,3,0,1,1,-1,-1,-14,-2,3,1,2,0,-1,0,1,1,-1,0,1
KR_6762052346,420,3,11,4,14,7,8,1,2,3,1,3,5,2,2,4,2,0,0,0,1,7,9,6,0,6,2,0,2,-1,1,1,1,1,1
KR_6761690715,420,6,40,15,10,7,8,1,0,2,2,1,3,2,0,1,1,2,2,0,0,9,-6,-1,4,3,2,0,0,0,-1,0,-1,0,1
KR_6702935263,420,1,-10,15,0,-2,2,4,6,7,1,-1,1,2,-1,1,2,-2,0,2,0,1,41,2,7,9,0,0,1,1,-1,1,-1,6,1
KR_6649312254,420,-3,-14,9,-6,-3,1,4,0,0,0,-3,2,5,0,2,2,0,0,0,0,-9,12,1,3,4,2,0,0,-1,-1,0,1,4,1
KR_6303252341,420,0,18,-4,-1,2,6,4,0,7,7,1,2,1,0,0,0,-4,0,4,0,-4,56,0,1,1,-14,0,1,1,0,1,-1,3,1
KR_5681894694,420,2,37,48,2,-3,1,4,3,3,0,-2,3,5,3,4,1,1,2,1,0,7,-2,0,3,3,3,0,4,-1,1,1,-1,5,1
KR_6665519571,420,0,-18,-11,2,-1,0,1,1,4,3,3,4,1,-3,0,3,2,2,0,0,0,-4,-4,7,3,2,0,0,0,-1,0,1,0,1
KR_6726584856,420,6,114,15,14,-1,1,2,3,6,3,4,5,1,9,9,0,-1,0,1,0,9,-14,-1,4,3,4,0,3,1,1,1,-1,1,1
KR_6758489141,420,6,98,11,18,5,5,0,1,2,1,9,9,0,3,7,4,0,2,2,0,14,-23,-3,8,5,4,0,4,1,1,1,-1,2,1
KR_6760252611,440,-1,0,-16,2,-5,0,5,-1,3,4,2,3,1,5,5,0,1,1,0,0,0,3,2,3,5,-1,0,0,1,1,0,1,5,1
KR_6661682894,420,0,56,-27,-1,1,2,1,-2,1,3,-1,0,1,2,3,1,-1,0,1,0,-3,-41,-2,7,5,3,0,1,1,-1,1,-1,4,1
KR_6674135080,420,4,96,-16,9,3,3,0,2,6,4,2,2,0,1,3,2,1,2,1,0,15,21,1,4,5,3,0,2,1,-1,1,1,4,1
KR_6657381831,420,6,-21,11,13,7,8,1,1,3,2,4,5,1,2,3,1,-1,0,1,0,6,-2,-3,5,2,4,0,0,1,1,1,1,4,1
KR_6584874351,440,4,-9,17,11,2,3,1,-1,2,3,2,3,1,5,6,1,3,5,2,1,7,1,-4,8,4,6,0,0,1,-1,0,1,1,1
KR_6761011646,420,-3,80,-20,0,1,3,2,-1,2,3,2,2,0,1,2,1,-3,0,3,0,-6,-7,-2,6,4,2,0,1,-1,1,1,1,4,1
KR_6692358554,420,1,-48,4,3,-1,2,3,2,3,1,-1,0,1,2,3,1,1,2,1,0,3,-36,-5,9,4,4,0,1,-1,0,1,-1,4,1
KR_6703677320,420,-1,3,-8,-2,-2,3,5,0,4,4,2,4,2,-3,2,5,1,2,1,0,2,-8,0,7,7,5,0,0,-1,0,0,1,4,1
KR_6733174265,440,4,107,48,4,3,3,0,-1,2,3,-1,5,6,2,2,0,1,1,0,1,-7,-8,-6,8,2,-1,0,2,1,1,1,1,5,1
KR_6675074171,420,1,16,-20,4,3,3,0,2,4,2,2,5,3,-3,2,5,0,1,1,0,-1,4,2,3,5,1,0,0,1,1,1,1,1,1
KR_6741806414,420,3,30,39,13,1,2,1,7,10,3,5,6,1,-1,6,7,1,3,2,4,12,2,-1,4,3,3,0,2,1,1,1,1,6,1
KR_6760665242,440,2,38,10,11,6,7,1,1,3,2,3,3,0,2,5,3,-1,1,2,0,10,12,-1,5,4,-4,0,0,1,1,1,1,1,1
KR_6755345602,420,3,83,-8,9,2,4,2,1,2,1,-2,0,2,7,7,0,1,1,0,0,9,164,3,2,5,2,0,0,1,1,0,1,3,1
KR_6714908556,440,0,-38,16,-4,3,3,0,5,9,4,-4,1,5,-6,2,8,-2,1,3,0,-13,-27,1,4,5,-1,0,1,-1,1,1,-1,3,1
KR_6730115598,420,0,-24,-4,7,5,5,0,7,8,1,0,2,2,-1,0,1,-4,2,6,0,6,-20,2,0,2,9,0,-1,-1,-1,-1,1,3,1
KR_6729986476,420,1,21,-4,10,2,2,0,8,10,2,1,2,1,0,1,1,-1,4,5,0,18,-13,-3,4,1,0,0,-1,0,-1,-1,1,0,1
KR_6760551657,420,1,30,4,4,4,4,0,1,4,3,2,3,1,-2,2,4,-1,0,1,0,2,8,-4,9,5,2,0,1,-1,1,1,1,4,1
KR_6557810475,420,-2,38,4,0,-1,2,3,5,8,3,3,5,2,-5,0,5,-2,0,2,0,5,20,2,3,5,-1,0,0,1,1,0,-1,6,1
KR_6623347001,420,4,95,24,9,-3,0,3,3,4,1,5,5,0,4,8,4,0,0,0,0,10,-11,6,2,8,2,0,1,1,1,1,-1,1,1
KR_6763712512,420,-2,2,-12,-7,2,2,0,-2,0,2,-4,2,6,-4,2,6,1,1,0,0,1,-21,-2,5,3,1,0,1,-1,0,1,-1,1,1
KR_6760597170,420,1,40,16,-4,2,3,1,-1,2,3,-3,1,4,1,5,4,-3,2,5,0,-6,-5,-1,4,3,6,0,-1,1,1,-1,-1,5,1
KR_6681359610,420,-2,45,-9,-1,0,3,3,-2,2,4,0,3,3,1,1,0,0,1,1,0,-4,11,1,4,5,-1,0,0,-1,-1,-1,1,1,1
KR_6674184421,420,-2,9,-13,-1,-2,0,2,3,3,0,-3,0,3,2,5,3,-1,3,4,0,7,7,9,2,11,-4,0,0,-1,-1,0,-1,6,1
KR_6742486526,420,4,19,38,9,-1,1,2,1,3,2,4,4,0,3,5,2,2,2,0,1,17,-1,0,3,3,-1,0,3,1,1,1,1,5,1
KR_6576896318,420,-5,-117,-12,-6,-1,3,4,-6,1,7,-1,4,5,3,4,1,-1,1,2,0,1,-107,-3,5,2,0,0,-2,1,1,-1,-1,6,1
KR_6758815546,420,10,6,120,18,6,8,2,6,7,1,3,3,0,0,2,2,3,5,2,0,10,4,5,2,7,1,0,3,1,1,1,1,2,1
KR_6758884303,420,2,-49,27,5,2,3,1,-1,0,1,-5,1,6,7,7,0,2,2,0,1,4,-2,-1,5,4,2,0,2,-1,1,1,1,3,1
KR_6730122820,420,2,18,12,8,-1,1,2,-4,1,5,3,5,2,7,7,0,3,4,1,0,11,4,4,1,5,3,0,0,1,-1,1,1,4,1
KR_6705931064,420,2,24,-9,7,6,6,0,9,9,0,-6,1,7,-1,1,2,-1,3,4,0,4,-5,3,2,5,-2,0,0,-1,1,1,-1,3,1
KR_6638329347,440,4,104,44,7,7,9,2,-7,1,8,4,4,0,4,6,2,-1,1,2,0,-7,1,2,5,7,-1,0,1,1,1,1,1,3,1
KR_6711319970,420,6,112,16,15,8,8,0,5,6,1,2,3,1,1,5,4,-1,2,3,0,7,7,2,1,3,1,0,4,1,1,1,1,1,1
KR_6757417844,420,1,-12,24,4,-3,1,4,4,4,0,1,4,3,2,2,0,0,0,0,1,2,-4,0,5,5,4,0,0,1,-1,-1,1,5,1
KR_6534976599,440,4,-13,30,9,1,3,2,0,1,1,-1,2,3,7,8,1,2,2,0,0,19,-62,-1,6,5,0,0,0,-1,1,1,-1,6,1
KR_6716444926,440,3,-46,8,8,2,5,3,0,1,1,1,2,1,3,4,1,2,2,0,0,10,7,-2,3,1,0,0,0,1,0,0,1,5,1
KR_6725824599,420,1,72,12,-9,1,1,0,-1,6,7,-7,0,7,0,3,3,-2,1,3,0,-10,-15,-1,4,3,-2,0,1,-1,1,1,-1,1,1
KR_6729047654,420,5,65,19,13,-2,0,2,5,5,0,5,8,3,4,6,2,1,2,1,0,16,5,-1,7,6,3,0,1,0,1,1,-1,0,1
KR_6763635140,420,2,20,2,9,0,2,2,-1,2,3,4,6,2,6,9,3,0,1,1,-1,9,5,7,4,11,-4,0,1,1,1,1,-1,3,1
KR_6636153150,420,2,111,16,4,3,3,0,2,8,6,0,2,2,0,2,2,-1,0,1,2,2,1,-2,6,4,0,0,0,1,1,0,1,5,1
KR_6762213511,420,1,-20,-8,6,0,2,2,-2,1,3,8,9,1,0,2,2,0,1,1,-1,3,365,-2,5,3,3,0,1,0,1,1,-1,0,1
KR_6502334495,420,5,69,16,7,1,4,3,1,2,1,8,8,0,-3,1,4,0,0,0,0,5,44,3,2,5,-17,0,0,1,0,0,-1,1,1
KR_6737952030,420,3,27,32,10,3,3,0,0,1,1,6,7,1,2,5,3,-1,0,1,0,4,-8,0,5,5,1,0,1,1,1,1,1,4,1
KR_6663571148,420,-1,24,4,-2,3,4,1,2,4,2,-2,2,4,-3,0,3,-2,1,3,0,-5,-24,-1,4,3,3,0,1,1,-1,1,-1,5,1
KR_6725543563,420,2,31,-4,9,1,3,2,1,2,1,2,2,0,3,4,1,2,2,0,0,10,178,-2,5,3,4,0,0,1,1,0,1,1,1
KR_6727480718,420,-1,-20,8,7,1,2,1,3,7,4,1,3,2,0,4,4,2,3,1,0,8,30,1,4,5,2,0,1,0,1,1,1,0,1
KR_6751967171,440,1,81,-12,-3,1,3,2,-4,1,5,-1,5,6,1,3,2,0,0,0,-1,-4,4,2,4,6,-15,0,0,0,-1,0,-1,0,1
KR_6717493752,420,4,83,-16,10,2,3,1,3,4,1,-1,2,3,5,5,0,1,1,0,0,14,5,0,4,4,-4,0,1,1,1,1,1,3,1
KR_6754307769,440,8,55,8,12,5,5,0,1,2,1,5,6,1,-1,7,8,2,4,2,1,8,-23,2,3,5,25,0,3,1,1,1,1,5,1
KR_6752554840,420,1,28,-8,2,-4,0,4,-1,1,2,0,2,2,6,6,0,1,1,0,0,8,-1,3,1,4,1,0,0,-1,1,1,-1,3,1
KR_6730223445,420,-2,-57,-4,-1,-1,2,3,0,4,4,-3,0,3,2,7,5,1,2,1,0,1,3,-1,6,5,0,0,-1,1,1,-1,1,5,1
KR_6633138639,420,1,36,9,3,-1,3,4,2,2,0,0,2,2,2,2,0,0,0,0,0,6,-20,2,4,6,2,0,-1,1,-1,-1,-1,2,1
KR_6654185396,420,0,38,-9,0,-3,1,4,1,4,3,-1,1,2,1,2,1,2,2,0,0,5,1,5,3,8,-1,0,-1,1,-1,-1,-1,6,1
KR_6755832156,420,4,19,30,11,-1,0,1,2,4,2,2,5,3,8,8,0,0,0,0,0,10,4,4,4,8,0,0,2,1,1,1,1,2,1
KR_6629704003,420,6,60,8,11,4,5,1,8,11,3,-3,2,5,1,2,1,1,3,2,1,11,-4,4,1,5,3,0,2,1,1,1,1,1,1
KR_6762454688,420,1,20,29,2,3,4,1,1,3,2,-2,3,5,-2,1,3,2,2,0,0,1,-11,-3,4,1,1,0,0,1,1,1,1,1,1
KR_6599581930,420,2,24,16,20,1,3,2,5,7,2,-2,2,4,11,13,2,5,5,0,1,34,2,1,3,4,0,0,1,1,0,1,1,2,1
KR_6736607343,440,4,43,14,7,1,1,0,3,3,0,5,7,2,0,2,2,-2,1,3,1,4,-25,0,4,4,-1,0,1,1,1,1,1,6,1
KR_6703558304,420,2,21,32,2,2,3,1,1,3,2,-1,3,4,1,2,1,-1,1,2,0,4,18,-3,6,3,-2,0,-1,1,-1,-1,-1,5,1
KR_6649411753,420,2,18,-7,9,3,3,0,-2,1,3,0,1,1,7,9,2,1,2,1,0,1,-10,-2,6,4,4,0,1,1,1,1,-1,1,1
KR_6741311192,420,3,19,9,11,0,0,0,1,1,0,0,3,3,8,9,1,2,2,0,0,17,24,2,2,4,7,0,1,1,1,1,1,6,1
KR_6733798656,420,4,89,0,2,3,4,1,-3,0,3,1,3,2,0,2,2,1,1,0,0,-2,2,-2,4,2,0,0,1,1,1,1,1,3,1
KR_6723196641,420,5,55,25,4,3,6,3,1,3,2,2,3,1,1,3,2,-3,1,4,0,-6,-13,1,4,5,-3,0,0,-1,1,0,1,1,1
KR_6601137856,420,8,24,28,13,3,3,0,4,4,0,6,8,2,-1,4,5,1,2,1,0,0,-1,-1,3,2,0,0,1,1,1,1,1,1,1
KR_6506249421,420,-1,-22,3,3,-3,1,4,5,6,1,-3,1,4,1,3,2,3,3,0,1,10,-394,-1,7,6,2,0,0,1,0,0,1,3,1
KR_6757947186,420,4,104,12,25,2,2,0,0,2,2,6,10,4,14,16,2,3,5,2,2,40,6,3,0,3,1,0,1,1,1,1,1,5,1
KR_6759039136,440,0,67,-13,3,0,3,3,-1,4,5,-3,3,6,9,10,1,-2,1,3,2,8,12,9,1,10,-8,0,0,-1,1,0,-1,5,1
KR_6591965072,420,0,30,30,2,-2,0,2,1,5,4,0,2,2,3,5,2,0,3,3,0,4,-8,-2,5,3,2,0,0,1,0,0,-1,5,1
KR_6724357775,440,0,-1,8,2,3,3,0,1,2,1,0,2,2,-2,0,2,0,0,0,1,2,-7,4,3,7,-2,0,0,1,-1,0,1,1,1
KR_6759113147,420,3,16,12,0,0,4,4,2,2,0,1,1,0,-2,0,2,-1,2,3,-1,3,-22,0,4,4,4,0,-1,1,-1,-1,-1,3,1
KR_6749637834,420,-3,-27,-4,0,0,1,1,0,3,3,-1,2,3,0,6,6,1,1,0,0,7,7,5,0,5,0,0,-1,-1,1,-1,-1,3,1
KR_6763243417,420,1,47,4,7,0,2,2,0,4,4,2,3,1,2,5,3,3,3,0,0,7,9,1,3,4,3,0,2,-1,1,1,-1,1,1
KR_6339174171,440,-1,64,5,-3,5,6,1,0,2,2,-3,0,3,0,2,2,-5,0,5,-1,-3,-3,1,5,6,-4,0,0,1,0,1,-1,1,1
KR_6727449041,420,-1,23,-16,-8,-1,3,4,-6,0,6,0,2,2,-2,2,4,1,1,0,0,-11,-3,6,3,9,0,0,0,-1,0,-1,1,5,1
KR_6633954460,420,1,-11,-40,0,1,1,0,2,5,3,3,5,2,-1,2,3,-5,0,5,0,-3,4,3,4,7,-1,0,-1,1,-1,-1,1,3,1
KR_6764432686,440,4,113,24,5,4,4,0,2,2,0,-1,1,2,-2,1,3,2,2,0,2,6,-42,-1,4,3,26,0,0,0,0,-1,1,0,1
KR_6759011866,420,6,82,8,9,1,3,2,-1,0,1,3,4,1,5,9,4,1,2,1,0,6,14,1,4,5,-1,0,2,-1,-1,1,1,5,1
KR_6734391550,420,-3,-32,8,-7,-3,1,4,1,1,0,0,4,4,-5,2,7,0,3,3,0,-6,-8,-3,5,2,3,0,0,-1,1,0,-1,2,1
KR_6586808988,420,3,21,0,5,2,2,0,2,5,3,0,2,2,1,5,4,0,0,0,1,4,-15,2,6,8,2,0,2,1,1,1,1,6,1
KR_6763734310,420,1,-2,8,2,-1,2,3,6,6,0,-1,1,2,0,0,0,-2,1,3,0,-1,-322,1,4,5,0,0,0,-1,1,1,-1,2,1
KR_6674091599,420,3,19,16,5,3,4,1,2,4,2,2,4,2,1,1,0,-3,1,4,1,8,-3,-1,3,2,5,0,1,1,1,1,1,6,1
KR_6740561679,420,5,20,32,8,2,3,1,0,2,2,3,4,1,3,7,4,0,2,2,1,6,20,6,4,10,-4,0,1,1,1,1,-1,4,1
KR_6760703194,420,0,57,13,-2,-2,1,3,-1,1,2,1,3,2,-1,1,2,1,1,0,0,-1,-5,-3,5,2,1,0,-1,-1,-1,-1,-1,5,1
KR_6685775574,420,-3,-40,-33,-1,-2,1,3,-1,3,4,0,3,3,0,1,1,2,2,0,0,4,-97,4,5,9,-2,0,0,1,-1,-1,-1,3,1
KR_6735401883,420,3,100,17,11,1,2,1,7,7,0,1,1,0,4,6,2,-2,1,3,0,5,191,3,2,5,-2,0,1,1,-1,1,1,1,1
KR_6751765149,420,1,-10,-8,-5,0,3,3,3,5,2,1,4,3,-6,1,7,-3,1,4,1,-5,-23,1,6,7,-1,0,-1,-1,-1,-1,1,1,1
KR_6633116277,420,1,15,-5,3,-7,1,8,3,5,2,0,2,2,9,10,1,-2,2,4,0,-1,-10,-4,8,4,-3,0,0,1,-1,-1,1,4,1
KR_6763231625,440,1,80,14,3,3,5,2,-2,2,4,0,3,3,3,6,3,-1,0,1,0,-1,-4,-4,7,3,1,0,1,1,0,1,1,6,1
KR_6681996736,440,0,-94,16,-1,-2,2,4,5,5,0,2,2,0,-5,2,7,-1,3,4,0,2,1,3,4,7,-1,0,-1,1,0,-1,-1,4,1
KR_6738946146,420,0,20,-44,-2,0,0,0,4,5,1,-1,1,2,-3,2,5,-2,0,2,0,-1,73,-3,5,2,-3,0,0,1,1,1,1,1,1
KR_6665588875,420,-1,-12,-52,3,8,8,0,5,9,4,-7,0,7,-1,2,3,-2,5,7,1,0,17,2,5,7,4,0,-1,1,-1,-1,1,3,1
KR_6699513545,420,5,45,33,9,0,1,1,4,6,2,1,3,2,3,4,1,1,2,1,0,9,-1,-3,7,4,-1,0,0,1,1,1,1,4,1
KR_6636013928,420,2,35,-9,11,-2,2,4,4,6,2,3,4,1,4,8,4,2,2,0,-1,17,2,1,2,3,1,0,1,-1,1,1,-1,2,1
KR_6759473096,420,2,-38,-2,5,-1,3,4,6,9,3,1,1,0,-3,1,4,2,2,0,0,4,7,5,1,6,-4,0,-1,-1,-1,-1,-1,6,1
KR_6669637650,420,2,38,21,12,0,1,1,1,3,2,5,5,0,6,7,1,0,1,1,0,10,53,2,4,6,-30,0,1,1,1,1,1,1,1
KR_6658385237,420,2,66,-8,0,-3,2,5,-3,2,5,1,2,1,5,7,2,0,2,2,0,-1,26,0,4,4,-22,0,0,-1,-1,1,1,5,1
KR_6629742529,420,1,85,-9,2,0,3,3,-2,0,2,-1,1,2,3,4,1,2,2,0,0,2,-7,-3,5,2,4,0,1,1,0,1,1,1,1
KR_6667772412,420,2,29,8,6,1,1,0,7,7,0,0,5,5,0,1,1,-2,0,2,0,11,11,7,2,9,-3,0,0,1,1,0,-1,2,1
KR_6739914099,420,-2,26,8,-2,1,4,3,-1,3,4,1,3,2,-2,1,3,-1,0,1,-1,-5,-9,-3,6,3,4,0,-1,1,-1,-1,-1,2,1
KR_6683595928,420,3,53,-23,2,2,4,2,2,3,1,6,7,1,-9,0,9,1,2,1,0,-4,170,-1,11,10,1,0,2,-1,-1,1,-1,4,1
KR_6508350509,420,0,-17,0,-3,0,0,0,0,0,0,4,4,0,-5,2,7,-2,0,2,-1,-3,-87,0,4,4,0,0,0,-1,1,-1,-1,5,1
KR_6747698683,420,1,-16,15,-1,3,4,1,-4,1,5,2,6,4,-1,0,1,-1,0,1,0,-8,-10,4,4,8,3,0,0,1,-1,0,1,5,1
KR_6716263719,440,-1,43,4,-2,1,5,4,-1,1,2,0,2,2,-4,1,5,2,3,1,0,-2,-18,3,5,8,2,0,0,-1,-1,0,1,4,1
KR_6749092126,420,2,33,10,9,-1,3,4,4,9,5,5,6,1,2,4,2,-1,0,1,0,15,41,5,2,7,-4,0,0,1,1,1,1,4,1
KR_6667747512,420,2,-59,15,4,3,3,0,3,3,0,0,0,0,-2,0,2,0,0,0,0,1,122,2,4,6,-3,0,1,0,1,1,1,0,1
KR_6730763532,420,3,25,32,9,-1,4,5,7,8,1,2,5,3,1,2,1,0,1,1,1,10,13,-2,5,3,-3,0,2,-1,1,1,-1,6,1
KR_6035625026,420,0,22,-22,1,0,1,1,0,4,4,2,3,1,-2,2,4,1,2,1,0,-2,28,-1,5,4,-4,0,0,-1,1,1,1,4,1
KR_6749601942,420,1,76,1,1,3,4,1,3,4,1,-1,1,2,-6,1,7,2,2,0,0,-3,-6,-7,15,8,2,0,2,-1,-1,1,-1,5,1
KR_6758352513,420,4,29,28,7,2,2,0,3,4,1,3,3,0,-2,2,4,1,1,0,0,11,3,2,4,6,0,0,0,1,1,0,1,6,1
KR_6597387966,420,0,11,-17,4,-2,1,3,2,5,3,4,6,2,2,2,0,-2,0,2,0,3,-220,1,5,6,5,0,0,-1,-1,0,1,4,1
KR_6762327901,420,0,4,-4,1,4,5,1,-2,1,3,1,1,0,-1,3,4,-1,0,1,0,4,-5,-1,4,3,0,0,1,1,-1,1,-1,5,1
KR_6758490356,420,1,1,8,-3,1,3,2,-4,0,4,0,3,3,-1,4,5,1,1,0,0,-4,3,-4,9,5,1,0,0,-1,1,0,-1,6,1
KR_6758071334,440,0,86,11,1,0,1,1,2,3,1,-2,0,2,-1,1,2,2,5,3,0,0,5,-1,2,1,-3,0,1,0,1,1,-1,0,1
KR_6420062638,420,4,60,-24,4,0,1,1,-1,2,3,2,4,2,3,3,0,0,0,0,0,-3,-34,-1,7,6,7,0,1,0,1,1,1,0,1
KR_6718791445,440,-1,41,4,1,0,0,0,0,4,4,-1,0,1,1,5,4,1,2,1,0,4,-257,2,3,5,1,0,-1,1,0,-1,-1,6,1
KR_6748405067,420,1,-72,16,-3,3,3,0,0,3,3,-7,1,8,1,2,1,0,1,1,1,-5,-109,0,4,4,-8,0,0,1,1,-1,1,3,1
KR_6686517581,420,2,45,24,8,2,2,0,2,3,1,5,9,4,0,4,4,-1,2,3,1,3,3,2,4,6,2,0,0,1,1,1,1,1,1
KR_6725238409,420,-2,-47,4,-1,2,3,1,1,6,5,-3,0,3,0,2,2,-1,0,1,0,6,10,-1,5,4,0,0,0,1,1,1,-1,6,1
KR_6761571859,420,-2,-40,0,1,-2,1,3,-5,2,7,2,3,1,6,7,1,0,0,0,0,7,20,1,3,4,2,0,-1,1,0,1,1,6,1
KR_6758389907,420,0,111,-17,0,1,4,3,-2,2,4,0,2,2,0,5,5,1,1,0,0,1,281,-5,7,2,3,0,0,1,1,0,1,5,1
KR_6729451741,420,1,-2,33,-3,-3,1,4,0,2,2,1,2,1,-1,3,4,0,2,2,0,0,6,2,3,5,-1,0,0,1,-1,0,1,6,1
KR_6759693988,440,-1,24,4,0,0,0,0,-1,1,2,4,5,1,-2,0,2,-1,0,1,0,-4,6,4,3,7,-6,0,0,-1,1,0,1,5,1
KR_6742169981,440,4,19,-17,12,2,2,0,4,4,0,1,2,1,3,3,0,2,2,0,0,12,-13,3,6,9,0,0,0,1,1,1,1,2,1
KR_6754216687,420,2,-17,8,2,1,2,1,3,3,0,-3,2,5,2,6,4,-1,2,3,0,10,-22,0,4,4,1,0,0,1,1,0,1,3,1
KR_6757119552,420,4,73,20,10,4,7,3,-1,3,4,4,5,1,3,3,0,0,0,0,0,3,-2,3,2,5,-1,0,1,1,1,1,1,5,1
KR_6728332075,440,1,49,8,5,-2,1,3,3,5,2,2,2,0,0,4,4,2,2,0,1,8,41,5,2,7,-25,0,0,-1,1,0,1,3,1
KR_6755766696,420,1,104,4,-3,1,2,1,-2,3,5,-3,1,4,0,5,5,1,2,1,0,-5,34,1,5,6,-15,0,0,-1,-1,1,1,3,1
KR_6751963379,420,0,27,-4,4,3,4,1,-2,2,4,5,8,3,-2,3,5,0,2,2,0,-5,-23,-2,8,6,3,0,3,1,-1,1,-1,3,1
KR_6546351176,420,7,104,65,11,0,2,2,1,2,1,2,4,2,7,9,2,1,1,0,0,10,-6,4,4,8,-1,0,2,1,-1,1,-1,5,1
KR_6510858677,420,0,12,24,-4,-2,2,4,1,3,2,1,3,2,0,3,3,-4,2,6,0,0,30,4,0,4,-4,0,0,-1,1,1,1,5,1
KR_6761719983,420,3,-34,-22,5,0,0,0,1,4,3,-2,2,4,5,6,1,1,2,1,0,17,-1,0,2,2,0,0,0,-1,-1,0,-1,5,1
KR_6753118238,440,0,-25,0,6,6,6,0,3,5,2,1,3,2,-4,0,4,0,0,0,0,1,-7,0,5,5,-1,0,1,-1,1,1,1,3,1
KR_6758187556,420,1,52,0,4,0,1,1,1,2,1,0,2,2,3,4,1,0,0,0,0,3,22,0,6,6,6,0,1,1,1,1,1,5,1
KR_6615416183,420,-3,-17,-8,-9,-3,2,5,1,4,3,0,1,1,-4,2,6,-3,1,4,0,-6,-6,0,4,4,-1,0,-1,-1,-1,-1,-1,5,1
KR_6512440272,420,2,21,16,4,1,3,2,5,6,1,2,3,1,-2,4,6,-2,2,4,0,3,-10,-2,4,2,7,0,1,1,1,1,1,2,1
KR_6738874917,420,2,20,-16,4,0,2,2,5,6,1,2,4,2,-3,0,3,0,0,0,1,2,-6,-5,6,1,0,0,1,1,-1,1,1,6,1
KR_6747857223,420,0,14,6,-5,0,0,0,-2,3,5,0,4,4,-2,1,3,-1,1,2,-1,-13,3,0,4,4,0,0,0,0,-1,1,-1,0,1
KR_6757451319,420,8,60,49,19,3,5,2,1,3,2,6,7,1,6,9,3,3,4,1,0,9,0,4,3,7,5,0,1,1,1,1,1,1,1
KR_6760831686,420,1,4,-13,8,2,3,1,4,6,2,-2,0,2,2,5,3,2,2,0,0,8,-11,-1,4,3,4,0,1,-1,1,1,-1,6,1
KR_6717690683,420,3,-28,-4,8,-1,2,3,3,4,1,5,6,1,2,2,0,-1,1,2,0,11,1,-5,8,3,3,0,1,-1,1,1,-1,4,1
KR_6757392757,420,1,25,7,-1,1,2,1,1,4,3,1,4,3,-4,1,5,0,1,1,0,-2,-6,3,3,6,2,0,0,-1,-1,0,-1,2,1
KR_6652919829,420,-1,-48,-1,-1,1,2,1,-3,3,6,1,1,0,0,2,2,0,2,2,0,1,12,0,6,6,1,0,0,1,-1,-1,-1,1,1
KR_6732483521,420,-1,-14,-11,0,1,2,1,-5,1,6,4,4,0,-4,0,4,4,6,2,0,-4,-4,0,4,4,-1,0,-1,-1,-1,-1,-1,1,1
KR_6632701009,440,4,44,-4,6,0,2,2,0,2,2,5,5,0,1,1,0,0,2,2,0,1,-4,-2,5,3,0,0,2,1,0,1,1,4,1
KR_6592198110,420,3,82,9,11,-1,0,1,5,7,2,0,0,0,5,6,1,2,2,0,0,16,10,5,3,8,-2,0,1,1,1,1,1,2,1
KR_6746392512,420,0,-48,4,-1,-3,1,4,-1,1,2,4,6,2,1,4,3,-2,1,3,-1,0,-24,-3,5,2,-4,0,0,1,1,0,-1,2,1
KR_6700378403,420,-2,-31,-17,0,1,3,2,3,4,1,0,1,1,-6,1,7,2,4,2,-1,3,24,3,6,9,-8,0,1,-1,1,1,-1,4,1
KR_6403891783,420,4,65,13,12,3,3,0,1,1,0,-1,2,3,8,8,0,1,1,0,0,18,23,2,4,6,0,0,1,1,-1,1,1,5,1
KR_6762565933,420,0,-54,14,2,2,4,2,4,6,2,-2,0,2,1,3,2,-3,0,3,0,5,31,3,3,6,-1,0,0,1,1,0,-1,4,1
KR_6274751251,420,-2,20,-4,-3,-1,1,2,1,2,1,0,2,2,-1,3,4,-2,2,4,1,3,-7,0,5,5,0,0,1,0,-1,1,1,0,1
KR_6490958993,420,2,-3,-8,2,1,3,2,0,4,4,2,6,4,-2,2,4,1,1,0,0,1,-2,2,3,5,-4,0,1,1,1,1,-1,1,1
KR_6675485652,420,-4,6,-16,-10,-1,2,3,-1,1,2,-5,0,5,0,0,0,-3,0,3,0,-6,-1,-3,5,2,-2,0,0,1,-1,-1,1,1,1
KR_6653119804,420,-1,3,-49,1,-2,1,3,0,2,2,-1,2,3,1,3,2,3,3,0,0,8,36,-1,3,2,-1,0,0,1,-1,-1,1,4,1
KR_6757691336,420,4,-21,17,9,2,4,2,0,0,0,4,9,5,1,4,3,2,2,0,0,7,10,3,6,9,0,0,-1,0,1,-1,1,0,1
KR_6746290970,420,7,122,-4,6,3,3,0,1,4,3,-2,2,4,2,2,0,2,2,0,0,8,-1,3,5,8,3,0,2,1,1,1,1,1,1
KR_6649453929,420,2,2,16,4,-1,0,1,-1,1,2,1,3,2,4,7,3,1,2,1,0,6,-6,-5,8,3,0,0,0,-1,1,0,1,2,1
KR_6728036684,440,2,55,0,-3,0,1,1,0,2,2,1,2,1,-1,3,4,-3,0,3,-1,-6,3,-3,8,5,-1,0,0,-1,1,0,-1,6,1
KR_6729752619,420,1,63,-9,7,4,4,0,-2,0,2,-1,0,1,5,6,1,1,1,0,0,2,8,3,3,6,-2,0,0,-1,-1,1,1,4,1
KR_6733706348,420,0,14,4,-3,-2,0,2,1,1,0,2,5,3,-4,1,5,0,0,0,0,-5,9,-1,5,4,-3,0,0,0,1,0,-1,0,1
KR_6760827214,420,2,12,8,5,3,4,1,0,2,2,3,4,1,0,1,1,-1,0,1,0,6,12,-1,9,8,-5,0,0,-1,1,1,1,3,1
KR_6744588202,420,3,1,-24,7,1,1,0,0,2,2,5,6,1,2,5,3,-1,1,2,0,3,-1,-1,5,4,2,0,1,-1,0,1,-1,2,1
KR_6761431898,420,-2,36,-11,-6,4,5,1,-3,1,4,-1,0,1,-6,1,7,0,1,1,0,-12,8,5,3,8,-4,0,0,-1,1,1,-1,4,1
KR_6751807096,420,7,26,44,15,-1,0,1,5,7,2,5,6,1,3,5,2,3,3,0,0,15,5,3,2,5,0,0,2,1,1,1,1,5,1
KR_6700197680,420,4,22,43,11,3,4,1,7,8,1,2,4,2,0,1,1,-1,0,1,0,9,-10,-5,8,3,4,0,0,1,-1,0,1,3,1
KR_6664551828,420,3,5,5,5,-2,0,2,3,4,1,1,5,4,3,4,1,0,0,0,0,4,141,0,7,7,-2,0,1,-1,1,1,1,2,1
KR_6738064258,440,3,17,14,7,1,2,1,0,4,4,2,2,0,6,6,0,-2,0,2,0,2,5,3,2,5,0,0,1,1,0,1,1,1,1
KR_6692980157,420,1,32,8,0,5,6,1,2,2,0,-5,0,5,-1,1,2,-1,3,4,0,-5,2,-2,5,3,-1,0,1,1,0,1,-1,1,1
KR_6742243589,420,3,106,19,7,7,7,0,0,3,3,6,7,1,-3,0,3,-3,0,3,0,6,-381,0,4,4,-20,0,0,-1,1,1,1,2,1
KR_6725049642,420,4,13,40,8,2,3,1,-3,1,4,1,2,1,3,3,0,5,5,0,0,-1,3,2,3,5,-1,0,1,0,-1,1,1,0,1
KR_6573875294,420,3,18,22,5,1,4,3,0,2,2,0,1,1,0,2,2,4,5,1,0,-2,9,5,4,9,-4,0,0,1,-1,0,-1,4,1
KR_6760349691,420,1,-33,-16,5,0,2,2,-3,1,4,4,5,1,3,3,0,1,1,0,0,4,15,2,3,5,1,0,1,1,-1,1,-1,5,1
KR_6762661416,420,-2,23,-21,2,0,2,2,1,5,4,-8,0,8,9,10,1,0,1,1,3,10,4,1,3,4,2,0,1,-1,-1,1,1,6,1
KR_6545755184,420,-2,-11,-2,4,2,2,0,1,4,3,3,4,1,-3,0,3,1,4,3,0,5,5,5,1,6,-5,0,0,-1,1,-1,1,1,1
KR_6631787045,420,-2,-60,-20,-3,-4,0,4,0,1,1,-1,2,3,2,2,0,0,2,2,0,-2,-4,0,4,4,-2,0,0,-1,-1,0,-1,5,1
KR_6639209574,440,5,4,20,6,0,1,1,0,1,1,4,4,0,-1,2,3,3,3,0,0,4,-2,0,2,2,0,0,1,1,1,1,1,6,1
KR_6704328976,420,-4,20,-5,-4,-2,1,3,0,4,4,1,4,3,-1,0,1,-2,0,2,-1,-7,-33,-2,5,3,30,0,1,0,0,1,-1,0,1
KR_6633302629,420,3,-1,-8,2,1,1,0,1,3,2,2,3,1,-2,0,2,0,0,0,0,1,8,-2,5,3,-3,0,0,1,-1,0,-1,1,1
KR_6764568489,420,-1,19,-4,3,0,1,1,2,4,2,4,8,4,-4,2,6,1,1,0,0,0,-5,-2,3,1,1,0,-1,1,-1,-1,-1,5,1
KR_6694479755,440,-2,-22,1,-7,-2,0,2,-3,2,5,-6,1,7,4,4,0,0,0,0,-1,-5,3,-1,4,3,-2,0,0,-1,-1,-1,-1,2,1
KR_5832013866,420,3,2,8,5,2,3,1,5,7,2,-2,0,2,-3,4,7,3,3,0,1,2,-10,0,4,4,2,0,0,-1,0,1,1,1,1
KR_6736571101,440,2,-43,-4,-1,-1,3,4,3,5,2,2,4,2,-4,1,5,-1,1,2,2,0,-4,1,1,2,-5,0,1,1,-1,1,1,6,1
KR_6669600411,420,2,26,-28,5,-1,4,5,1,3,2,1,4,3,2,2,0,2,2,0,0,6,-117,0,2,2,3,0,0,1,-1,-1,-1,1,1
KR_6764132588,420,-1,27,-12,-4,-1,1,2,-4,2,6,-1,1,2,3,5,2,-1,1,2,0,1,-24,-3,7,4,8,0,0,1,-1,-1,-1,2,1
KR_6739731343,420,3,116,-4,6,-1,1,2,0,1,1,7,7,0,0,3,3,0,1,1,0,2,-15,0,3,3,4,0,2,1,-1,1,1,6,1
KR_6763481891,420,1,-40,8,2,-2,1,3,1,5,4,4,6,2,0,2,2,-1,3,4,0,6,4,3,2,5,1,0,-1,1,-1,-1,-1,5,1
KR_6745894468,420,0,37,28,2,1,1,0,0,2,2,5,7,2,-4,1,5,0,0,0,1,-1,-9,-2,6,4,-2,0,1,1,0,1,1,4,1
KR_6721754251,420,3,89,23,2,3,4,1,0,3,3,0,3,3,2,2,0,-3,0,3,1,0,3,-1,2,1,0,0,2,1,-1,1,1,1,1
KR_6719598119,420,1,2,19,2,-2,1,3,2,5,3,3,5,2,0,3,3,-1,0,1,2,10,48,5,1,6,-27,0,0,1,1,0,1,4,1
KR_6663927085,420,0,-13,0,2,2,3,1,2,5,3,0,4,4,-2,1,3,0,1,1,0,3,-124,-2,4,2,-1,0,-1,-1,-1,-1,1,2,1
KR_6746236040,440,2,39,-24,4,2,4,2,2,2,0,0,3,3,0,2,2,0,0,0,-1,1,-8,0,4,4,-2,0,0,0,1,0,-1,0,1
KR_6570672713,420,3,48,21,13,2,2,0,8,9,1,-2,4,6,4,6,2,1,1,0,1,19,32,-5,9,4,6,0,3,-1,-1,1,1,3,1
KR_6740372699,440,-1,33,-21,-2,0,1,1,0,2,2,-1,1,2,-2,2,4,1,1,0,0,6,-146,-6,8,2,3,0,-1,-1,-1,-1,1,3,1
KR_6741866024,420,3,18,9,6,4,4,0,-6,0,6,3,3,0,4,6,2,1,1,0,0,6,-4,2,3,5,2,0,1,-1,1,1,1,3,1
KR_6676460778,440,1,48,-8,4,3,4,1,1,3,2,3,3,0,0,0,0,-3,0,3,0,1,3,3,2,5,-1,0,0,0,-1,0,1,0,1
KR_6750220049,420,2,23,24,1,1,3,2,-3,4,7,3,4,1,0,4,4,0,0,0,0,-1,-2,0,3,3,-2,0,2,-1,1,1,-1,6,1
KR_6591798996,420,-2,47,35,2,-1,1,2,1,2,1,1,4,3,1,1,0,0,1,1,0,3,9,3,3,6,0,0,0,1,-1,1,1,1,1
KR_6759269085,420,0,-33,-20,0,-1,1,2,-5,1,6,-3,3,6,7,7,0,2,2,0,0,6,-32,-5,8,3,2,0,0,-1,-1,0,-1,5,1
KR_6744666595,420,2,88,8,3,2,4,2,-1,1,2,0,4,4,1,3,2,1,1,0,-1,-3,-184,5,3,8,4,0,0,1,-1,1,-1,1,1
KR_6582472200,420,7,54,20,16,2,3,1,8,10,2,2,2,0,4,5,1,0,2,2,2,18,1,1,5,6,-4,0,2,1,1,1,1,1,1
KR_6602844729,420,-2,-26,-5,5,3,4,1,-2,0,2,5,5,0,-1,4,5,0,4,4,2,4,1,3,3,6,-3,0,1,-1,1,1,1,5,1
KR_6538231507,420,2,23,11,3,4,4,0,-1,0,1,3,5,2,-2,0,2,-1,0,1,0,-5,10,-6,7,1,-5,0,0,-1,1,1,1,2,1
KR_6570606198,420,5,75,40,9,4,6,2,0,3,3,5,5,0,2,4,2,-2,0,2,0,8,-218,-2,5,3,3,0,1,1,1,1,1,5,1
KR_6762222821,420,3,69,-8,2,-1,0,1,2,4,2,-2,0,2,1,3,2,2,3,1,0,4,6,2,2,4,-2,0,1,-1,1,1,1,2,1
KR_6638158727,420,1,62,16,7,-3,1,4,2,4,2,-2,2,4,7,7,0,3,3,0,1,9,6,2,4,6,3,0,0,-1,1,0,1,2,1
KR_6752546967,420,2,18,24,3,2,4,2,0,2,2,-1,4,5,0,2,2,2,4,2,0,3,5,4,3,7,4,0,1,1,-1,-1,1,6,1
KR_6761541394,420,0,-3,-5,6,0,3,3,9,9,0,-1,0,1,-1,0,1,-1,0,1,0,8,39,-2,6,4,-14,0,-1,-1,-1,-1,1,6,1
KR_6763937299,420,5,13,-1,8,1,1,0,2,2,0,0,1,1,3,5,2,2,3,1,1,12,-120,-2,6,4,7,0,-1,1,-1,-1,1,1,1
KR_6700814981,420,5,35,31,11,2,4,2,2,6,4,1,3,2,6,6,0,0,0,0,0,7,-28,3,4,7,19,0,3,0,1,1,1,0,1
KR_6663711534,420,2,67,-2,8,3,3,0,2,3,1,1,3,2,2,4,2,0,1,1,0,4,4,4,3,7,4,0,1,-1,1,1,1,5,1
KR_6759450594,420,-1,0,-34,4,-2,2,4,1,3,2,-1,3,4,6,12,6,0,1,1,2,11,-5,3,5,8,4,0,1,0,1,1,1,0,1
KR_6733643810,420,1,53,19,2,2,2,0,2,3,1,-1,2,3,-2,5,7,1,2,1,0,10,-345,3,3,6,2,0,0,-1,-1,-1,1,3,1
KR_6633334198,420,-2,-45,0,-10,-1,0,1,3,9,6,-4,2,6,-7,1,8,-1,1,2,0,-17,-13,1,6,7,2,0,-1,1,0,-1,-1,4,1
KR_6741558873,420,-1,-4,-4,-7,0,1,1,-4,2,6,-3,0,3,1,2,1,-1,5,6,0,-5,-1,-2,6,4,-2,0,-1,-1,-1,-1,-1,3,1
KR_6721532073,420,3,94,-12,12,4,5,1,3,3,0,1,4,3,0,3,3,4,6,2,0,2,8,2,4,6,6,0,1,-1,1,1,1,1,1
KR_6738900420,420,1,12,-8,-4,-4,3,7,-2,0,2,2,4,2,-2,2,4,2,4,2,0,1,56,-4,5,1,-12,0,-1,-1,-1,-1,-1,5,1
KR_6751443533,440,0,13,-6,-1,5,6,1,4,6,2,-3,2,5,-3,0,3,-4,1,5,-2,-3,-7,-2,5,3,2,0,1,-1,0,1,-1,6,1
KR_6761565903,420,4,10,32,5,0,0,0,-2,1,3,-1,0,1,6,9,3,2,4,2,1,2,10,3,3,6,-2,0,1,1,-1,1,1,6,1
KR_6762076869,420,0,-46,9,-6,-1,0,1,-1,1,2,2,5,3,-3,3,6,-3,0,3,0,-18,0,-1,4,3,-4,0,-1,-1,-1,-1,-1,4,1
KR_6597462854,420,2,-46,0,2,-2,0,2,-3,1,4,1,1,0,-1,2,3,7,7,0,0,4,1,-1,4,3,2,0,-1,1,1,-1,1,1,1
KR_6713694333,420,0,-15,20,-3,-5,1,6,1,3,2,1,3,2,0,2,2,0,1,1,0,-4,0,-4,7,3,-1,0,-1,1,0,-1,-1,6,1
KR_6560426697,440,6,110,23,14,2,3,1,-2,0,2,6,6,0,5,7,2,3,6,3,0,16,-18,4,2,6,-3,0,3,1,1,1,1,2,1
KR_6616900182,420,-1,22,10,1,2,3,1,3,3,0,0,3,3,-3,1,4,-1,0,1,1,4,2,5,3,8,-5,0,-2,1,-1,-1,1,3,1
KR_6748014012,420,6,12,24,12,1,3,2,6,8,2,6,6,0,-4,0,4,3,5,2,0,8,38,1,2,3,-4,0,0,0,0,-1,-1,0,1
KR_6759775715,420,-2,22,-4,-7,-4,1,5,1,5,4,-5,1,6,-3,1,4,4,5,1,0,-7,5,-2,3,1,0,0,0,-1,-1,-1,-1,6,1
KR_6760471348,420,1,-12,4,2,5,6,1,3,7,4,-1,1,2,-7,0,7,2,2,0,-1,-8,3,0,2,2,0,0,0,0,0,1,-1,0,1
KR_6760281018,420,6,31,6,17,5,6,1,2,2,0,12,13,1,-1,0,1,-1,0,1,0,15,33,1,2,3,5,0,0,-1,1,1,1,5,1
KR_6761642997,420,5,97,20,7,2,2,0,-2,5,7,2,5,3,4,5,1,1,1,0,0,0,4,1,1,2,3,0,2,1,0,1,1,3,1
KR_6760302317,420,7,129,17,7,0,2,2,4,4,0,4,5,1,1,5,4,-2,2,4,-1,6,28,1,1,2,0,0,3,1,1,1,-1,1,1
KR_6753604463,420,8,131,25,17,8,9,1,1,2,1,4,5,1,2,5,3,2,2,0,0,1,-21,5,2,7,-2,0,4,1,1,1,1,3,1
KR_6602413619,420,3,-1,24,6,0,2,2,4,7,3,0,1,1,0,2,2,2,3,1,0,10,-4,0,5,5,4,0,0,-1,1,0,1,5,1
KR_6758377934,420,4,47,20,14,0,2,2,5,6,1,0,2,2,5,5,0,4,4,0,1,7,6,-2,6,4,2,0,1,1,1,1,1,5,1
KR_6750876084,420,4,-2,32,12,6,7,1,0,2,2,-1,1,2,7,11,4,0,1,1,0,10,5,1,3,4,-5,0,1,1,1,1,1,4,1
KR_6667630379,420,4,81,29,4,-2,2,4,0,0,0,3,6,3,4,5,1,-1,0,1,0,3,19,2,2,4,-24,0,0,0,1,1,1,0,1
KR_6580997557,440,5,17,12,8,4,5,1,1,7,6,2,2,0,0,3,3,1,3,2,0,1,-17,3,5,8,2,0,1,-1,1,1,1,6,1
KR_6747092945,420,0,22,-16,-6,1,2,1,-1,1,2,-1,1,2,-4,1,5,-1,0,1,0,-13,38,0,5,5,2,0,1,-1,1,1,-1,3,1
KR_6736710866,420,3,36,40,7,2,2,0,4,4,0,1,2,1,0,1,1,0,0,0,0,8,1,1,5,6,-1,0,0,1,1,1,1,5,1
KR_6733451805,440,1,15,-43,4,-1,2,3,1,5,4,1,2,1,3,5,2,0,1,1,1,10,-151,2,2,4,0,0,-1,-1,-1,-1,1,5,1
KR_6745067052,420,-4,-23,-23,-10,-1,1,2,0,1,1,0,2,2,-4,0,4,-5,0,5,-1,-10,-6,5,4,9,-1,0,0,-1,1,1,-1,2,1
KR_6679913113,420,2,-16,4,-2,0,0,0,2,4,2,1,3,2,-1,1,2,-4,1,5,0,2,38,-5,7,2,-17,0,0,-1,-1,0,-1,3,1
KR_6601054888,420,1,6,-4,3,2,4,2,1,2,1,-1,1,2,2,4,2,-1,0,1,0,4,-17,0,5,5,0,0,2,-1,1,1,1,4,1
KR_6582804672,420,4,89,0,3,2,3,1,0,2,2,-2,3,5,3,6,3,0,1,1,-1,-7,11,7,2,9,-6,0,2,1,1,1,1,1,1
KR_6681203170,420,1,-65,-13,8,1,2,1,2,2,0,4,6,2,2,7,5,-1,1,2,1,14,4,-4,9,5,-2,0,1,-1,1,1,1,3,1
KR_6764226268,420,-2,-70,-22,6,1,1,0,6,6,0,1,2,1,-1,1,2,-1,0,1,0,12,-359,-1,5,4,0,0,-1,1,-1,-1,1,3,1
KR_6404813243,420,3,42,4,2,-2,0,2,-2,5,7,4,4,0,3,3,0,-1,0,1,0,3,-8,0,5,5,8,0,0,1,-1,-1,-1,1,1
KR_6764594580,420,1,-13,-4,7,-1,1,2,-1,2,3,5,6,1,5,7,2,-1,0,1,-1,7,-406,-3,7,4,3,0,1,-1,-1,1,-1,4,1
KR_6216585571,420,-2,3,13,-3,0,1,1,0,4,4,-1,3,4,0,2,2,-2,0,2,0,-2,-8,-5,7,2,1,0,2,1,1,1,1,2,1
KR_6512646733,420,-2,-7,4,1,-5,1,6,2,4,2,-2,2,4,3,4,1,3,5,2,0,5,-6,2,7,9,1,0,0,0,-1,0,-1,0,1
KR_6759808441,420,-1,14,8,1,0,2,2,6,8,2,0,5,5,-1,3,4,-4,0,4,0,2,37,-2,3,1,-20,0,0,-1,1,1,-1,4,1
KR_6672670321,420,-2,-5,30,-5,-3,0,3,1,4,3,3,4,1,-2,2,4,-4,1,5,0,-6,-10,-4,9,5,6,0,0,1,1,0,1,2,1
KR_6715918460,420,2,44,-12,3,0,1,1,-2,1,3,4,5,1,4,5,1,-3,2,5,0,-6,8,3,5,8,2,0,0,0,0,0,1,0,1
KR_6708591147,420,-1,3,-4,-4,-4,0,4,0,1,1,2,2,0,-1,2,3,-1,0,1,-1,-5,34,-2,6,4,2,0,-1,1,-1,-1,-1,5,1
KR_6761511898,420,-2,13,-4,-6,0,4,4,1,4,3,-1,0,1,-6,1,7,0,2,2,0,-9,23,3,3,6,2,0,0,0,-1,-1,-1,0,1
KR_6760680124,440,3,11,-5,6,-1,2,3,-1,2,3,3,6,3,3,5,2,2,3,1,0,3,0,0,3,3,2,0,0,1,1,0,1,6,1
KR_6658085868,420,1,15,36,1,-1,1,2,1,4,3,2,4,2,0,3,3,-1,0,1,0,6,-37,1,3,4,22,0,0,1,-1,0,-1,1,1
KR_6760481217,420,2,27,-20,-1,-2,0,2,-2,3,5,-1,0,1,3,6,3,1,3,2,-1,2,-3,0,7,7,6,0,0,1,-1,1,-1,2,1
KR_6708264165,420,0,-15,9,6,4,4,0,-5,1,6,-3,3,6,5,7,2,5,6,1,0,-8,-46,-6,11,5,9,0,1,0,1,1,-1,0,1
KR_6762647480,420,0,-31,9,1,3,4,1,0,4,4,0,2,2,-2,2,4,0,1,1,1,-5,-39,1,2,3,-6,0,0,1,1,0,1,6,1
KR_6696489704,420,1,35,-5,2,6,6,0,-2,4,6,-2,4,6,0,1,1,0,0,0,0,2,92,1,3,4,0,0,2,1,-1,1,1,1,1
KR_6571838838,420,3,18,-24,8,5,7,2,-3,3,6,2,2,0,5,6,1,-1,1,2,0,15,1,-2,8,6,6,0,1,0,-1,1,-1,0,1
KR_6716516679,420,8,118,65,16,1,3,2,2,2,0,0,3,3,10,10,0,3,4,1,0,13,0,-1,4,3,7,0,3,1,1,1,1,3,1
KR_6667497114,420,7,78,12,17,1,2,1,-2,0,2,9,9,0,8,8,0,1,2,1,0,10,6,-1,3,2,2,0,1,1,0,1,1,3,1
KR_6742094567,420,1,27,0,2,3,3,0,2,4,2,1,2,1,-4,0,4,0,1,1,0,-3,5,1,4,5,-3,0,1,-1,1,1,1,2,1
KR_6668838530,420,4,58,13,5,0,2,2,-1,2,3,2,6,4,5,6,1,-1,1,2,1,9,-181,0,6,6,0,0,0,1,-1,1,1,6,1
KR_6735990405,420,-2,-49,16,-1,-2,1,3,-4,1,5,0,2,2,6,9,3,-1,2,3,0,-6,-48,-2,4,2,7,0,0,1,-1,1,1,4,1
KR_5682300064,420,2,-19,4,2,-1,0,1,3,5,2,1,3,2,0,1,1,-1,2,3,0,6,-6,-4,9,5,1,0,0,-1,-1,0,-1,5,1
KR_6744723943,420,0,-48,12,6,-1,3,4,2,3,1,1,3,2,2,4,2,2,2,0,0,10,15,-1,7,6,5,0,0,1,-1,0,-1,3,1
KR_6759790388,420,2,86,28,2,1,1,0,-1,3,4,1,2,1,1,2,1,0,3,3,0,-5,-6,5,2,7,5,0,0,1,1,1,1,2,1
KR_6754781262,420,-1,-1,3,1,-2,0,2,0,3,3,-1,2,3,3,4,1,1,2,1,0,3,35,3,3,6,0,0,0,-1,1,0,1,6,1
KR_6749532434,420,0,3,16,5,1,4,3,2,2,0,-2,0,2,2,5,3,2,2,0,0,8,163,1,3,4,-4,0,1,1,-1,1,1,6,1
KR_6689692503,420,-3,-77,2,-3,-1,2,3,0,2,2,-2,0,2,-2,2,4,2,4,2,0,-4,-23,-4,6,2,2,0,0,1,1,1,1,6,1
KR_6586753017,420,3,50,0,11,-1,2,3,1,3,2,0,3,3,10,13,3,1,1,0,0,9,0,-3,10,7,3,0,2,1,-1,1,-1,6,1
KR_6755217420,420,0,-7,28,2,0,1,1,-1,3,4,6,6,0,-3,1,4,0,1,1,0,-4,6,-1,6,5,-4,0,1,1,1,1,1,4,1
KR_6730508856,420,5,2,52,8,1,2,1,1,4,3,0,1,1,7,7,0,-1,0,1,-1,15,-1,0,3,3,-1,0,1,1,1,1,-1,1,1
KR_6745447077,420,3,52,12,-1,-1,0,1,1,4,3,1,3,2,-2,1,3,0,0,0,-1,-6,152,-4,9,5,5,0,0,1,-1,0,-1,1,1
KR_6714731605,420,-2,27,40,-2,-1,1,2,-2,3,5,3,5,2,-2,4,6,0,1,1,0,-2,29,2,3,5,-12,0,0,-1,1,-1,1,1,1
KR_6633550229,420,3,24,19,2,1,5,4,2,4,2,1,2,1,3,5,2,-5,2,7,0,5,-3,-3,7,4,2,0,2,0,0,1,-1,0,1
KR_6738839391,420,5,28,12,9,5,6,1,2,2,0,2,5,3,0,3,3,0,1,1,0,7,2,1,4,5,2,0,2,1,1,1,-1,6,1
KR_6708644203,420,-1,-30,28,0,-4,0,4,-2,6,8,2,3,1,7,7,0,-3,0,3,1,16,-1,-8,12,4,6,0,1,1,-1,1,1,4,1
KR_6714553825,420,3,-49,116,5,-2,0,2,3,3,0,3,4,1,1,2,1,0,2,2,0,6,9,-1,2,1,1,0,1,1,1,1,1,1,1
KR_6763556563,420,-2,19,-16,-3,2,3,1,-2,3,5,-2,4,6,1,3,2,-2,1,3,0,2,6,-2,4,2,4,0,-1,1,-1,-1,1,6,1
KR_6758115837,420,-1,-25,0,-6,2,2,0,1,2,1,-2,0,2,-4,2,6,-3,0,3,-1,-14,-5,-3,8,5,2,0,0,-1,-1,0,-1,6,1
KR_6739050560,420,-4,-18,-21,-6,1,3,2,0,3,3,-2,3,5,0,3,3,-5,0,5,-1,-7,-1,-4,7,3,1,0,-1,-1,1,-1,-1,1,1
KR_6604364789,420,2,33,-42,3,1,2,1,1,4,3,1,3,2,1,3,2,-1,1,2,0,5,9,1,2,3,-6,0,-1,-1,1,-1,-1,5,1
KR_6695417252,420,4,-23,43,9,1,1,0,4,5,1,1,4,3,2,4,2,1,1,0,3,11,-17,0,3,3,4,0,-1,1,1,1,1,6,1
KR_6645200029,420,7,60,11,2,1,2,1,1,4,3,0,4,4,0,1,1,0,1,1,0,-4,-9,-5,7,2,5,0,1,-1,1,1,-1,6,1
KR_6752973146,420,2,34,11,6,-1,2,3,8,8,0,0,2,2,-1,1,2,0,3,3,2,3,-9,-4,7,3,5,0,-1,-1,-1,1,1,6,1
KR_6739573836,420,1,40,29,-4,0,1,1,1,4,3,0,3,3,-4,0,4,-1,0,1,0,-7,-115,-1,2,1,-3,0,-1,-1,1,-1,1,5,1
KR_6747124458,420,3,-3,20,9,1,1,0,6,7,1,1,2,1,2,3,1,-1,0,1,1,13,-5,0,2,2,2,0,1,0,1,1,1,0,1
KR_6705733843,420,1,1,-16,7,2,3,1,3,3,0,0,2,2,-3,1,4,5,6,1,0,11,-2,-2,7,5,-3,0,2,-1,1,1,1,1,1
KR_6756134355,420,2,41,-26,3,0,3,3,1,1,0,2,6,4,-2,0,2,2,2,0,0,4,-4,0,4,4,5,0,1,1,0,1,1,3,1
KR_6751273155,420,2,33,0,2,1,1,0,-1,0,1,2,3,1,-2,0,2,2,2,0,0,2,132,-3,7,4,-1,0,1,-1,1,1,1,6,1
KR_6660217516,440,-1,-58,-22,0,-2,0,2,-3,0,3,4,5,1,1,2,1,0,0,0,1,8,-3,4,1,5,0,0,0,1,1,0,1,4,1
KR_6686177181,420,6,16,20,9,2,5,3,1,1,0,3,3,0,-1,0,1,4,4,0,0,8,-402,2,4,6,14,0,2,-1,-1,1,1,5,1
KR_6656421547,420,4,99,-20,17,0,1,1,13,15,2,-2,2,4,6,6,0,0,1,1,0,15,2,1,4,5,-2,0,2,1,1,1,1,3,1
KR_6741183860,420,2,62,-10,8,0,2,2,1,2,1,5,5,0,3,4,1,-1,0,1,0,1,2,2,4,6,1,0,1,1,1,1,1,1,1
KR_6726995600,440,2,38,12,2,1,4,3,3,7,4,-6,2,8,3,4,1,1,2,1,-3,-1,25,1,4,5,-6,0,-1,1,-1,1,-1,2,1
KR_6729927956,420,3,50,0,10,2,3,1,4,4,0,2,3,1,2,7,5,0,0,0,0,4,6,-3,6,3,1,0,1,-1,-1,1,-1,1,1
KR_6761095065,420,1,-10,37,-1,-5,0,5,0,3,3,2,3,1,2,5,3,0,0,0,0,-5,0,3,4,7,1,0,0,1,1,-1,1,5,1
KR_6744033365,420,4,10,16,6,0,1,1,1,2,1,3,8,5,0,1,1,2,2,0,0,10,25,2,1,3,-1,0,1,-1,-1,1,1,3,1
KR_6759990816,420,3,79,-8,1,0,1,1,-1,2,3,7,7,0,-4,0,4,-1,1,2,0,0,-20,0,4,4,2,0,0,1,-1,0,-1,3,1
KR_6733744942,440,4,16,8,13,10,10,0,-2,3,5,1,3,2,4,5,1,0,2,2,2,17,0,1,3,4,-2,0,0,-1,1,1,1,1,1
KR_6719926281,420,3,44,37,5,2,3,1,1,1,0,1,3,2,0,3,3,1,2,1,0,1,18,-3,6,3,-2,0,2,1,1,1,1,1,1
KR_6636381788,420,4,38,24,-1,-1,3,4,2,3,1,-4,0,4,3,3,0,-1,0,1,0,-3,-7,-3,7,4,3,0,0,0,-1,-1,-1,0,1
KR_6757383925,420,2,-18,-4,8,6,6,0,3,4,1,1,2,1,-2,3,5,0,0,0,1,5,7,-3,5,2,0,0,1,-1,1,1,1,6,1
KR_6632630101,420,-2,-62,30,-9,-7,0,7,2,6,4,1,1,0,-3,3,6,-2,0,2,-1,-15,0,-5,10,5,-3,0,0,-1,-1,1,-1,2,1
KR_6743235272,420,-2,-48,-13,-1,1,4,3,-1,1,2,-1,3,4,1,2,1,-1,0,1,-1,-6,-310,4,3,7,-5,0,0,0,1,-1,-1,0,1
KR_6674577556,420,4,17,3,1,1,1,0,1,4,3,2,2,0,-1,0,1,-2,0,2,0,-2,-10,-6,12,6,6,0,0,1,1,1,1,2,1
KR_6733605403,440,2,40,0,5,3,3,0,0,3,3,-1,3,4,4,6,2,-1,1,2,0,4,2,3,2,5,-4,0,0,1,-1,0,1,2,1
KR_6676385762,420,2,14,-6,11,5,5,0,3,5,2,0,1,1,1,6,5,2,2,0,0,6,-188,1,8,9,4,0,0,1,1,0,1,3,1
KR_6746300193,420,1,-30,15,6,0,4,4,-1,2,3,0,1,1,3,4,1,4,4,0,0,15,7,4,5,9,-1,0,-1,-1,-1,-1,-1,2,1
KR_6715455236,420,2,51,14,2,0,2,2,2,4,2,-2,0,2,0,0,0,2,3,1,0,7,2,3,3,6,-2,0,2,-1,1,1,1,5,1
KR_6761890460,420,3,-74,-17,-1,1,3,2,-2,2,4,2,4,2,-2,5,7,0,1,1,0,-5,-6,-4,6,2,3,0,0,0,-1,-1,-1,0,1
KR_6653283548,420,2,21,13,6,1,1,0,1,7,6,0,1,1,3,5,2,1,3,2,0,3,2,4,5,9,0,0,0,-1,0,0,-1,4,1
KR_6661237806,420,-2,-77,12,-4,-4,0,4,-1,2,3,-2,1,3,1,2,1,2,2,0,0,-3,10,1,7,8,-5,0,0,0,-1,1,-1,0,1
KR_6167808495,420,0,9,12,-2,-2,2,4,0,4,4,0,3,3,-1,2,3,1,1,0,0,-3,-8,-3,6,3,1,0,-1,-1,0,-1,-1,5,1
KR_6756822471,420,3,-41,16,-3,-1,1,2,-1,2,3,0,3,3,-1,1,2,0,3,3,0,-8,-3,1,5,6,-1,0,0,1,-1,-1,1,3,1
KR_6706944039,440,3,-6,20,11,6,6,0,-1,2,3,-2,0,2,6,7,1,2,2,0,-1,7,3,-4,9,5,-1,0,2,-1,1,1,-1,2,1
KR_6751978357,420,3,43,2,9,-1,0,1,3,4,1,-1,1,2,4,4,0,4,4,0,0,17,12,5,1,6,1,0,1,1,1,1,1,3,1
KR_6752638690,420,2,51,20,6,2,3,1,7,8,1,0,1,1,-2,2,4,-1,0,1,0,11,-39,2,6,8,23,0,2,1,1,1,1,6,1
KR_6411333630,420,2,92,24,5,-1,1,2,-3,1,4,1,5,4,6,9,3,2,2,0,0,9,15,4,5,9,5,0,1,1,0,1,1,1,1
KR_6763060121,420,2,36,23,9,-2,0,2,2,3,1,4,4,0,1,3,2,4,4,0,0,12,-4,-4,7,3,5,0,2,1,1,1,1,5,1
KR_6759635821,420,2,27,-23,8,4,5,1,0,1,1,0,0,0,3,5,2,1,2,1,0,-1,6,4,3,7,-5,0,1,-1,0,1,1,4,1
KR_6622201434,420,0,-12,-7,4,2,2,0,0,1,1,5,7,2,-5,3,8,2,2,0,0,6,1,2,4,6,-2,0,-1,1,1,-1,1,3,1
KR_6761957872,420,2,-7,2,3,-2,0,2,0,3,3,-1,0,1,4,6,2,2,2,0,0,5,-502,-3,8,5,4,0,0,1,-1,0,1,3,1
KR_6697158158,420,1,65,21,-4,1,2,1,0,3,3,-3,1,4,-1,1,2,-1,0,1,-1,-9,28,-1,5,4,-1,0,0,-1,1,0,-1,5,1
KR_6729863345,420,4,-14,17,10,3,3,0,3,5,2,3,3,0,3,4,1,-2,1,3,0,0,4,-3,6,3,-1,0,2,-1,1,1,-1,5,1
KR_6318835192,420,7,37,24,18,4,7,3,3,5,2,2,3,1,8,9,1,1,1,0,0,8,26,3,0,3,1,0,2,0,1,1,-1,0,1
KR_6662832716,420,3,70,32,4,0,1,1,-1,1,2,3,3,0,3,3,0,-1,0,1,0,1,-1,-3,9,6,1,0,0,-1,1,1,1,1,1
KR_6681433013,420,-2,-57,19,2,-1,2,3,-3,1,4,8,11,3,0,3,3,-2,1,3,-1,5,0,0,3,3,2,0,-1,-1,-1,1,-1,3,1
KR_6545559365,420,1,15,3,2,-1,1,2,3,4,1,3,3,0,-4,3,7,1,1,0,0,0,16,2,3,5,-1,0,1,0,1,1,-1,0,1
KR_6737807893,420,0,6,7,0,2,3,1,-3,1,4,4,5,1,0,4,4,-3,1,4,0,3,-21,-1,4,3,23,0,-2,1,-1,-1,-1,3,1
KR_6763131435,440,-1,4,12,-4,0,0,0,-2,0,2,-2,3,5,0,2,2,0,2,2,0,-7,0,1,6,7,4,0,0,1,1,0,-1,5,1
KR_6747865384,420,0,-32,-1,3,3,3,0,0,0,0,1,1,0,-2,0,2,1,2,1,0,4,-1,-2,6,4,0,0,0,-1,1,0,1,4,1
KR_6216426075,420,1,78,-4,3,-1,1,2,-1,5,6,1,2,1,3,4,1,1,2,1,0,3,14,-1,8,7,2,0,2,0,1,1,1,0,1
KR_6669442797,420,5,67,5,12,1,2,1,3,5,2,1,4,3,7,7,0,0,1,1,0,11,11,3,2,5,-1,0,2,1,1,1,1,4,1
KR_6639893106,420,0,22,12,3,5,7,2,-1,3,4,-2,0,2,1,2,1,0,0,0,0,0,1,0,5,5,-1,0,1,-1,1,1,1,3,1
KR_6761681741,420,4,13,12,9,0,2,2,4,4,0,8,12,4,-3,5,8,0,2,2,0,8,-10,-1,7,6,3,0,2,-1,1,1,1,4,1
KR_6761803803,440,3,73,2,4,0,0,0,-1,6,7,4,5,1,-1,2,3,2,2,0,0,-1,10,6,4,10,4,0,2,-1,1,1,1,1,1
KR_6760673136,420,0,-18,4,-1,-3,2,5,1,2,1,0,2,2,0,0,0,1,2,1,0,1,22,1,5,6,1,0,1,1,1,1,-1,1,1
KR_6749343661,420,0,8,4,-1,-5,0,5,-3,1,4,1,4,3,6,7,1,0,0,0,0,-2,7,3,1,4,-2,0,1,1,-1,1,1,5,1
KR_6747358610,420,3,-38,16,12,-1,0,1,7,9,2,2,3,1,2,5,3,2,4,2,0,18,32,2,3,5,2,0,1,1,-1,1,1,1,1
KR_6754583604,420,-1,-15,4,-5,-1,1,2,2,2,0,-3,4,7,-4,0,4,1,5,4,-1,-2,38,2,1,3,-16,0,0,-1,-1,-1,-1,1,1
KR_6734767949,440,-3,-59,-16,-5,-5,2,7,0,4,4,0,2,2,2,2,0,-2,1,3,-1,2,-15,0,5,5,1,0,1,1,-1,-1,-1,1,1
KR_6692193668,420,0,29,14,-4,-5,0,5,0,3,3,-1,1,2,1,2,1,1,1,0,0,5,-14,-2,5,3,-1,0,2,1,1,-1,1,3,1
KR_6764754002,420,6,74,28,11,2,3,1,2,4,2,1,3,2,6,6,0,0,1,1,1,11,50,1,2,3,0,0,0,1,-1,1,1,4,1
KR_6758835335,420,5,2,44,9,0,2,2,0,2,2,7,8,1,1,1,0,1,2,1,0,11,3,6,0,6,2,0,1,1,1,1,1,3,1
KR_6546828839,420,4,12,-7,14,5,5,0,4,6,2,3,3,0,2,3,1,0,1,1,0,12,-1,-3,8,5,-3,0,0,1,1,0,1,1,1
KR_6669220750,440,1,-2,17,4,0,2,2,0,1,1,2,2,0,2,2,0,0,0,0,0,4,-6,-2,5,3,7,0,0,1,-1,-1,1,5,1
KR_6727008082,420,6,73,5,14,5,5,0,6,7,1,3,4,1,0,5,5,0,1,1,-1,10,18,5,3,8,-1,0,1,1,-1,1,-1,4,1
KR_6756850446,420,1,8,4,10,-1,1,2,5,6,1,2,4,2,2,5,3,2,2,0,0,12,-6,0,6,6,1,0,0,1,-1,0,-1,6,1
KR_6433919407,420,-1,15,0,-2,3,3,0,-1,1,2,-4,0,4,-1,2,3,1,2,1,0,-4,0,-5,9,4,0,0,0,1,-1,0,-1,1,1
KR_6341832361,420,-4,-33,-2,-7,1,1,0,1,6,5,0,3,3,-7,0,7,-2,1,3,0,-14,2,1,2,3,-2,0,1,-1,1,-1,1,5,1
KR_6724974466,420,0,-24,24,6,0,3,3,2,2,0,0,3,3,3,7,4,1,1,0,0,2,-120,2,3,5,3,0,0,-1,-1,0,1,3,1
KR_6759520276,420,0,23,-17,2,-2,0,2,1,2,1,1,3,2,-1,6,7,3,4,1,0,6,133,3,4,7,1,0,1,-1,-1,1,-1,5,1
KR_6764187474,420,2,5,8,7,-3,1,4,4,4,0,3,5,2,2,2,0,1,1,0,0,14,34,0,3,3,-16,0,1,1,1,1,1,3,1
KR_6557065777,420,4,21,-4,10,0,2,2,7,9,2,1,1,0,3,5,2,-1,1,2,1,13,10,1,5,6,3,0,1,-1,1,1,1,4,1
KR_6754649229,420,-1,-6,-16,-4,-2,0,2,0,1,1,2,3,1,-4,2,6,0,0,0,0,-2,-4,-1,5,4,3,0,-2,0,-1,-1,1,0,1
KR_6664274108,420,6,91,23,9,-2,2,4,6,7,1,1,3,2,3,4,1,1,2,1,0,11,2,4,1,5,2,0,2,1,1,1,1,3,1
KR_6759748064,420,0,1,20,3,8,8,0,-2,0,2,-2,1,3,0,2,2,-1,1,2,0,0,1,-2,5,3,-1,0,-1,1,-1,-1,1,1,1
KR_6666976387,420,2,-36,-16,18,-2,2,4,9,9,0,1,1,0,5,8,3,5,6,1,0,21,71,1,3,4,0,0,-1,-1,1,1,-1,2,1
KR_6574826894,420,6,91,30,14,3,4,1,0,5,5,5,7,2,3,4,1,3,3,0,0,14,-37,-3,6,3,22,0,2,1,1,1,-1,6,1
KR_6704914101,420,-1,44,5,-1,-1,1,2,2,5,3,0,1,1,-3,4,7,1,3,2,0,-4,174,1,5,6,3,0,2,-1,1,1,1,2,1
KR_6670341469,420,1,-57,-25,1,-2,1,3,5,7,2,-1,3,4,1,1,0,-2,0,2,0,6,-8,0,6,6,3,0,0,0,-1,0,-1,0,1
KR_6666642943,420,-3,7,20,-2,-4,0,4,2,4,2,-1,3,4,2,5,3,-1,0,1,-2,-6,1,3,7,10,0,0,0,1,1,0,-1,3,1
KR_6741366209,420,2,82,20,11,4,4,0,6,9,3,3,3,0,-4,1,5,2,2,0,0,10,6,1,6,7,2,0,1,-1,1,1,1,5,1
KR_6681042425,420,2,-8,23,2,-2,2,4,1,3,2,1,1,0,2,3,1,0,2,2,0,2,-12,0,4,4,4,0,1,1,-1,-1,-1,3,1
KR_6739741244,440,-2,13,-23,-7,-3,0,3,0,4,4,0,5,5,-4,5,9,0,0,0,0,-1,5,0,2,2,-4,0,-2,1,-1,-1,-1,3,1
KR_6747429966,440,-1,-32,-10,7,-1,1,2,1,1,0,1,1,0,5,5,0,1,2,1,0,8,-100,3,3,6,0,0,0,-1,1,-1,1,2,1
KR_6623045022,420,6,78,24,9,-2,0,2,2,3,1,1,1,0,3,4,1,5,5,0,0,10,-50,-8,10,2,27,0,1,-1,0,1,-1,3,1
KR_6749259773,440,4,70,22,8,1,2,1,3,4,1,-1,0,1,4,4,0,1,2,1,0,10,1,-5,10,5,6,0,0,1,0,1,1,1,1
KR_6725075739,420,3,21,1,7,1,1,0,-4,1,5,2,3,1,7,7,0,1,2,1,-1,6,1,2,3,5,2,0,2,1,1,1,-1,5,1
KR_6364970373,420,2,27,-7,4,3,4,1,1,4,3,-2,1,3,0,3,3,2,3,1,0,4,0,0,0,0,2,0,0,-1,1,1,-1,5,1
KR_6726076070,420,6,14,39,12,2,3,1,3,4,1,1,3,2,6,6,0,0,1,1,0,4,-93,1,3,4,-1,0,0,0,0,0,1,0,1
KR_6730699277,420,-4,-6,8,-4,-1,0,1,-7,3,10,-2,1,3,6,6,0,0,2,2,0,0,-30,5,1,6,-2,0,-1,1,-1,-1,1,5,1
KR_6762528163,420,-4,-8,-44,-4,0,2,2,-3,1,4,-1,1,2,3,6,3,-3,1,4,1,3,12,2,4,6,-3,0,1,1,1,1,1,4,1
KR_6759626314,440,3,67,12,4,1,3,2,3,3,0,1,1,0,0,2,2,-1,1,2,-2,3,5,1,4,5,4,0,2,1,1,1,-1,5,1
KR_6616893035,420,2,-12,8,6,-3,0,3,-1,1,2,8,10,2,4,4,0,-2,1,3,0,5,-10,-4,6,2,6,0,1,1,1,1,-1,2,1
KR_6680001055,420,2,49,23,-4,-2,1,3,-4,2,6,0,1,1,4,8,4,-2,0,2,0,-10,-23,4,4,8,-6,0,-1,1,-1,-1,1,5,1
KR_6667498136,420,4,75,12,7,5,5,0,0,4,4,2,2,0,-1,5,6,1,2,1,0,8,-19,4,3,7,16,0,1,0,1,1,1,0,1
KR_6748246086,420,1,51,17,-3,4,4,0,-1,0,1,-1,2,3,-5,0,5,0,0,0,0,-8,9,1,6,7,-2,0,1,-1,1,1,1,3,1
KR_6667081709,420,-2,-10,-8,-5,-5,2,7,2,4,2,0,4,4,0,2,2,-2,1,3,-1,-3,-1,1,9,10,-2,0,-3,-1,-1,-1,-1,2,1
KR_6756793706,420,2,59,8,-3,-1,1,2,0,2,2,3,6,3,-4,3,7,-1,2,3,-1,-4,-27,-11,12,1,6,0,0,1,1,0,-1,6,1
KR_6742061950,420,1,2,-3,8,0,3,3,-1,0,1,3,4,1,6,8,2,0,2,2,0,14,-101,-2,7,5,3,0,1,1,1,1,-1,4,1
KR_6731602697,420,6,39,23,14,4,4,0,4,4,0,4,5,1,-3,0,3,5,5,0,0,10,-128,-2,7,5,-3,0,1,1,1,1,1,6,1
KR_6720143689,420,4,66,29,5,1,2,1,4,6,2,1,4,3,2,4,2,-3,1,4,1,6,-33,7,2,9,0,0,-1,-1,-1,-1,1,6,1
KR_6730949531,420,1,43,2,1,-6,0,6,-5,2,7,-2,1,3,8,9,1,6,6,0,-1,5,-4,-5,6,1,7,0,3,-1,1,1,-1,6,1
KR_6761811885,420,2,77,-14,4,-2,0,2,1,2,1,2,2,0,2,3,1,1,1,0,0,7,0,1,3,4,6,0,1,1,0,1,1,3,1
KR_6711483655,420,1,68,-28,-5,2,3,1,0,5,5,-3,4,7,-2,1,3,-2,1,3,0,-5,-46,0,4,4,3,0,2,0,-1,1,-1,0,1
KR_6761655090,420,2,5,22,-2,-2,1,3,-5,0,5,0,1,1,3,6,3,2,4,2,-1,-7,-1,-4,7,3,9,0,2,-1,1,1,-1,6,1
KR_6759768922,420,1,22,15,-2,-2,1,3,-1,2,3,-2,2,4,4,5,1,-1,0,1,0,0,8,1,4,5,1,0,0,1,1,1,-1,1,1
KR_6135422943,440,4,42,12,5,5,6,1,1,2,1,7,7,0,-4,1,5,-4,0,4,0,3,-226,-1,4,3,4,0,0,1,1,-1,-1,5,1
KR_6759815771,420,4,42,-16,6,-1,3,4,3,6,3,1,1,0,2,3,1,1,2,1,-1,7,16,1,5,6,3,0,0,-1,-1,1,-1,3,1
KR_6730926995,420,3,9,5,7,-1,2,3,0,2,2,1,2,1,7,8,1,0,1,1,0,7,4,-2,9,7,-4,0,1,1,-1,1,1,6,1
KR_6274992598,420,0,-30,-8,1,1,1,0,3,7,4,3,4,1,-3,2,5,-3,1,4,-1,-3,-3,-3,8,5,0,0,1,-1,1,1,-1,1,1
KR_6751937539,420,2,36,20,6,2,3,1,1,3,2,0,3,3,2,3,1,1,1,0,0,8,1,0,3,3,2,0,0,-1,-1,0,-1,3,1
KR_6740912812,420,1,-6,-20,0,4,7,3,2,2,0,-3,1,4,-3,1,4,0,1,1,0,-2,-26,3,4,7,6,0,0,1,1,-1,-1,6,1
KR_6745623689,420,2,37,-5,-6,4,4,0,-1,0,1,0,2,2,-6,0,6,-3,0,3,0,-6,-4,-4,5,1,2,0,2,0,1,1,1,0,1
KR_6748320334,420,4,112,-16,12,0,3,3,4,8,4,8,9,1,1,1,0,-1,0,1,1,15,41,-1,3,2,-12,0,3,1,-1,1,1,4,1
KR_6605743239,420,3,-22,26,3,1,2,1,1,2,1,2,5,3,1,4,3,-2,0,2,0,3,2,-7,9,2,-3,0,-1,-1,1,1,-1,2,1
KR_6668186762,420,2,24,40,3,4,7,3,1,3,2,-4,0,4,5,6,1,-3,0,3,0,0,34,-2,7,5,-1,0,2,1,1,1,-1,3,1
KR_6764073877,420,8,107,34,17,3,4,1,5,5,0,4,5,1,-1,2,3,6,6,0,1,12,11,4,0,4,4,0,2,0,1,1,1,0,1
KR_6752173005,420,3,66,8,2,5,5,0,-2,0,2,3,3,0,-3,1,4,-1,0,1,0,-3,0,0,5,5,3,0,0,-1,1,0,1,5,1
KR_6680285274,420,1,92,-8,6,4,5,1,0,3,3,1,4,3,0,2,2,1,1,0,0,3,-1,3,3,6,-1,0,0,1,0,0,1,4,1
KR_6701214321,420,1,-20,18,6,-4,0,4,1,2,1,1,1,0,1,4,3,7,7,0,0,1,2,2,2,4,-2,0,0,1,1,-1,1,1,1
KR_6626358623,420,-3,8,24,1,6,8,2,1,3,2,-1,1,2,-1,1,2,-4,0,4,1,-1,-14,-3,6,3,3,0,1,1,-1,1,1,4,1
KR_6566331940,420,1,-32,9,-6,-1,1,2,1,3,2,-3,1,4,-1,4,5,-2,1,3,-1,-1,-6,4,4,8,1,0,0,-1,1,0,-1,2,1
KR_6751076588,440,1,77,4,5,5,6,1,-2,1,3,0,1,1,-2,0,2,4,4,0,0,-2,-1,3,5,8,2,0,1,1,1,1,1,4,1
KR_6760971194,420,-1,6,12,4,-1,0,1,0,1,1,0,3,3,4,6,2,1,2,1,-1,6,25,1,0,1,0,0,1,-1,1,1,-1,4,1
KR_6615718521,420,1,-12,-16,3,-1,0,1,5,6,1,3,6,3,0,3,3,-4,1,5,0,7,-3,4,4,8,3,0,0,1,-1,-1,1,5,1
KR_6712794673,420,2,68,-18,4,-1,0,1,1,6,5,-2,1,3,6,12,6,0,0,0,-2,2,10,-6,8,2,-1,0,1,1,-1,1,-1,3,1
KR_6604244012,420,1,-14,1,1,1,2,1,-1,2,3,0,1,1,1,2,1,0,0,0,0,1,-113,-3,4,1,1,0,0,-1,1,0,-1,2,1
KR_6711223629,420,0,-39,29,-1,-5,0,5,1,1,0,4,4,0,-2,3,5,1,1,0,0,10,-1,-3,3,0,4,0,-1,-1,-1,-1,-1,2,1
KR_6704833589,420,0,-10,28,0,3,3,0,1,4,3,-4,3,7,0,1,1,0,0,0,0,-9,5,2,1,3,-3,0,0,1,1,0,1,4,1
KR_6741093141,420,5,-19,18,19,1,5,4,5,6,1,4,4,0,6,8,2,3,4,1,3,21,-65,-3,5,2,-14,0,1,1,1,1,1,1,1
KR_6754062398,420,3,68,39,12,2,3,1,2,3,1,4,5,1,3,5,2,1,1,0,1,6,129,5,2,7,4,0,3,1,1,1,1,6,1
KR_6750031664,420,-1,22,8,-2,-3,0,3,0,2,2,-2,6,8,2,2,0,1,4,3,0,-2,-1,-1,6,5,2,0,1,-1,1,1,1,5,1
KR_6667242907,420,-1,-47,-17,-3,-1,0,1,-1,2,3,-2,1,3,1,2,1,0,1,1,0,2,1,1,2,3,-6,0,-2,-1,-1,-1,-1,6,1
KR_6738855675,420,2,68,36,6,4,4,0,-1,5,6,-1,3,4,6,6,0,-2,0,2,0,10,7,6,3,9,-4,0,0,1,-1,1,1,1,1
KR_6747493089,420,1,25,1,14,1,2,1,8,9,1,1,3,2,2,5,3,2,3,1,1,20,6,4,3,7,-7,0,0,0,1,0,1,0,1
KR_6671877892,420,2,42,24,8,0,2,2,3,3,0,4,5,1,3,7,4,-2,0,2,0,3,101,-2,5,3,5,0,1,1,-1,1,1,1,1
KR_6618651901,420,2,43,-13,1,-2,3,5,1,6,5,-2,0,2,5,8,3,-1,0,1,0,2,4,-1,7,6,-3,0,1,-1,1,1,1,3,1
KR_6694538637,420,1,3,15,2,0,1,1,1,3,2,1,1,0,-3,1,4,3,4,1,0,3,12,-4,6,2,4,0,-1,1,-1,-1,1,2,1
KR_6654966059,420,-3,4,-2,-3,1,4,3,1,2,1,-2,1,3,0,2,2,-3,1,4,3,4,-10,5,4,9,4,0,-1,-1,-1,-1,1,2,1
KR_6756998024,420,1,27,4,4,0,1,1,2,4,2,3,6,3,-3,1,4,2,2,0,0,-1,-2,-1,6,5,-3,0,0,1,1,1,1,6,1
KR_6692983989,420,1,11,32,5,0,1,1,-1,2,3,7,8,1,-5,2,7,4,5,1,0,6,15,2,3,5,-2,0,1,1,1,1,1,6,1
KR_6758727156,420,2,59,16,1,3,3,0,0,4,4,1,5,4,-6,2,8,3,3,0,0,-1,2,1,3,4,2,0,1,-1,-1,1,1,2,1
KR_6759262009,440,-2,-44,-29,-8,-2,1,3,-2,0,2,0,5,5,-4,0,4,0,1,1,0,-9,-44,0,3,3,-1,0,1,-1,0,1,-1,6,1
KR_6691242599,420,-1,-6,7,0,-2,1,3,6,10,4,-1,4,5,-1,0,1,-2,1,3,0,4,-6,-5,8,3,0,0,0,1,1,-1,-1,3,1
KR_6744540007,420,1,30,-1,-5,-2,0,2,-6,0,6,4,4,0,-2,0,2,1,1,0,0,-10,-7,0,4,4,1,0,1,1,0,1,-1,4,1
KR_6678803172,420,-2,-5,-8,0,1,3,2,3,3,0,2,2,0,-1,2,3,-5,1,6,2,4,0,1,5,6,-1,0,1,1,1,1,1,4,1
KR_6467586040,420,0,19,0,3,0,2,2,1,4,3,0,2,2,3,4,1,-1,1,2,0,1,10,4,3,7,-4,0,3,-1,1,1,1,3,1
KR_6740438943,420,0,33,2,1,-4,1,5,0,3,3,2,3,1,3,5,2,0,3,3,0,6,-299,1,4,5,-4,0,0,-1,-1,0,1,4,1
KR_6763291682,420,0,-10,-9,9,-3,0,3,1,1,0,5,7,2,-1,2,3,7,8,1,1,10,13,0,4,4,0,0,1,1,1,1,1,6,1
KR_6739545857,440,1,11,1,7,4,5,1,4,5,1,-1,2,3,1,2,1,-1,0,1,0,0,0,2,5,7,-2,0,1,1,1,-1,1,6,1
KR_6764479898,420,-3,-19,-5,-3,-5,2,7,-1,2,3,-2,0,2,5,7,2,0,3,3,0,-2,-13,-8,9,1,1,0,-2,-1,-1,-1,-1,5,1
KR_6751689747,420,-1,40,-3,-2,1,1,0,3,5,2,-4,1,5,0,3,3,-2,2,4,-1,2,-1,4,3,7,-2,0,0,0,-1,0,-1,0,1
KR_6619874893,420,4,-29,16,8,2,3,1,0,3,3,3,4,1,3,4,1,0,0,0,0,6,2,-4,7,3,2,0,0,1,0,0,1,1,1
KR_6706623671,420,0,4,-26,8,0,0,0,-2,2,4,5,6,1,3,4,1,2,3,1,2,5,8,5,3,8,4,0,2,1,1,1,1,6,1
KR_6661843705,420,2,-62,0,0,1,1,0,2,5,3,-2,3,5,-1,1,2,0,1,1,0,9,-2,-3,6,3,3,0,-1,1,1,-1,-1,3,1
KR_6756892125,420,0,10,0,1,5,6,1,0,3,3,-1,1,2,-7,0,7,4,4,0,0,6,3,-1,1,0,-1,0,0,-1,0,0,1,6,1
KR_6706884549,440,3,96,4,10,1,4,3,2,4,2,3,6,3,3,4,1,1,4,3,1,10,-5,-1,3,2,2,0,2,-1,1,1,1,2,1
KR_6028384855,420,0,77,0,1,-6,1,7,0,1,1,3,3,0,4,7,3,0,1,1,1,9,20,3,3,6,-6,0,0,1,1,1,1,4,1
KR_6639078533,420,2,-7,19,2,1,3,2,3,5,2,-1,3,4,0,2,2,-1,1,2,0,-1,5,-1,4,3,-3,0,2,1,1,1,1,6,1
KR_6757645785,420,0,-13,-35,3,-2,0,2,-2,3,5,7,8,1,-2,3,5,2,2,0,0,7,-49,2,5,7,3,0,-1,-1,-1,-1,1,3,1
KR_6761348367,420,1,71,18,3,0,2,2,3,3,0,-3,1,4,2,4,2,1,1,0,0,6,25,1,1,2,-17,0,1,-1,-1,1,1,6,1
KR_6757825209,420,3,32,44,5,5,6,1,0,3,3,1,1,0,-3,1,4,2,2,0,0,2,7,1,3,4,-3,0,1,1,1,-1,1,5,1
KR_6755284330,440,5,27,23,4,-2,2,4,9,12,3,2,4,2,-5,1,6,0,0,0,0,8,-13,-2,9,7,3,0,0,-1,-1,-1,1,2,1
KR_6699977037,420,2,24,3,10,3,4,1,-1,3,4,3,3,0,5,6,1,0,1,1,0,4,25,1,5,6,2,0,1,1,0,1,1,1,1
KR_6658330025,420,-1,19,0,7,-3,4,7,5,7,2,1,3,2,5,6,1,-1,0,1,0,10,-21,1,3,4,3,0,-1,1,-1,1,1,6,1
KR_6743030504,420,1,39,-16,2,2,2,0,-1,3,4,3,4,1,0,3,3,-2,0,2,-1,-6,-34,-1,6,5,14,0,0,1,-1,0,-1,4,1
KR_6587460529,420,1,15,-15,7,0,2,2,2,4,2,2,4,2,-2,3,5,5,6,1,1,10,45,3,2,5,-15,0,0,1,-1,0,1,1,1
KR_6755830809,420,5,18,30,4,0,2,2,6,7,1,-2,1,3,0,4,4,0,0,0,0,4,-4,1,5,6,5,0,2,1,1,1,1,4,1
KR_6631073872,420,4,54,28,1,-3,1,4,2,2,0,-4,0,4,2,3,1,4,6,2,0,5,0,-1,4,3,6,0,-1,1,-1,-1,1,1,1
KR_6764756549,420,1,7,-16,4,-1,3,4,4,5,1,-1,1,2,2,3,1,0,1,1,0,6,-100,-1,5,4,1,0,1,-1,1,1,-1,5,1
KR_6664789225,420,4,101,0,12,3,4,1,5,7,2,6,6,0,-1,5,6,-1,2,3,0,5,-65,-3,6,3,23,0,1,1,-1,1,1,3,1
KR_6710272134,420,0,-13,-24,7,1,4,3,4,6,2,1,2,1,1,6,5,0,0,0,0,8,3,2,2,4,-1,0,0,1,-1,1,-1,2,1
KR_6696865201,420,2,55,-35,11,8,8,0,0,3,3,0,1,1,1,2,1,2,2,0,0,6,161,-1,4,3,-2,0,4,0,1,1,1,0,1
KR_6730133060,440,-3,-59,-5,-10,-5,0,5,-3,0,3,-1,4,5,0,2,2,-1,2,3,0,-6,8,-6,9,3,1,0,-1,0,-1,-1,-1,0,1
KR_6681148688,420,-1,53,-4,-2,4,4,0,-1,7,8,-6,2,8,1,1,0,0,0,0,0,9,120,0,7,7,1,0,0,1,1,1,-1,3,1
KR_6690294802,420,4,99,11,4,0,2,2,1,5,4,3,7,4,1,2,1,-1,0,1,0,4,-14,-5,7,2,9,0,1,1,0,1,1,5,1
KR_6694450974,420,0,39,4,0,2,2,0,1,2,1,2,4,2,-5,1,6,0,0,0,0,-8,-8,-3,9,6,5,0,0,1,1,1,1,5,1
KR_6714321998,440,-2,-34,-23,-11,-1,1,2,-11,0,11,0,1,1,0,1,1,1,2,1,0,-17,-4,1,3,4,-1,0,0,1,0,0,-1,6,1
KR_6762654979,440,1,-16,-27,3,3,3,0,2,3,1,1,2,1,-1,1,2,-2,1,3,0,9,31,2,1,3,-5,0,0,0,0,0,-1,0,1
KR_6764107801,420,0,-40,-27,-4,0,1,1,2,3,1,0,2,2,-5,2,7,-1,0,1,0,-2,-6,-1,3,2,-2,0,0,-1,-1,0,-1,3,1
KR_6577121397,420,2,49,34,0,0,1,1,3,4,1,0,1,1,-5,2,7,2,2,0,1,2,48,7,1,8,-20,0,1,0,1,1,1,0,1
KR_6716739806,420,2,23,-15,11,-1,0,1,3,4,1,2,2,0,8,10,2,-1,1,2,1,11,11,1,2,3,0,0,1,1,1,1,1,5,1
KR_6566439663,420,4,24,1,13,5,5,0,2,5,3,6,6,0,0,4,4,0,3,3,0,5,-3,8,0,8,1,0,0,-1,0,1,1,3,1
KR_6755800189,420,-2,-64,8,-4,-2,0,2,-2,2,4,-2,1,3,0,8,8,2,3,1,0,3,3,-4,6,2,-2,0,-2,-1,-1,-1,-1,3,1
KR_6636208103,420,4,13,12,3,1,2,1,-2,2,4,3,4,1,2,3,1,-1,0,1,0,6,50,-2,6,4,-2,0,1,-1,1,1,1,6,1
KR_6744991450,440,4,31,-16,6,4,4,0,0,3,3,2,5,3,1,1,0,-1,1,2,0,3,2,0,4,4,2,0,0,-1,1,1,-1,5,1
KR_6731144392,420,4,40,22,7,1,2,1,1,2,1,2,2,0,3,4,1,0,0,0,0,9,-4,-1,5,4,-2,0,0,1,0,0,1,1,1
KR_6664695787,420,-1,13,-40,1,0,2,2,3,6,3,0,1,1,-1,2,3,-1,0,1,0,5,-1,1,3,4,0,0,0,-1,-1,0,-1,6,1
KR_6743752466,420,6,7,9,23,1,2,1,9,9,0,2,2,0,9,9,0,2,2,0,0,29,2,0,5,5,-5,0,0,1,-1,0,1,3,1
KR_6739189644,420,-3,-21,-4,2,1,2,1,0,3,3,-1,1,2,1,3,2,1,2,1,1,5,390,0,4,4,2,0,0,1,1,0,1,4,1
KR_6644119661,420,1,21,8,-1,-1,1,2,0,4,4,0,2,2,0,0,0,0,0,0,0,-2,-5,4,3,7,3,0,0,-1,0,1,-1,6,1
KR_6756014977,420,-1,-45,-24,4,0,3,3,0,1,1,1,2,1,3,4,1,0,0,0,0,6,-7,3,1,4,2,0,1,1,1,1,1,3,1
KR_6724791574,420,2,4,4,8,1,1,0,4,5,1,1,3,2,3,4,1,-1,0,1,0,6,5,1,3,4,0,0,0,1,0,1,1,5,1
KR_6727845044,420,1,27,8,4,-1,1,2,5,5,0,0,3,3,1,2,1,-1,0,1,1,10,10,0,2,2,-5,0,1,1,1,1,1,6,1
KR_6703745244,420,-5,-31,-12,-4,-5,0,5,-3,1,4,0,0,0,5,5,0,-1,1,2,2,0,8,6,0,6,-1,0,0,1,1,-1,1,4,1
KR_6748782238,420,1,50,26,0,-2,3,5,0,4,4,3,4,1,0,2,2,-1,2,3,0,0,-1,2,3,5,-6,0,0,-1,1,-1,-1,6,1
KR_6760822036,420,2,8,4,0,4,6,2,-5,2,7,-2,2,4,0,2,2,3,4,1,0,0,8,3,5,8,-3,0,1,-1,1,1,-1,3,1
KR_6369684424,420,0,73,24,-1,0,3,3,-3,1,4,-1,4,5,3,4,1,0,1,1,0,1,0,0,0,0,3,0,0,1,1,0,1,5,1
KR_6666402576,420,6,91,32,15,1,1,0,0,1,1,6,6,0,5,9,4,3,4,1,0,22,-126,5,4,9,8,0,2,1,1,1,-1,4,1
KR_6691657418,420,4,28,18,9,-3,2,5,1,1,0,1,2,1,11,14,3,-1,0,1,1,18,11,3,4,7,0,0,0,1,0,1,1,4,1
KR_6662957716,420,-1,2,30,-10,1,2,1,-6,1,7,4,4,0,-7,0,7,-2,0,2,-1,-15,-4,0,6,6,-2,0,0,0,1,-1,-1,0,1
KR_6758504910,420,3,23,-20,10,2,2,0,3,3,0,2,3,1,2,4,2,1,2,1,0,12,12,1,4,5,0,0,0,1,-1,1,1,3,1
KR_6758391685,420,2,77,-32,4,2,2,0,-1,2,3,3,5,2,0,3,3,0,1,1,-2,-3,-36,-1,4,3,-1,0,0,1,1,0,-1,3,1
KR_6640927021,420,-2,-22,0,4,-2,1,3,1,3,2,-1,1,2,4,8,4,2,2,0,-1,9,-2,-1,5,4,0,0,0,1,-1,1,-1,3,1
KR_6750829610,420,2,17,-24,5,3,5,2,1,5,4,3,3,0,-1,2,3,-1,0,1,0,1,-4,-1,4,3,3,0,0,-1,0,0,1,4,1
KR_6733327162,420,3,63,20,8,-2,2,4,3,6,3,3,3,0,2,4,2,2,3,1,0,9,10,5,0,5,-1,0,0,1,1,1,-1,3,1
KR_6596090440,420,-2,-15,39,-4,-1,1,2,-1,3,4,2,4,2,-2,2,4,-2,0,2,0,0,-3,-10,15,5,6,0,1,-1,1,1,1,3,1
KR_6758418743,420,4,34,-3,4,3,6,3,3,4,1,0,3,3,-2,1,3,0,1,1,1,3,8,-2,11,9,-7,0,0,-1,-1,0,1,6,1
KR_6756864758,420,-1,-43,8,0,1,4,3,1,2,1,-4,0,4,2,4,2,0,1,1,0,4,0,2,3,5,-1,0,0,-1,1,0,1,4,1
KR_6735720426,420,1,71,-48,5,-1,0,1,1,4,3,-2,1,3,7,7,0,0,0,0,0,8,-215,-3,5,2,-1,0,2,-1,-1,1,1,3,1
KR_6760542169,420,6,70,16,13,6,7,1,-2,0,2,2,3,1,6,7,1,1,2,1,0,7,-4,-7,9,2,0,0,1,1,1,1,1,5,1
KR_6689729948,420,5,144,7,8,4,5,1,1,1,0,2,5,3,-1,2,3,2,2,0,1,11,-8,4,5,9,6,0,4,1,1,1,1,4,1
KR_6660123364,420,-1,-30,-28,1,0,1,1,-2,3,5,0,2,2,2,6,4,1,1,0,0,1,-7,-5,8,3,5,0,0,-1,1,0,1,2,1
KR_6722531835,420,1,37,-16,3,-1,2,3,-7,0,7,5,6,1,4,8,4,2,2,0,-1,-3,6,-3,6,3,1,0,0,-1,-1,1,-1,2,1
KR_6518587559,420,-1,27,4,-2,-1,0,1,3,3,0,6,7,1,-4,1,5,-6,0,6,1,-4,-4,1,3,4,2,0,-1,1,-1,1,1,4,1
KR_6731234713,420,-3,-23,-4,-2,0,2,2,1,3,2,-3,0,3,-1,1,2,1,2,1,0,-1,298,6,3,9,-3,0,0,1,1,-1,1,6,1
KR_6750184643,420,-5,-72,-28,-15,4,4,0,1,2,1,-13,0,13,-1,2,3,-6,1,7,-1,-9,-5,1,4,5,0,0,-1,-1,0,-1,-1,2,1
KR_6740724394,420,0,53,-16,-7,2,2,0,-2,0,2,1,3,2,-1,1,2,-7,0,7,-1,-9,33,-1,4,3,-6,0,0,-1,0,0,-1,5,1
KR_6758874247,420,-2,-16,-20,3,5,6,1,0,6,6,-3,2,5,0,2,2,1,1,0,0,7,6,0,4,4,1,0,2,1,-1,1,1,6,1
KR_6760639128,420,-1,15,-24,-1,-1,1,2,4,4,0,-1,2,3,-4,2,6,1,4,3,2,1,-2,-2,5,3,-2,0,0,-1,0,0,1,1,1
KR_6762199110,420,2,27,32,0,-3,4,7,1,3,2,1,3,2,3,3,0,-2,3,5,0,0,4,4,2,6,2,0,2,1,-1,1,-1,5,1
KR_6706193328,420,5,24,14,4,-1,2,3,-1,4,5,0,1,1,1,2,1,5,6,1,0,2,5,-5,10,5,-2,0,2,1,1,1,1,4,1
KR_6720416421,420,2,54,18,7,4,4,0,-1,2,3,-5,0,5,5,6,1,4,5,1,0,3,4,0,2,2,1,0,0,-1,-1,1,-1,6,1
KR_6713180249,420,-1,-60,7,1,-3,1,4,0,4,4,3,3,0,1,1,0,0,2,2,0,6,18,-3,5,2,-1,0,-1,1,1,-1,1,4,1
KR_6680370174,440,4,-1,13,6,1,4,3,5,11,6,2,2,0,2,2,0,-4,1,5,0,7,12,-3,4,1,-3,0,0,1,-1,1,-1,4,1
KR_6733206347,420,0,-16,3,-5,-2,2,4,2,3,1,-2,0,2,-1,2,3,-2,0,2,0,-5,-5,-2,5,3,0,0,0,1,-1,0,-1,5,1
KR_6688904938,420,6,67,17,10,3,3,0,3,3,0,0,1,1,5,7,2,-1,0,1,0,6,116,0,7,7,4,0,1,1,1,1,-1,6,1
KR_6689030885,420,4,127,23,5,3,3,0,3,5,2,-4,3,7,5,5,0,-2,0,2,1,0,1,2,1,3,0,0,3,-1,1,1,1,5,1
KR_6689237588,420,-1,-6,-1,1,1,3,2,-3,1,4,0,2,2,3,4,1,0,0,0,1,1,9,0,6,6,4,0,0,-1,1,1,1,6,1
KR_6755670315,420,2,41,8,6,2,2,0,0,4,4,1,2,1,4,5,1,-1,3,4,0,4,-25,3,5,8,4,0,1,0,1,1,1,0,1
KR_6691218730,420,1,42,-13,4,5,7,2,-2,1,3,-2,3,5,4,8,4,-1,0,1,0,-6,8,2,5,7,0,0,1,-1,1,1,1,5,1
KR_6650351223,440,0,-2,16,-3,-2,1,3,3,3,0,1,1,0,-5,1,6,0,0,0,0,-5,-3,-8,9,1,0,0,1,-1,1,1,-1,6,1
KR_6750132896,420,3,49,-4,9,0,5,5,1,3,2,3,3,0,5,7,2,0,0,0,0,10,-34,-1,3,2,16,0,1,1,0,1,1,4,1
KR_6658001270,420,4,22,40,12,5,5,0,0,3,3,4,4,0,0,1,1,3,3,0,0,12,8,2,4,6,-1,0,1,1,1,1,1,4,1
KR_6649702223,420,0,-26,37,-2,4,5,1,1,2,1,1,1,0,-7,0,7,-1,1,2,1,-7,-3,-1,6,5,3,0,1,1,1,1,1,3,1
KR_6679157905,440,0,56,13,-4,1,3,2,3,5,2,-1,3,4,-7,0,7,0,1,1,0,-9,-70,-1,7,6,1,0,0,-1,0,0,-1,5,1
KR_6749172932,420,0,22,29,0,-2,1,3,2,3,1,2,4,2,0,1,1,-2,0,2,1,5,195,1,3,4,1,0,0,1,1,0,1,4,1
KR_6756567947,420,1,-2,17,11,5,6,1,2,2,0,3,4,1,1,5,4,0,1,1,1,10,-5,4,1,5,3,0,2,1,1,1,1,3,1
KR_6710120534,440,3,44,28,3,2,2,0,2,3,1,2,2,0,-3,0,3,0,0,0,0,1,0,-2,8,6,3,0,0,1,0,0,1,6,1
KR_6687973714,420,-3,-32,-4,-3,0,2,2,0,2,2,-3,1,4,1,4,3,-1,2,3,0,-7,1,1,3,4,-7,0,-1,1,-1,-1,-1,3,1
KR_6763020719,420,-2,-29,-12,-7,-2,0,2,-1,2,3,-2,1,3,-3,4,7,1,1,0,0,-2,9,-1,4,3,0,0,-2,-1,-1,-1,1,6,1
KR_6691793352,420,1,-18,-2,2,-2,1,3,1,4,3,-1,2,3,4,5,1,0,1,1,1,0,50,4,3,7,-2,0,0,1,-1,-1,1,4,1
KR_6749316638,420,2,49,2,8,-4,0,4,5,6,1,3,5,2,3,4,1,1,2,1,0,10,14,-2,6,4,4,0,1,0,1,1,1,0,1
KR_6744669738,420,2,-61,31,11,1,2,1,0,2,2,-1,2,3,6,6,0,5,6,1,0,15,9,4,3,7,-3,0,0,1,1,0,-1,4,1
KR_6729947111,420,5,35,20,4,0,3,3,2,5,3,2,2,0,1,2,1,-1,0,1,0,3,0,-1,5,4,3,0,1,1,1,1,-1,6,1
KR_6741348759,440,7,81,27,10,4,5,1,3,4,1,0,2,2,4,4,0,-1,2,3,0,4,1,6,1,7,2,0,1,0,1,1,1,0,1
KR_6745478509,420,2,-54,16,6,5,7,2,-1,1,2,1,2,1,-2,0,2,3,3,0,0,9,15,-2,4,2,2,0,1,1,1,1,1,5,1
KR_6606229534,420,-1,-18,-39,1,-2,2,4,1,3,2,0,1,1,1,3,2,1,1,0,1,4,12,1,2,3,2,0,0,1,-1,0,1,5,1
KR_6724745091,420,-1,-52,4,-1,-1,2,3,-1,2,3,4,6,2,0,1,1,-3,0,3,0,1,39,1,6,7,-14,0,0,1,1,-1,1,2,1
KR_6576954340,440,3,49,12,1,3,3,0,-2,1,3,2,2,0,-1,1,2,-1,0,1,1,-5,-9,-1,4,3,4,0,1,1,1,1,1,2,1
KR_6750968038,420,2,50,16,0,1,1,0,2,3,1,2,3,1,-4,3,7,-1,0,1,0,1,-4,-4,9,5,5,0,0,1,1,0,-1,6,1
KR_6741883341,420,8,88,33,14,2,4,2,-1,5,6,5,5,0,6,8,2,2,2,0,-1,11,8,-2,2,0,2,0,2,1,1,1,-1,6,1
KR_6751734624,420,3,108,61,11,-3,3,6,1,2,1,3,5,2,8,8,0,2,3,1,1,9,33,4,0,4,-1,0,2,1,1,1,1,3,1
KR_6762482631,420,2,23,8,9,3,4,1,2,2,0,2,4,2,0,1,1,2,2,0,0,12,-1,-2,6,4,2,0,1,1,-1,1,1,2,1
KR_6735204678,420,5,57,20,4,2,4,2,-2,1,3,2,3,1,2,4,2,0,1,1,0,2,-2,-1,6,5,-7,0,1,1,-1,1,1,5,1
KR_6494378113,420,0,29,34,-1,-4,1,5,2,4,2,-3,1,4,2,2,0,2,2,0,0,6,-9,0,7,7,-1,0,-1,1,1,1,-1,6,1
KR_6663760526,420,1,19,4,3,4,4,0,-5,1,6,0,5,5,2,5,3,2,3,1,0,3,2,8,1,9,3,0,0,1,-1,0,1,5,1
KR_6747148552,420,1,48,5,3,3,3,0,-4,1,5,1,3,2,3,4,1,0,0,0,0,2,259,0,6,6,0,0,0,1,1,0,1,5,1
KR_6708778560,420,0,0,-8,2,-2,0,2,0,5,5,3,4,1,0,4,4,1,2,1,0,2,-7,-1,6,5,3,0,0,-1,-1,0,-1,3,1
KR_6748333589,420,0,0,-11,3,-3,4,7,2,4,2,-1,2,3,1,6,5,4,4,0,0,6,20,1,1,2,-1,0,-1,1,-1,-1,-1,5,1
KR_6688537630,420,2,76,-2,3,1,2,1,-1,1,2,2,3,1,1,4,3,0,0,0,0,0,-22,0,5,5,-3,0,1,1,-1,-1,1,4,1
KR_6549306020,420,1,-45,6,4,0,1,1,-3,3,6,-1,5,6,2,4,2,6,6,0,0,14,29,0,4,4,3,0,0,1,1,1,-1,6,1
KR_6752502483,440,1,-42,3,-2,-2,0,2,0,2,2,1,1,0,-2,0,2,1,2,1,0,-4,15,0,4,4,-2,0,-1,1,-1,-1,-1,3,1
KR_6681132334,420,-3,-22,-8,0,2,3,1,-1,1,2,-1,2,3,1,3,2,-1,1,2,0,-6,2,5,3,8,-2,0,0,1,1,1,1,4,1
KR_6494384660,420,5,88,3,15,4,4,0,3,5,2,2,4,2,3,3,0,3,3,0,0,13,-9,4,4,8,3,0,3,1,1,1,1,2,1
KR_6730132948,440,2,47,-8,0,-1,4,5,-2,2,4,0,1,1,5,5,0,-2,0,2,0,10,4,-3,8,5,4,0,-1,1,-1,-1,1,4,1
KR_6733757443,420,1,-21,43,2,-5,1,6,4,5,1,0,4,4,3,5,2,0,0,0,1,14,-8,3,4,7,2,0,0,1,0,0,1,5,1
KR_6704255035,420,0,-60,-7,2,-1,3,4,1,4,3,1,3,2,-1,2,3,2,2,0,0,4,46,1,2,3,-2,0,0,1,0,0,-1,1,1
KR_6761318302,420,1,3,24,4,0,0,0,-4,1,5,2,2,0,4,5,1,2,2,0,0,7,-10,0,5,5,1,0,-1,1,-1,-1,-1,2,1
KR_6753815370,440,3,3,6,5,1,3,2,1,4,3,1,3,2,0,5,5,2,3,1,0,8,-7,-8,12,4,4,0,0,0,0,1,1,0,1
KR_6724489132,420,1,51,-6,6,1,3,2,2,5,3,-2,3,5,5,5,0,0,0,0,0,5,2,0,3,3,-2,0,1,1,1,1,1,2,1
KR_6764000624,420,-2,25,37,-2,-4,3,7,2,3,1,8,9,1,-6,1,7,-2,0,2,0,-5,38,2,3,5,-7,0,-1,1,0,-1,-1,4,1
KR_6758287829,420,0,37,-28,3,1,3,2,1,2,1,2,2,0,1,4,3,-2,1,3,0,7,-19,-1,5,4,2,0,0,1,-1,-1,1,4,1
KR_6705524861,420,1,38,-12,3,-2,0,2,-1,4,5,1,2,1,4,4,0,1,1,0,0,6,20,-2,5,3,5,0,0,1,-1,1,-1,3,1
KR_6590288736,420,1,87,18,1,-1,0,1,-4,1,5,1,2,1,4,5,1,1,3,2,0,-4,4,1,5,6,2,0,0,1,-1,-1,1,5,1
KR_6646591611,420,2,38,4,-7,-1,2,3,-2,3,5,-2,1,3,-1,3,4,-1,2,3,-3,-5,17,-3,9,6,-1,0,0,1,-1,0,-1,6,1
KR_6729107980,420,2,-42,36,-1,3,5,2,2,8,6,2,4,2,-6,2,8,-2,1,3,0,-2,8,2,1,3,0,0,0,-1,1,-1,-1,3,1
KR_6685344045,420,2,-4,39,3,1,1,0,-1,0,1,-1,2,3,2,3,1,2,2,0,0,4,141,4,3,7,1,0,2,1,1,1,1,3,1
KR_6758443991,420,4,115,0,5,2,6,4,2,4,2,-1,1,2,1,2,1,1,1,0,0,3,-269,1,4,5,6,0,1,1,-1,1,-1,2,1
KR_6571251050,420,-3,-5,-8,-3,1,3,2,2,4,2,-3,4,7,-4,0,4,1,3,2,0,-2,1,4,4,8,5,0,-1,-1,-1,1,1,1,1
KR_6730044779,440,-1,-56,-1,0,1,1,0,1,4,3,-1,2,3,1,7,6,-2,0,2,0,3,4,0,6,6,-3,0,0,1,-1,0,-1,5,1
KR_6762519102,420,0,-21,7,1,1,1,0,3,4,1,-1,1,2,-3,3,6,1,2,1,-1,1,-4,-2,3,1,2,0,-1,1,-1,-1,-1,5,1
KR_6717033669,420,-1,-21,-8,-5,-2,0,2,-2,1,3,-2,0,2,0,4,4,1,2,1,0,-2,-2,1,3,4,-5,0,-1,1,-1,-1,1,1,1
KR_6664445524,420,0,54,20,-1,-1,2,3,-2,0,2,3,4,1,1,2,1,-2,0,2,0,-6,6,8,4,12,-2,0,-1,-1,0,-1,-1,1,1
KR_6568152147,420,2,-9,-11,4,-2,1,3,1,2,1,3,5,2,2,4,2,0,0,0,0,9,-53,-3,5,2,35,0,-1,-1,1,-1,1,4,1
KR_6749406944,420,-4,6,-11,-9,4,5,1,-4,0,4,-1,3,4,-6,0,6,-2,1,3,0,-10,9,-3,4,1,-1,0,-1,1,1,-1,1,5,1
KR_6395620768,420,2,38,0,10,2,2,0,0,1,1,7,7,0,2,4,2,-1,1,2,0,3,-3,3,3,6,6,0,3,1,1,1,1,2,1
KR_6664515938,420,1,26,-8,4,0,1,1,2,2,0,-3,1,4,3,4,1,2,2,0,-1,4,-27,-3,4,1,1,0,1,0,1,1,-1,0,1
KR_6112347269,420,1,30,6,9,4,5,1,1,5,4,5,7,2,-1,2,3,0,0,0,1,0,13,-2,6,4,-2,0,1,0,1,1,1,0,1
KR_6625457695,420,2,64,-19,12,1,3,2,0,1,1,2,3,1,3,5,2,6,7,1,0,10,-3,2,3,5,5,0,1,1,1,1,1,5,1
KR_6672368017,420,-1,-9,21,6,0,2,2,6,6,0,-1,3,4,0,3,3,1,2,1,3,13,8,6,3,9,-3,0,2,-1,1,1,1,6,1
KR_6729126967,420,2,-1,35,14,6,6,0,6,10,4,0,2,2,1,5,4,1,2,1,0,10,6,7,2,9,-6,0,1,1,-1,1,1,4,1
KR_6741171048,440,-1,26,16,9,1,1,0,3,3,0,1,3,2,4,7,3,0,0,0,0,7,0,-1,7,6,6,0,0,1,1,1,1,4,1
KR_6720565141,420,0,36,3,-5,4,4,0,-2,1,3,-8,0,8,0,4,4,1,1,0,1,-7,2,-2,5,3,-1,0,1,-1,1,1,1,2,1
KR_6742076132,420,-2,-17,32,-4,0,1,1,-1,2,3,-2,1,3,3,6,3,-4,1,5,0,-8,-216,3,2,5,3,0,0,-1,1,0,-1,1,1
KR_6624166973,420,1,-2,44,-3,-1,1,2,0,2,2,-1,0,1,3,5,2,-4,0,4,0,-1,4,-2,2,0,1,0,0,1,-1,0,-1,4,1
KR_6735934206,420,-1,45,5,2,-1,2,3,-2,1,3,3,5,2,2,3,1,0,0,0,0,3,7,-5,6,1,0,0,0,-1,-1,0,1,4,1
KR_6761645716,420,-3,-43,28,-11,2,3,1,-4,2,6,-3,2,5,-5,1,6,-1,2,3,0,-13,-325,-3,4,1,-4,0,0,1,1,1,-1,5,1
KR_6601517706,420,4,40,15,12,5,5,0,2,3,1,3,3,0,4,8,4,-2,1,3,0,6,11,-5,9,4,3,0,2,-1,1,1,-1,2,1
KR_6737573240,420,2,43,-13,11,3,5,2,2,5,3,3,5,2,3,3,0,0,1,1,0,11,6,-2,5,3,-2,0,1,1,-1,1,1,5,1
KR_6739557455,420,4,130,56,7,3,4,1,2,3,1,4,4,0,0,2,2,-2,0,2,0,5,-1,4,3,7,1,0,1,1,1,1,1,1,1
KR_6749318458,440,-1,8,-32,4,0,2,2,4,5,1,0,1,1,1,2,1,-1,0,1,0,2,-16,-2,5,3,3,0,2,-1,1,-1,-1,5,1
KR_6762523684,440,1,-61,8,-5,1,1,0,1,4,3,-5,0,5,-4,1,5,2,3,1,0,3,-3,3,3,6,2,0,-4,1,-1,-1,-1,1,1
KR_6669832396,420,9,69,12,10,4,4,0,1,4,3,2,3,1,0,1,1,3,4,1,0,10,-20,-5,9,4,21,0,1,1,-1,1,-1,2,1
KR_6740221005,420,4,20,-16,11,3,4,1,3,3,0,0,1,1,3,4,1,2,2,0,0,15,-68,1,5,6,29,0,0,1,0,-1,1,2,1
KR_6763576331,440,4,3,-10,9,5,5,0,-1,1,2,-1,1,2,2,3,1,4,6,2,0,6,-4,-3,4,1,4,0,1,0,0,1,-1,0,1
KR_6737442174,420,8,87,20,18,6,6,0,3,6,3,2,2,0,7,8,1,0,2,2,0,9,19,-2,9,7,-3,0,2,1,1,1,-1,2,1
KR_6662472421,420,5,93,12,13,1,1,0,3,4,1,6,6,0,2,3,1,1,2,1,0,14,-2,1,5,6,5,0,3,1,1,1,1,2,1
KR_6744272062,420,2,28,4,5,2,3,1,1,2,1,3,3,0,-1,2,3,0,1,1,0,-1,0,-1,4,3,1,0,0,1,1,1,-1,6,1
KR_6686719629,420,0,-4,16,1,0,3,3,-1,1,2,-1,3,4,3,3,0,0,0,0,0,4,15,3,6,9,0,0,0,1,-1,1,1,3,1
KR_6720222312,420,5,106,8,1,1,3,2,1,3,2,0,2,2,-2,3,5,1,4,3,0,-6,8,-4,7,3,3,0,1,1,1,1,1,5,1
KR_6752970199,440,0,28,13,-1,-3,4,7,0,1,1,-1,1,2,3,8,5,0,0,0,1,-10,-1,1,4,5,-2,0,0,1,-1,0,1,2,1
KR_6473540903,420,1,-10,17,2,4,5,1,0,3,3,-4,1,5,2,3,1,0,0,0,0,4,17,3,2,5,0,0,1,1,1,1,-1,5,1
KR_6738849059,420,8,61,20,19,4,7,3,7,7,0,3,4,1,5,6,1,0,0,0,0,14,1,1,3,4,1,0,1,1,1,1,-1,4,1
KR_6761982125,420,-2,11,8,9,4,5,1,-3,1,4,-2,0,2,1,1,0,9,9,0,0,1,-3,1,1,2,-1,0,0,-1,-1,-1,1,6,1
KR_6500314066,420,1,23,-20,1,0,1,1,-1,3,4,-1,2,3,-1,4,5,4,4,0,0,-2,5,2,3,5,3,0,1,-1,1,1,1,2,1
KR_6714845814,420,2,60,3,6,5,7,2,-6,1,7,4,6,2,-1,1,2,4,4,0,0,-7,-8,4,3,7,0,0,1,1,1,1,1,4,1
KR_6689483073,420,2,19,34,6,-2,1,3,1,2,1,6,8,2,1,2,1,0,0,0,0,8,-1,3,2,5,-3,0,0,1,0,0,-1,6,1
KR_6748558265,420,1,25,28,-5,0,0,0,3,5,2,-6,2,8,0,3,3,-2,1,3,-1,-5,-131,-1,8,7,-4,0,1,-1,1,1,-1,4,1
KR_6732013484,420,3,7,12,10,0,2,2,-1,4,5,0,1,1,8,10,2,3,3,0,3,25,9,4,3,7,-5,0,2,-1,0,1,1,2,1
KR_6746197376,420,4,31,32,7,4,5,1,5,5,0,2,4,2,-2,1,3,-2,1,3,0,4,21,-3,8,5,5,0,0,0,1,1,-1,0,1
KR_6691357440,420,2,-46,24,7,-1,2,3,5,5,0,-1,0,1,3,5,2,1,1,0,0,15,13,-2,8,6,-6,0,-1,1,1,-1,1,3,1
KR_6608848530,420,3,48,-7,5,8,8,0,-1,3,4,0,0,0,-3,1,4,1,1,0,1,-4,18,2,6,8,-2,0,4,-1,1,1,1,3,1
KR_6745414677,420,0,-10,-8,-1,1,4,3,1,1,0,-8,1,9,7,8,1,-2,0,2,-3,2,218,-6,9,3,6,0,0,-1,-1,-1,-1,5,1
KR_6726120079,420,1,31,0,0,4,6,2,-3,1,4,0,2,2,0,3,3,-1,0,1,0,-2,14,1,3,4,0,0,1,1,1,1,-1,4,1
KR_6755614889,420,2,66,-12,4,3,4,1,-1,0,1,1,2,1,-3,1,4,4,4,0,0,-3,-7,-3,6,3,3,0,1,1,1,1,1,3,1
KR_6757774198,420,9,47,36,6,2,4,2,1,5,4,8,9,1,-3,3,6,-2,2,4,-3,-4,1,0,6,6,2,0,1,1,-1,1,-1,5,1
KR_6763309136,440,2,81,20,4,5,8,3,-3,1,4,-1,0,1,3,4,1,0,0,0,0,1,-5,-5,9,4,3,0,1,-1,1,1,1,3,1
KR_6755989689,420,5,69,12,10,5,5,0,-2,1,3,1,3,2,6,7,1,0,0,0,0,2,-6,1,7,8,1,0,1,-1,1,1,1,6,1
KR_6737787288,420,2,45,-27,2,2,2,0,-2,1,3,2,5,3,0,1,1,0,2,2,0,0,-300,4,0,4,14,0,1,1,-1,1,1,2,1
KR_6729222014,420,4,96,37,6,3,7,4,4,6,2,-2,2,4,1,4,3,0,1,1,0,6,73,1,4,5,-5,0,3,-1,1,1,1,4,1
KR_6678725758,420,3,-6,0,7,-3,0,3,0,0,0,6,6,0,6,7,1,-2,0,2,0,13,8,5,3,8,1,0,0,1,-1,0,1,4,1
KR_6759530431,440,3,23,29,12,3,3,0,2,2,0,2,3,1,7,12,5,-2,0,2,2,25,0,-1,3,2,-1,0,0,1,1,1,1,4,1
KR_6748274864,420,-2,25,-12,0,1,4,3,-1,2,3,1,2,1,-1,3,4,0,1,1,1,3,-25,3,3,6,0,0,0,0,0,0,1,0,1
KR_6644686877,440,2,23,1,14,2,2,0,1,3,2,2,2,0,9,9,0,0,1,1,0,16,9,2,4,6,-2,0,2,1,1,1,1,3,1
KR_6628098338,420,2,20,-12,3,-1,3,4,5,9,4,2,2,0,-3,1,4,0,0,0,0,1,265,-1,6,5,1,0,1,1,1,1,1,4,1
KR_6669826483,420,1,24,-24,4,-1,3,4,9,9,0,3,8,5,-5,1,6,-2,0,2,1,7,-8,-1,5,4,3,0,0,-1,1,1,1,1,1
KR_6591732716,420,-4,-33,-12,-3,0,0,0,0,2,2,2,3,1,1,3,2,-6,0,6,-1,-6,-6,3,5,8,0,0,0,-1,-1,0,-1,6,1
KR_6746186398,440,3,70,12,4,5,7,2,0,1,1,-2,6,8,-1,3,4,2,2,0,0,5,-4,-3,7,4,-2,0,1,1,1,1,1,5,1
KR_6732180032,420,4,48,11,6,3,4,1,4,6,2,1,2,1,-2,0,2,0,0,0,0,10,249,-1,4,3,-2,0,3,1,1,1,-1,6,1
KR_6749352320,420,5,64,40,8,1,2,1,2,4,2,2,3,1,3,3,0,0,1,1,0,14,6,3,2,5,0,0,1,1,1,1,1,5,1
KR_6761551757,420,-1,-16,-10,-2,0,0,0,1,5,4,2,4,2,-1,1,2,-4,0,4,0,3,22,-1,4,3,0,0,-1,1,-1,-1,1,4,1
KR_6750167366,420,1,14,-16,0,-1,0,1,0,3,3,0,2,2,1,4,3,0,0,0,-1,0,293,-6,10,4,1,0,0,1,-1,-1,-1,6,1
KR_6704817395,420,-4,-36,-8,-4,-4,0,4,0,2,2,0,1,1,-1,2,3,1,1,0,0,-6,-7,-5,8,3,5,0,-2,-1,-1,-1,-1,2,1
KR_6729309163,420,4,46,24,13,1,3,2,0,4,4,1,1,0,8,8,0,3,4,1,1,15,-6,2,3,5,-1,0,0,1,1,1,1,5,1
KR_6741909274,420,1,5,40,1,3,4,1,2,2,0,-3,0,3,-1,3,4,0,0,0,0,0,-3,-3,4,1,-1,0,0,-1,-1,-1,1,4,1
KR_6714009130,420,3,-74,23,6,2,3,1,3,5,2,3,5,2,0,2,2,-2,0,2,0,-1,108,-3,6,3,1,0,2,1,1,1,1,2,1
KR_6629285461,420,1,50,-46,7,5,7,2,-6,1,7,3,4,1,4,9,5,1,2,1,-1,0,4,0,4,4,3,0,-1,-1,1,1,1,5,1
KR_6664642327,420,1,43,-16,2,4,4,0,1,3,2,-4,0,4,2,3,1,-1,1,2,0,3,4,-1,5,4,-1,0,1,-1,-1,1,-1,2,1
KR_6623917732,420,3,81,36,10,0,3,3,3,4,1,2,2,0,4,8,4,1,2,1,1,2,8,-1,7,6,3,0,1,1,1,1,1,4,1
KR_6713173078,420,4,6,-4,6,3,4,1,0,5,5,2,6,4,1,1,0,0,1,1,0,3,2,-6,10,4,0,0,0,0,-1,0,1,0,1
KR_6687024224,420,3,52,29,4,-5,0,5,0,2,2,7,7,0,1,3,2,1,1,0,0,8,18,0,5,5,1,0,2,1,1,1,1,1,1
KR_6754381412,420,2,7,0,0,5,6,1,0,1,1,-1,2,3,-3,0,3,-1,0,1,0,-2,-101,0,2,2,-2,0,-2,1,-1,-1,1,2,1
KR_6762436233,420,1,-43,12,0,-2,0,2,2,3,1,-1,2,3,-1,2,3,2,4,2,-1,1,-17,-4,6,2,1,0,-1,1,-1,-1,-1,6,1
KR_6731622059,420,5,60,22,8,4,4,0,2,5,3,6,6,0,-4,2,6,0,1,1,0,4,-1,2,2,4,4,0,1,1,1,1,1,3,1
KR_6286939714,440,4,44,13,3,2,4,2,1,4,3,0,2,2,-4,1,5,4,4,0,0,-3,2,-5,7,2,5,0,1,1,0,1,-1,4,1
KR_6699148823,420,2,31,17,0,1,2,1,1,2,1,3,4,1,-4,0,4,-1,1,2,0,-5,11,0,4,4,0,0,3,-1,-1,1,1,3,1
KR_6748490389,420,1,9,28,4,-1,1,2,2,4,2,2,2,0,4,6,2,-3,2,5,0,2,22,-1,3,2,1,0,1,-1,-1,1,-1,5,1
KR_6695547978,420,-3,11,24,-4,-2,2,4,-1,1,2,1,4,3,-2,1,3,0,3,3,0,-8,-32,1,3,4,21,0,1,1,1,1,1,2,1
KR_6738678164,420,7,89,56,9,8,9,1,4,10,6,1,1,0,-3,2,5,-1,3,4,-1,-4,4,-4,7,3,3,0,2,1,1,1,-1,4,1
KR_6661503030,420,-1,50,-3,-2,2,3,1,-3,2,5,-3,1,4,2,4,2,0,0,0,0,1,10,1,1,2,2,0,0,1,1,1,-1,3,1
KR_6724542973,420,4,-19,20,0,3,4,1,-4,1,5,1,4,3,1,1,0,-1,1,2,0,2,24,-2,4,2,-2,0,-1,1,0,-1,-1,3,1
KR_6686427199,420,2,50,10,8,3,5,2,2,5,3,-1,1,2,4,4,0,0,1,1,0,11,5,0,4,4,-4,0,0,1,-1,1,1,3,1
KR_6656455033,420,4,-6,8,9,3,4,1,1,4,3,3,4,1,3,5,2,-1,3,4,0,10,3,0,5,5,3,0,1,1,-1,1,-1,4,1
KR_6536827042,440,-4,-23,-2,-9,-3,1,4,-3,1,4,0,0,0,1,4,3,-4,1,5,0,-4,22,2,3,5,1,0,-3,1,-1,-1,-1,5,1
KR_6734791186,420,0,55,4,0,4,4,0,-2,4,6,-1,1,2,-2,0,2,1,1,0,0,0,-24,1,5,6,6,0,2,-1,1,1,1,1,1
KR_6702675794,420,6,105,28,18,2,3,1,5,8,3,5,6,1,3,3,0,3,5,2,1,10,-42,2,3,5,10,0,5,1,1,1,1,6,1
KR_6741861722,420,-1,-59,-6,-1,-2,0,2,3,3,0,1,3,2,-5,1,6,2,3,1,1,0,-5,-6,6,0,1,0,1,1,1,1,-1,2,1
KR_6738680205,420,1,12,-36,3,0,2,2,3,3,0,-1,0,1,2,3,1,-1,3,4,0,-1,-5,0,3,3,3,0,0,1,-1,-1,-1,4,1
KR_6737096379,420,4,-34,10,8,0,3,3,-1,2,3,4,4,0,4,4,0,1,1,0,0,7,2,1,4,5,0,0,1,1,1,-1,1,6,1
KR_6695235003,420,2,15,33,0,2,2,0,2,3,1,-4,2,6,0,5,5,0,1,1,1,8,4,-3,4,1,6,0,1,1,0,1,1,5,1
KR_6539674449,420,3,33,17,6,3,5,2,-3,1,4,1,3,2,5,6,1,0,3,3,0,1,0,-1,4,3,1,0,0,-1,1,1,1,1,1
KR_6754300634,420,9,102,25,13,0,1,1,3,5,2,3,4,1,10,11,1,-3,0,3,-1,12,3,-1,6,5,3,0,1,1,-1,1,-1,1,1
KR_6726037895,420,2,-34,16,-3,-4,2,6,-1,2,3,1,2,1,-1,2,3,2,2,0,0,6,-285,-4,5,1,25,0,0,1,-1,-1,-1,2,1
KR_6714548052,420,1,34,23,8,-2,0,2,3,4,1,2,3,1,1,2,1,4,6,2,0,12,-26,3,4,7,1,0,1,1,1,1,1,4,1
KR_6709163333,420,0,57,-21,-2,-1,1,2,2,5,3,-3,0,3,0,2,2,0,1,1,0,1,-122,-1,7,6,-3,0,1,1,-1,1,-1,5,1
KR_6492050868,420,0,5,19,-3,-2,0,2,-3,1,4,4,4,0,-4,0,4,2,2,0,0,-3,6,4,2,6,1,0,1,1,1,1,1,5,1
KR_6764344469,420,0,59,16,1,1,3,2,0,4,4,1,7,6,0,3,3,-1,0,1,0,-7,7,4,1,5,-1,0,1,1,1,1,1,2,1
KR_6644624661,420,3,26,-14,2,0,3,3,-3,2,5,-2,1,3,3,6,3,4,4,0,0,4,-7,3,3,6,1,0,0,1,-1,1,-1,1,1
KR_6748373731,420,7,84,47,14,2,3,1,-1,3,4,5,9,4,8,8,0,0,0,0,0,0,0,-2,6,4,1,0,1,1,1,1,1,1,1
KR_6744505665,420,-1,17,7,-6,1,3,2,0,1,1,-2,2,4,-3,1,4,-2,0,2,-1,-11,0,-4,8,4,1,0,0,-1,0,1,-1,6,1
KR_6754445876,420,2,44,-13,5,2,3,1,3,5,2,2,4,2,0,3,3,-2,0,2,1,9,-19,2,5,7,3,0,0,-1,-1,0,1,6,1
KR_6629370840,420,1,39,22,-1,5,7,2,2,2,0,2,3,1,-12,1,13,2,3,1,0,-8,19,-1,5,4,2,0,-1,1,-1,-1,1,4,1
KR_6723978985,420,3,20,14,-3,2,2,0,-1,3,4,0,2,2,-2,3,5,-2,1,3,1,-2,-3,-1,8,7,-3,0,-1,1,-1,-1,1,6,1
KR_6743966821,420,3,5,-12,10,3,4,1,-1,0,1,4,5,1,2,4,2,2,2,0,0,17,6,1,7,8,2,0,2,1,-1,1,-1,1,1
KR_6737176651,420,2,7,4,5,0,4,4,0,1,1,0,2,2,4,5,1,1,1,0,0,12,42,0,2,2,-14,0,1,-1,1,1,1,4,1
KR_6624474194,420,0,12,-6,-1,6,7,1,-5,1,6,-1,2,3,-3,1,4,2,3,1,0,-7,4,-1,3,2,-4,0,0,-1,1,-1,-1,4,1
KR_6696551267,420,-2,-70,-26,-7,-2,1,3,-6,0,6,1,3,2,-2,1,3,2,4,2,0,-4,-104,0,3,3,2,0,-1,-1,-1,-1,-1,3,1
KR_6764442564,420,1,26,27,7,3,4,1,1,5,4,2,7,5,0,1,1,1,2,1,-1,3,14,-1,5,4,-1,0,-2,0,-1,1,-1,0,1
KR_6724309705,420,1,68,-12,-1,-1,2,3,-3,1,4,1,1,0,1,2,1,1,1,0,0,1,7,0,4,4,-1,0,1,0,-1,1,-1,0,1
KR_6399065257,420,1,-21,14,5,-1,2,3,0,3,3,5,6,1,0,3,3,1,4,3,0,6,1,-1,4,3,2,0,0,1,1,0,1,6,1
KR_6762820819,420,6,96,1,14,3,4,1,5,7,2,0,1,1,5,6,1,1,3,2,0,14,12,-2,9,7,9,0,1,-1,1,1,1,5,1
KR_6709073820,420,-1,-84,-34,6,-2,0,2,0,6,6,-1,1,2,6,8,2,3,3,0,0,11,-1,1,5,6,5,0,-1,1,1,-1,1,5,1
KR_6730197662,440,4,30,-1,7,2,3,1,2,4,2,5,8,3,3,4,1,-5,1,6,0,1,-6,-2,7,5,3,0,0,-1,1,1,-1,2,1
KR_6573626063,420,1,9,-11,6,3,3,0,2,4,2,-2,0,2,3,4,1,0,1,1,0,6,-1,4,6,10,1,0,0,1,-1,0,1,3,1
KR_6746312405,420,3,51,12,8,5,6,1,-2,2,4,3,4,1,0,0,0,2,2,0,0,5,-251,5,2,7,-7,0,0,1,-1,1,1,6,1
KR_6752210710,420,2,22,6,8,-1,1,2,5,7,2,-1,2,3,4,4,0,1,2,1,0,9,7,1,3,4,-3,0,0,1,-1,0,1,3,1
KR_6752742716,420,3,14,4,9,0,1,1,-2,3,5,5,8,3,4,4,0,2,2,0,0,13,-243,2,3,5,2,0,2,1,1,1,1,3,1
KR_6657354875,440,1,86,7,-3,0,3,3,-1,1,2,1,3,2,-2,1,3,-1,2,3,-1,-13,-9,-2,3,1,2,0,1,1,1,1,-1,5,1
KR_6749435131,420,-2,-8,0,-9,0,1,1,0,3,3,-2,1,3,-5,2,7,-2,0,2,1,-11,-2,-4,5,1,-3,0,0,-1,-1,0,1,4,1
KR_6759972729,440,4,64,2,1,2,2,0,-3,1,4,0,2,2,1,2,1,1,1,0,-2,0,-27,1,2,3,-7,0,-1,1,-1,-1,-1,6,1
KR_6684882147,420,4,67,19,8,3,6,3,-1,1,2,4,6,2,0,6,6,2,2,0,0,0,-118,-1,2,1,1,0,1,-1,1,1,1,3,1
KR_6538296281,420,1,-26,-1,-2,-1,0,1,-1,0,1,-4,3,7,5,9,4,-1,0,1,0,2,-31,1,4,5,-1,0,-1,1,-1,-1,-1,5,1
KR_6732118368,420,4,86,-17,8,0,4,4,4,5,1,2,3,1,1,5,4,1,2,1,-1,12,2,-5,6,1,1,0,1,1,1,1,-1,4,1
KR_6655268097,420,-2,-81,-34,-1,5,6,1,-1,3,4,-3,0,3,-3,4,7,1,2,1,0,12,5,5,1,6,-3,0,0,0,0,-1,-1,0,1
KR_6738545439,420,1,-10,44,0,-1,1,2,0,2,2,1,3,2,-2,3,5,2,4,2,0,-5,3,1,3,4,4,0,1,-1,0,1,1,6,1
KR_6762359627,420,0,-35,8,0,-3,0,3,1,4,3,1,4,3,0,0,0,1,1,0,0,1,5,2,3,5,-3,0,0,1,1,-1,-1,5,1
KR_6494740628,420,1,76,-16,8,-1,0,1,5,6,1,0,0,0,4,5,1,0,1,1,0,13,58,1,5,6,-2,0,1,-1,-1,1,1,2,1
KR_6753275331,420,1,-49,-12,10,2,4,2,2,2,0,6,9,3,-1,0,1,1,2,1,0,5,16,-2,3,1,6,0,0,-1,1,0,1,2,1
KR_6578483852,420,0,23,-17,-4,3,5,2,-5,2,7,1,4,3,-2,1,3,-1,1,2,0,-8,2,-1,10,9,2,0,1,-1,-1,1,1,6,1
KR_6750992564,420,4,111,32,8,2,2,0,1,3,2,1,4,3,4,5,1,0,2,2,0,7,34,5,1,6,-23,0,1,1,1,1,1,2,1
KR_6473478439,420,2,2,8,4,0,0,0,-1,0,1,2,4,2,2,2,0,1,1,0,0,7,-10,4,2,6,-3,0,1,1,1,1,1,4,1
KR_6763116390,420,-3,-12,-4,-9,-2,0,2,3,3,0,-4,7,11,-1,1,2,-5,0,5,0,-9,-4,-3,5,2,-2,0,0,-1,1,-1,-1,2,1
KR_6749360928,440,6,26,-12,17,4,4,0,1,1,0,7,7,0,3,4,1,2,2,0,1,20,5,5,0,5,-3,0,0,1,-1,0,1,5,1
KR_6715002785,440,3,14,12,7,-1,0,1,1,5,4,4,4,0,1,1,0,2,2,0,0,7,-19,-2,4,2,2,0,0,1,-1,-1,1,3,1
KR_6682620532,420,5,94,8,3,1,4,3,-3,0,3,0,2,2,5,5,0,0,1,1,0,3,2,-1,4,3,2,0,2,1,-1,1,-1,5,1
KR_6719002400,420,0,-21,-1,3,2,3,1,0,3,3,1,5,4,-2,2,4,2,2,0,0,3,0,-1,5,4,2,0,2,1,1,1,-1,5,1
KR_6764052702,420,3,44,18,3,-2,2,4,0,3,3,7,7,0,-1,0,1,-1,1,2,1,-2,250,-2,6,4,1,0,0,1,1,-1,1,2,1
KR_6739649165,440,5,16,9,12,4,4,0,7,9,2,5,6,1,-2,0,2,-2,2,4,0,1,21,-1,3,2,1,0,1,1,1,1,1,4,1
KR_6471289139,420,-2,-48,10,0,-2,0,2,7,7,0,-3,1,4,-2,2,4,0,1,1,0,3,-6,-4,6,2,5,0,1,1,-1,1,1,1,1
KR_6750963524,420,6,129,44,11,0,0,0,6,6,0,0,2,2,1,1,0,4,4,0,0,17,19,3,0,3,0,0,1,1,1,1,-1,2,1
KR_6455491884,420,5,22,44,3,2,4,2,4,7,3,-5,2,7,4,5,1,-2,2,4,1,1,0,-1,5,4,4,0,1,1,1,1,1,2,1
KR_6752520295,420,-2,-32,-19,-9,2,3,1,-2,0,2,-3,3,6,-2,1,3,-4,0,4,0,-14,-32,-5,9,4,2,0,0,-1,0,-1,-1,4,1
KR_6752066316,420,3,-5,33,-1,2,3,1,-3,1,4,0,0,0,0,3,3,0,1,1,0,-5,2,2,7,9,0,0,0,0,-1,0,1,0,1
KR_6738569713,420,2,66,28,3,2,2,0,-3,4,7,2,2,0,0,2,2,2,2,0,0,2,533,1,3,4,-1,0,0,1,-1,1,1,6,1
KR_6747985758,420,6,67,43,9,3,4,1,3,5,2,0,4,4,1,3,2,2,2,0,0,2,-8,-5,7,2,3,0,2,1,1,1,-1,3,1
KR_6678538760,420,3,40,23,8,0,1,1,7,8,1,2,3,1,-2,3,5,1,2,1,0,5,-29,3,3,6,-1,0,0,1,1,0,1,6,1
KR_6763584672,420,9,81,56,23,5,5,0,2,3,1,13,13,0,2,3,1,1,1,0,0,14,282,5,2,7,1,0,4,1,1,1,1,2,1
KR_6608183849,420,4,-6,-12,8,1,2,1,-2,2,4,6,7,1,2,4,2,1,1,0,0,5,2,3,6,9,-1,0,0,1,-1,-1,-1,2,1
KR_6754906128,420,0,-17,8,-2,1,6,5,0,1,1,-1,1,2,-2,0,2,0,2,2,0,-1,-29,-2,5,3,-5,0,1,-1,1,1,-1,1,1
KR_6755185566,420,3,33,-1,7,5,5,0,-3,1,4,2,2,0,4,6,2,-1,0,1,0,0,6,2,3,5,2,0,0,1,1,0,1,6,1
KR_6609973242,420,2,11,13,3,-1,2,3,-4,1,5,-1,1,2,8,8,0,1,1,0,0,12,22,1,4,5,1,0,2,1,1,1,-1,1,1
KR_6742179684,420,4,120,4,6,3,4,1,1,5,4,1,4,3,3,5,2,-2,0,2,0,5,0,2,2,4,1,0,3,1,1,1,-1,3,1
KR_6674707133,420,4,5,28,13,8,8,0,4,6,2,4,5,1,-3,4,7,0,2,2,1,6,9,0,4,4,1,0,0,-1,1,1,1,4,1
KR_6619048644,420,4,21,12,11,5,5,0,0,2,2,3,3,0,1,1,0,2,2,0,0,8,1,-4,8,4,-2,0,1,0,0,1,-1,0,1
KR_6661490178,420,2,-3,23,10,1,2,1,4,6,2,6,7,1,-1,1,2,0,0,0,0,10,-167,-1,5,4,2,0,0,-1,1,0,1,3,1
KR_6506313122,420,2,41,-24,8,1,2,1,-2,1,3,8,8,0,1,4,3,0,0,0,0,6,-15,-5,8,3,3,0,0,1,-1,0,1,6,1
KR_6582879767,420,2,14,-20,9,1,2,1,-1,2,3,3,3,0,3,3,0,3,3,0,0,16,7,2,5,7,1,0,2,1,-1,1,-1,3,1
KR_6654045045,420,0,55,-12,3,0,1,1,4,8,4,-1,0,1,2,4,2,-2,0,2,1,6,-21,-1,5,4,0,0,0,1,-1,-1,1,1,1
KR_6570458233,420,2,69,10,7,1,1,0,0,3,3,3,3,0,2,3,1,1,1,0,0,8,5,0,6,6,1,0,1,1,1,1,1,5,1
KR_6764690739,420,1,-30,23,7,-3,1,4,5,8,3,2,4,2,1,5,4,2,3,1,2,0,-4,-1,3,2,0,0,0,1,1,-1,1,2,1
KR_6761566692,420,1,21,0,-1,2,2,0,-1,3,4,1,4,3,-3,3,6,0,3,3,0,-6,11,0,5,5,1,0,0,-1,1,1,-1,1,1
KR_6683981561,420,-1,29,20,0,-1,4,5,0,3,3,-1,1,2,3,3,0,-1,0,1,0,2,9,1,1,2,1,0,1,1,0,1,1,4,1
KR_6761719880,420,2,10,-3,16,1,3,2,3,6,3,10,10,0,1,3,2,1,2,1,0,16,29,0,4,4,-1,0,0,1,1,1,1,5,1
KR_6658241830,420,0,7,1,0,-1,2,3,1,3,2,-1,0,1,2,5,3,-1,1,2,0,2,-20,-2,6,4,-5,0,-1,1,1,-1,1,5,1
KR_6708250825,420,-2,-21,-3,-2,1,2,1,-1,3,4,2,6,4,-4,2,6,0,0,0,0,0,1,5,1,6,-3,0,2,-1,1,1,-1,2,1
KR_6750271819,420,-1,48,-15,-4,2,4,2,-1,2,3,0,2,2,1,3,2,-6,1,7,0,-6,0,0,2,2,2,0,1,-1,1,1,-1,1,1
KR_6715997736,420,3,-9,29,7,0,2,2,2,2,0,4,4,0,1,3,2,0,0,0,0,3,46,-1,9,8,-31,0,0,1,-1,0,1,3,1
KR_6757783323,420,2,35,28,2,1,3,2,0,2,2,1,2,1,-5,1,6,5,6,1,0,4,56,3,2,5,-17,0,1,1,1,1,1,3,1
KR_6759318833,420,-1,55,-5,0,0,0,0,1,2,1,2,4,2,-3,1,4,0,1,1,0,-4,-2,5,1,6,-4,0,0,1,1,0,1,2,1
KR_6762576335,420,0,32,8,2,2,3,1,2,5,3,4,4,0,-5,2,7,-1,1,2,0,-2,-212,0,8,8,-3,0,0,0,-1,-1,1,0,1
KR_6710112718,420,1,72,-15,5,1,3,2,1,3,2,4,7,3,-2,0,2,1,3,2,0,1,-1,2,4,6,-3,0,4,1,1,1,1,1,1
KR_6756160992,420,0,29,12,5,-4,2,6,2,3,1,3,6,3,2,5,3,2,3,1,0,1,6,0,3,3,-5,0,2,1,1,1,1,2,1
KR_6759914495,440,1,4,-9,-5,2,3,1,1,1,0,0,2,2,-4,2,6,-4,0,4,0,-9,-4,-3,6,3,1,0,-1,-1,1,-1,-1,6,1
KR_6740802931,420,4,45,-13,8,1,2,1,3,4,1,3,6,3,1,2,1,0,2,2,0,11,44,2,3,5,-1,0,0,1,0,1,1,2,1
KR_6619485589,440,2,-18,-5,5,5,6,1,-1,2,3,-4,2,6,3,5,2,2,4,2,0,3,1,-1,5,4,4,0,2,-1,1,1,1,2,1
KR_6695616414,420,1,26,-4,6,1,1,0,1,5,4,-3,4,7,3,4,1,4,5,1,0,13,-5,-6,6,0,-3,0,1,1,-1,1,-1,6,1
KR_6112362628,420,3,28,22,4,-2,1,3,2,5,3,2,5,3,2,2,0,0,1,1,0,0,-16,-2,5,3,-1,0,0,-1,-1,0,-1,5,1
KR_6702934881,420,-1,34,-43,0,3,3,0,-1,1,2,1,3,2,-3,1,4,0,1,1,0,-2,-4,0,4,4,3,0,2,0,1,1,1,0,1
KR_6738712025,420,5,69,12,13,4,5,1,-5,0,5,3,3,0,6,6,0,5,5,0,-1,7,11,0,2,2,0,0,1,1,-1,1,-1,1,1
KR_6733232702,420,3,-9,32,9,-1,0,1,4,5,1,2,5,3,3,5,2,1,1,0,2,9,-109,1,4,5,-4,0,1,1,1,1,1,6,1
KR_6745155502,420,1,1,-8,5,-2,0,2,3,7,4,-2,0,2,5,6,1,1,3,2,0,10,-127,-1,8,7,-5,0,1,0,1,1,1,0,1
KR_6545715797,420,3,65,8,5,4,5,1,2,7,5,0,4,4,-2,1,3,1,1,0,-2,-2,3,1,2,3,4,0,2,1,1,1,-1,3,1
KR_6674184080,420,-1,24,-24,1,3,3,0,-1,3,4,1,2,1,-2,2,4,0,1,1,0,3,6,4,5,9,-4,0,0,-1,-1,-1,-1,1,1
KR_6651222863,420,-1,-9,-22,10,-2,0,2,7,8,1,-2,1,3,6,7,1,1,1,0,0,20,7,2,4,6,1,0,0,1,1,1,-1,3,1
KR_6764327605,420,-1,25,28,3,2,3,1,1,4,3,-1,1,2,1,5,4,0,1,1,0,4,1,-2,4,2,0,0,0,1,-1,0,1,1,1
KR_6754313545,420,4,-22,29,12,1,3,2,6,8,2,2,3,1,3,3,0,0,1,1,0,12,-301,0,4,4,0,0,1,1,-1,1,1,2,1
KR_6761862752,420,4,33,28,5,5,6,1,-1,2,3,6,8,2,-4,0,4,-1,2,3,0,-1,-20,1,4,5,2,0,1,-1,1,1,-1,1,1
KR_6764038599,420,-1,-21,-25,7,0,0,0,1,3,2,-2,1,3,5,5,0,3,5,2,1,8,4,-2,4,2,7,0,1,1,-1,1,1,4,1
KR_6718156256,440,5,62,8,13,1,1,0,0,2,2,4,5,1,5,5,0,3,5,2,1,10,1,-1,4,3,0,0,0,0,-1,0,-1,0,1
KR_6713663324,420,-1,73,-8,-1,-5,1,6,-2,0,2,1,3,2,4,5,1,1,2,1,0,8,-2,2,3,5,-1,0,-1,1,-1,-1,1,2,1
KR_6736398815,420,2,50,16,4,-1,3,4,3,4,1,2,3,1,-1,3,4,1,2,1,0,0,14,-2,6,4,2,0,0,1,-1,0,1,5,1
KR_6761801239,420,3,71,-12,-2,3,4,1,-2,1,3,-5,0,5,1,1,0,1,2,1,0,-6,12,1,3,4,-4,0,1,-1,1,1,1,5,1
KR_6664061674,420,4,35,56,14,3,4,1,1,2,1,4,6,2,2,6,4,4,5,1,3,12,5,-2,3,1,1,0,1,1,1,1,1,5,1
KR_6761371997,420,3,62,0,1,-1,3,4,1,3,2,0,3,3,1,4,3,0,0,0,0,-1,0,2,4,6,-1,0,0,0,-1,1,-1,0,1
KR_6669075967,420,-2,55,-8,1,-6,0,6,2,3,1,5,5,0,1,6,5,-1,0,1,1,0,35,1,5,6,-5,0,1,-1,-1,-1,1,3,1
KR_6723118141,440,4,103,42,9,3,3,0,2,6,4,5,5,0,-1,3,4,0,0,0,0,-2,13,-2,6,4,1,0,3,1,-1,1,-1,3,1
KR_6751285592,420,0,-14,3,8,-1,1,2,1,1,0,6,7,1,3,4,1,-1,0,1,0,6,-5,1,6,7,6,0,-1,0,1,-1,1,0,1
KR_6235240365,420,1,73,-24,-2,3,3,0,-10,1,11,2,3,1,3,5,2,0,1,1,1,-5,-261,-2,4,2,0,0,1,1,1,1,1,1,1
KR_6703310559,420,5,75,15,12,0,2,2,1,3,2,-1,2,3,8,9,1,4,4,0,1,10,-8,-3,5,2,3,0,1,1,1,1,1,6,1
KR_6752484560,420,1,-9,-12,4,-6,1,7,6,7,1,4,5,1,0,0,0,0,0,0,0,5,-5,0,2,2,-1,0,-1,-1,0,-1,1,1,1
KR_6760451259,420,6,33,31,8,4,4,0,2,5,3,1,3,2,1,4,3,0,0,0,1,-3,3,6,4,10,2,0,2,1,-1,1,1,4,1
KR_6760756644,420,-2,-5,16,-1,-3,1,4,1,3,2,2,5,3,-1,4,5,0,0,0,-2,-8,15,3,5,8,-1,0,0,1,1,1,-1,2,1
KR_6734019484,420,1,-17,4,-2,-1,2,3,-1,1,2,0,4,4,-1,4,5,1,1,0,0,-10,368,-4,5,1,3,0,-1,-1,1,1,1,1,1
KR_6760964492,420,1,36,28,1,0,2,2,0,2,2,-1,2,3,1,2,1,1,1,0,0,2,-19,-2,8,6,2,0,0,1,-1,0,1,5,1
KR_6591845750,420,0,29,-2,-3,-2,0,2,-1,1,2,-3,1,4,3,3,0,0,1,1,0,0,-6,-2,5,3,0,0,0,1,0,0,-1,2,1
KR_6699544311,420,1,17,-30,1,3,4,1,-6,0,6,4,5,1,0,3,3,0,0,0,0,0,1,5,4,9,2,0,0,0,1,0,-1,0,1
KR_6740415381,420,3,-5,22,13,0,2,2,7,8,1,4,5,1,2,3,1,0,1,1,0,12,2,2,2,4,-2,0,0,1,0,0,1,5,1
KR_6731114082,420,0,-90,44,-7,2,2,0,-7,0,7,-4,0,4,3,5,2,-1,0,1,0,-9,-17,0,5,5,-6,0,0,-1,1,1,-1,3,1
KR_6740126705,420,1,11,-43,6,1,2,1,-4,4,8,1,1,0,8,8,0,0,1,1,0,5,0,3,3,6,-2,0,0,-1,1,-1,1,3,1
KR_6679360985,440,4,20,33,12,2,2,0,1,2,1,-1,1,2,8,8,0,2,3,1,0,11,9,3,2,5,-1,0,1,1,1,1,1,1,1
KR_6729292142,420,4,30,8,8,5,6,1,4,7,3,2,4,2,-1,1,2,-2,0,2,0,6,2,5,3,8,-3,0,1,1,-1,1,1,2,1
KR_6592776336,420,3,27,12,6,1,3,2,4,5,1,2,2,0,0,1,1,-1,0,1,0,7,-218,4,2,6,5,0,0,1,-1,0,1,4,1
KR_6753337443,420,1,74,-24,14,0,2,2,4,5,1,1,1,0,6,8,2,3,3,0,0,10,2,-1,4,3,0,0,2,1,1,1,1,5,1
KR_6741269627,420,1,14,-18,1,1,2,1,3,6,3,0,2,2,-3,4,7,0,1,1,0,2,1,0,4,4,1,0,0,0,1,-1,1,0,1
KR_6695115838,420,4,37,23,13,4,7,3,6,6,0,-1,2,3,4,6,2,0,2,2,0,8,277,3,1,4,0,0,1,1,1,1,1,4,1
KR_6703011180,420,4,-15,13,6,1,3,2,0,4,4,5,8,3,-2,2,4,2,2,0,-2,10,-5,-4,8,4,-1,0,0,1,-1,0,-1,1,1
KR_6587838273,420,3,23,-7,4,2,2,0,0,3,3,-1,2,3,3,8,5,0,0,0,0,6,-28,-1,6,5,15,0,0,-1,-1,0,1,1,1
KR_6752270441,420,-1,-60,-12,-2,-5,2,7,6,6,0,-6,1,7,4,7,3,-1,0,1,0,2,-167,0,3,3,22,0,-1,1,1,-1,1,5,1
KR_6756617966,420,3,8,16,7,1,3,2,0,1,1,2,3,1,4,4,0,0,1,1,0,0,0,-1,6,5,1,0,-1,1,-1,-1,1,2,1
KR_6425201898,420,3,92,0,5,-2,1,3,-1,3,4,0,2,2,7,8,1,1,3,2,1,7,-208,0,6,6,0,0,1,1,-1,1,1,2,1
KR_6645707033,440,2,111,13,6,0,0,0,0,0,0,1,1,0,3,10,7,2,3,1,0,11,12,-7,8,1,-1,0,2,1,0,1,-1,5,1
KR_6710218294,420,2,-11,0,1,2,3,1,5,8,3,-5,0,5,-1,4,5,0,0,0,0,8,4,0,5,5,0,0,1,1,1,1,1,1,1
KR_6762045741,420,2,52,29,2,-5,0,5,3,4,1,3,3,0,-4,0,4,5,5,0,0,-4,0,2,2,4,6,0,1,1,-1,-1,1,4,1
KR_6730054064,420,1,-20,15,6,0,1,1,3,3,0,1,3,2,3,6,3,-1,0,1,0,9,-34,3,4,7,3,0,-1,1,1,-1,-1,4,1
KR_6760570456,440,0,10,0,-4,4,4,0,1,2,1,-4,0,4,-5,0,5,0,1,1,0,-6,-11,-2,7,5,-4,0,1,-1,1,1,1,5,1
KR_6740402998,420,0,21,24,3,0,1,1,1,2,1,-2,0,2,3,6,3,1,1,0,0,4,-19,2,2,4,-2,0,1,1,0,1,1,2,1
KR_6724387651,420,7,56,44,9,4,5,1,2,4,2,2,5,3,0,2,2,1,2,1,0,5,-1,4,1,5,-1,0,1,1,1,1,1,3,1
KR_6471763252,420,4,29,37,12,2,2,0,4,4,0,1,2,1,3,5,2,2,3,1,1,17,5,0,6,6,3,0,3,1,1,1,1,6,1
KR_6663972838,420,0,41,-42,-2,0,1,1,0,4,4,2,5,3,-2,5,7,-2,0,2,0,7,5,2,3,5,-1,0,0,-1,-1,-1,1,5,1
KR_6751539320,420,4,67,4,11,4,6,2,0,2,2,4,5,1,2,3,1,1,1,0,0,7,0,2,3,5,-1,0,0,1,-1,1,-1,3,1
KR_6741478889,440,3,10,0,11,0,1,1,3,3,0,8,8,0,0,1,1,0,0,0,0,16,-7,-2,7,5,3,0,0,1,-1,0,1,5,1
KR_6759179889,420,0,29,9,0,-1,2,3,0,2,2,3,3,0,-2,5,7,0,0,0,-1,0,-5,-4,5,1,3,0,-1,-1,-1,-1,-1,4,1
KR_6751198700,420,1,15,4,2,0,2,2,1,3,2,2,4,2,-1,4,5,0,2,2,0,-3,-27,1,4,5,2,0,0,1,-1,0,-1,5,1
KR_6579825579,420,11,78,46,16,-3,1,4,2,3,1,0,3,3,14,14,0,3,3,0,2,22,-4,-1,9,8,6,0,3,-1,-1,1,1,2,1
KR_6728452802,420,4,72,-16,-1,3,3,0,2,4,2,-2,2,4,1,3,2,-5,0,5,0,-1,32,-1,6,5,-30,0,-1,1,-1,1,-1,6,1
KR_6633245126,420,1,115,-4,3,1,2,1,-1,2,3,0,2,2,1,7,6,2,3,1,2,11,27,3,5,8,-28,0,2,1,1,1,1,3,1
KR_6738263182,420,4,15,16,4,0,0,0,1,5,4,4,4,0,-1,2,3,0,0,0,0,6,4,4,1,5,0,0,0,-1,1,0,-1,1,1
KR_6752647024,420,1,-7,15,10,2,4,2,0,0,0,6,7,1,2,3,1,0,1,1,1,8,-4,-3,8,5,7,0,0,1,1,0,1,5,1
KR_6725800135,420,6,30,4,13,1,3,2,5,5,0,2,3,1,5,5,0,0,0,0,0,16,-53,-1,4,3,20,0,2,1,-1,1,1,1,1
KR_6302118526,420,0,-21,33,-3,0,1,1,-2,1,3,-2,3,5,0,3,3,1,1,0,0,-7,-8,-5,9,4,2,0,0,1,-1,-1,1,5,1
KR_6153626368,420,-2,3,39,0,-3,3,6,1,5,4,-1,1,2,2,5,3,1,1,0,0,6,-7,-1,8,7,4,0,0,1,-1,-1,1,1,1
KR_6531413150,420,1,-43,20,3,-4,1,5,3,3,0,2,3,1,2,4,2,0,0,0,0,6,-5,0,4,4,-5,0,0,1,-1,0,-1,6,1
KR_6738336874,420,3,12,-12,11,0,1,1,1,5,4,4,5,1,4,7,3,2,2,0,0,9,-22,0,4,4,1,0,1,1,-1,1,1,6,1
KR_6722355979,420,2,-32,10,6,1,2,1,5,7,2,1,3,2,2,7,5,-3,0,3,0,4,8,3,3,6,-7,0,1,1,1,1,-1,3,1
KR_6741812698,420,-1,34,-16,-2,-2,0,2,-1,3,4,3,5,2,0,3,3,-2,0,2,0,-7,0,4,4,8,-3,0,0,1,1,1,1,6,1
KR_6722189974,420,0,-8,-11,-8,-3,2,5,5,8,3,-1,3,4,-7,3,10,-2,0,2,0,-3,-2,2,5,7,2,0,0,0,0,-1,-1,0,1
KR_6743866482,420,2,37,8,2,-2,3,5,-1,5,6,5,10,5,-1,1,2,1,1,0,-1,-2,127,1,5,6,1,0,0,1,0,1,-1,5,1
KR_6699890034,420,5,44,24,13,-1,3,4,3,3,0,10,10,0,0,2,2,1,1,0,0,5,10,4,1,5,-3,0,1,1,1,1,1,5,1
KR_6764709445,420,6,94,27,16,3,4,1,6,7,1,-2,1,3,6,7,1,3,4,1,3,11,10,5,2,7,-1,0,3,-1,1,1,1,3,1
KR_6748356122,420,3,83,22,4,1,1,0,0,2,2,1,4,3,2,4,2,0,0,0,0,0,-20,-1,8,7,10,0,2,1,1,1,-1,4,1
KR_6747425753,420,3,12,28,8,4,5,1,-2,4,6,2,3,1,4,6,2,0,2,2,0,2,-8,1,4,5,0,0,1,-1,1,1,1,1,1
KR_6763531901,420,1,29,24,10,0,0,0,-2,2,4,5,5,0,3,5,2,4,4,0,0,12,130,-3,7,4,0,0,0,1,1,0,1,6,1
KR_6763713874,420,0,11,16,-4,-4,0,4,2,7,5,1,4,3,-3,1,4,0,2,2,0,-13,0,2,4,6,-4,0,2,-1,1,1,-1,5,1
KR_6494196419,420,0,-54,12,4,0,1,1,1,4,3,-3,2,5,6,6,0,0,1,1,0,11,9,6,2,8,-6,0,1,1,1,1,1,2,1
KR_6723641032,440,2,27,8,8,6,7,1,-4,2,6,-1,0,1,7,7,0,0,0,0,-1,13,33,1,4,5,6,0,2,-1,1,1,-1,3,1
KR_6654700670,420,-1,35,4,2,2,4,2,5,6,1,2,2,0,-5,0,5,-2,2,4,0,1,-2,2,4,6,1,0,-1,1,-1,-1,1,3,1
KR_6292813191,420,0,9,6,0,2,2,0,2,6,4,-1,2,3,-2,5,7,-1,0,1,1,2,-133,-3,4,1,0,0,-1,1,0,-1,1,2,1
KR_6734640225,420,3,122,12,4,1,2,1,0,2,2,2,5,3,2,5,3,-1,1,2,1,6,-22,-5,7,2,4,0,2,-1,1,1,1,2,1
KR_6760565064,420,6,39,65,4,-1,2,3,3,4,1,4,4,0,-3,0,3,1,3,2,0,-3,2,3,2,5,0,0,1,1,-1,1,-1,4,1
KR_6674031576,420,1,72,-2,7,5,5,0,0,2,2,6,8,2,-3,2,5,-1,0,1,0,5,-10,0,4,4,4,0,1,-1,1,1,-1,4,1
KR_6753790708,420,1,40,9,9,-5,0,5,4,4,0,8,8,0,7,7,0,-5,0,5,0,5,4,2,1,3,0,0,3,0,1,1,1,0,1
KR_6418297517,420,2,57,-32,1,-2,1,3,-1,2,3,1,2,1,3,3,0,0,2,2,-1,0,7,-6,11,5,-20,0,0,1,-1,0,-1,6,1
KR_6724676153,420,1,1,12,8,4,4,0,-2,2,4,2,3,1,1,4,3,3,3,0,1,9,3,0,7,7,-1,0,0,1,1,0,1,3,1
KR_6453796095,420,-4,37,-52,-8,0,0,0,-4,0,4,4,4,0,-8,0,8,0,0,0,0,-11,-20,0,2,2,-2,0,1,-1,1,1,-1,6,1
KR_6700867106,420,0,4,0,0,-3,0,3,3,5,2,4,4,0,-4,3,7,0,0,0,0,1,4,4,2,6,-3,0,-1,1,-1,-1,1,4,1
KR_6753974360,420,-1,-33,-10,-10,1,1,0,1,3,2,-3,3,6,-7,2,9,-2,0,2,0,-6,13,0,4,4,-3,0,0,1,0,0,-1,4,1
KR_6689682086,420,1,0,28,5,-2,0,2,1,3,2,0,2,2,3,5,2,3,3,0,0,9,-3,0,5,5,5,0,0,1,1,1,1,4,1
KR_6672752477,420,1,17,-24,9,3,4,1,4,5,1,-1,3,4,3,3,0,0,1,1,0,12,11,7,0,7,-1,0,1,1,-1,1,-1,5,1
KR_6742928716,420,-2,-44,-31,-2,-3,1,4,0,5,5,0,1,1,0,1,1,1,1,0,0,8,-17,5,4,9,1,0,0,1,-1,-1,-1,5,1
KR_6763267029,420,1,114,-29,6,1,7,6,3,4,1,1,3,2,-1,0,1,2,3,1,0,11,-11,-3,5,2,-1,0,2,-1,1,1,1,3,1
KR_6751373340,440,2,10,-4,8,0,2,2,5,5,0,1,2,1,1,3,2,1,1,0,1,14,7,4,5,9,-3,0,0,1,-1,0,1,2,1
KR_6678122600,440,8,103,23,13,1,3,2,1,3,2,-2,2,4,12,14,2,1,1,0,0,6,-18,-3,5,2,4,0,1,1,0,1,1,3,1
KR_6719476482,420,1,23,36,0,0,1,1,0,1,1,-2,0,2,2,3,1,0,0,0,0,1,19,-1,5,4,1,0,0,-1,-1,-1,-1,1,1
KR_6700765282,420,4,31,16,7,3,3,0,1,4,3,3,4,1,0,1,1,0,2,2,0,0,5,-2,5,3,-3,0,0,1,1,0,1,6,1
KR_6572973827,420,4,109,9,10,4,5,1,5,7,2,2,3,1,-1,2,3,0,2,2,0,7,-1,1,6,7,-2,0,2,1,1,1,1,5,1
KR_6737764393,420,1,45,8,-2,9,10,1,-4,1,5,-2,3,5,-2,0,2,-3,0,3,-1,-10,-13,-3,5,2,-2,0,-2,-1,1,1,1,6,1
KR_6750706601,420,-3,28,-48,3,1,3,2,1,1,0,-2,1,3,-1,3,4,4,5,1,0,4,-34,0,4,4,2,0,0,1,1,1,1,1,1
KR_6713467641,420,0,-27,43,-2,1,2,1,-2,7,9,-1,1,2,-3,2,5,3,3,0,0,-3,-3,-1,6,5,0,0,0,-1,1,0,-1,5,1
KR_6691293829,420,6,97,27,19,3,4,1,8,8,0,4,4,0,4,7,3,0,2,2,0,14,-181,4,2,6,0,0,4,1,1,1,-1,2,1
KR_6675217725,420,2,-17,-13,7,2,2,0,-1,1,2,-3,3,6,7,8,1,2,2,0,0,9,2,-3,6,3,3,0,1,1,-1,-1,1,6,1
KR_6651494109,420,1,44,2,7,-2,0,2,1,2,1,3,4,1,3,5,2,2,2,0,1,8,26,-1,6,5,4,0,1,1,-1,1,1,2,1
KR_6761739638,420,2,59,16,5,1,1,0,0,1,1,3,4,1,1,3,2,0,0,0,0,2,-6,-6,10,4,1,0,2,1,1,1,1,1,1
KR_6608411663,420,6,85,-7,11,5,5,0,-1,3,4,2,4,2,2,6,4,3,7,4,0,5,1,3,6,9,0,0,2,1,1,1,-1,3,1
KR_6667784847,420,1,6,-24,5,2,3,1,-1,2,3,-1,1,2,4,4,0,1,1,0,0,10,-2,1,3,4,2,0,0,1,-1,-1,1,2,1
KR_6684534220,420,5,24,32,13,1,2,1,5,5,0,4,6,2,-1,1,2,4,5,1,0,11,8,2,3,5,1,0,0,1,-1,1,1,4,1
KR_6603928260,420,1,-2,11,-1,-1,0,1,-1,5,6,-3,2,5,3,5,2,1,1,0,0,1,34,1,3,4,0,0,0,0,1,0,1,0,1
KR_6666352661,420,4,49,20,11,2,4,2,2,2,0,4,5,1,3,3,0,0,1,1,0,10,8,2,3,5,1,0,2,-1,1,1,1,6,1
KR_6762410493,420,5,-54,5,3,-2,0,2,5,9,4,-1,5,6,2,3,1,-1,0,1,0,12,27,0,5,5,3,0,1,-1,-1,-1,-1,1,1
KR_6570739298,420,5,9,35,11,-1,4,5,1,5,4,2,2,0,10,12,2,-1,0,1,0,10,23,-3,6,3,-2,0,-1,-1,-1,-1,-1,6,1
KR_6700786774,420,2,65,-20,-8,1,6,5,-3,2,5,-6,1,7,0,0,0,0,1,1,0,-10,-122,-2,4,2,1,0,1,1,0,1,-1,3,1
KR_6744248581,420,-2,44,-16,-1,2,2,0,-11,0,11,-4,1,5,5,5,0,7,7,0,1,2,-31,-5,10,5,2,0,1,1,0,1,1,2,1
KR_6759942773,440,1,49,-19,1,4,6,2,-4,0,4,2,5,3,1,7,6,-2,1,3,1,-3,38,-4,6,2,3,0,2,-1,1,1,1,3,1
KR_6759459050,420,-1,-14,-16,-5,-1,0,1,-1,2,3,-2,2,4,2,5,3,-3,2,5,-2,-7,-1,-1,6,5,-4,0,0,-1,-1,0,-1,2,1
KR_6759797028,420,4,-47,-12,15,2,4,2,6,8,2,1,2,1,0,3,3,6,6,0,1,12,-19,-4,7,3,3,0,2,1,1,1,1,3,1
KR_6686623865,420,-4,-29,-8,-8,0,0,0,-2,4,6,-1,1,2,-5,1,6,0,2,2,0,-12,117,-3,5,2,2,0,-1,1,1,-1,-1,4,1
KR_6744904805,420,2,28,-21,9,-1,0,1,0,0,0,2,3,1,5,6,1,3,4,1,0,18,155,-1,4,3,1,0,2,1,1,1,1,5,1
KR_6756841580,420,-1,-62,-8,3,2,2,0,-3,1,4,2,4,2,2,4,2,0,3,3,1,3,-6,0,4,4,2,0,0,-1,1,0,1,3,1
KR_6715892692,420,2,21,7,4,1,4,3,-1,5,6,7,7,0,-7,0,7,4,4,0,0,-2,-118,-3,7,4,1,0,1,1,1,1,1,3,1
KR_6763312652,440,2,-12,-4,4,4,4,0,1,5,4,0,1,1,-1,3,4,0,1,1,0,-1,13,0,4,4,-3,0,-1,-1,-1,-1,-1,1,1
KR_6764288099,420,1,-11,15,0,-1,1,2,-2,2,4,1,1,0,2,2,0,0,2,2,0,-2,-2,-5,11,6,-1,0,1,1,1,1,1,4,1
KR_6630288007,420,2,51,-55,11,2,4,2,4,8,4,6,6,0,0,2,2,-1,4,5,1,11,18,5,7,12,6,0,2,-1,-1,1,1,2,1
KR_6753080942,420,1,5,52,4,1,2,1,-1,4,5,3,6,3,0,3,3,1,2,1,0,3,2,1,4,5,-1,0,1,1,1,1,1,3,1
KR_6711864972,420,-1,9,-4,0,3,3,0,-5,1,6,2,3,1,-1,1,2,1,4,3,-1,-5,7,-1,4,3,2,0,0,1,1,1,-1,3,1
KR_6743117468,420,5,99,-20,14,2,2,0,0,3,3,9,10,1,5,8,3,-2,1,3,0,10,10,0,6,6,-2,0,0,0,0,1,-1,0,1
KR_6764373935,420,-2,63,4,1,0,1,1,-2,3,5,1,4,3,3,5,2,-1,0,1,0,5,-181,2,1,3,0,0,1,-1,-1,1,1,2,1
KR_6604864754,420,-2,-54,-20,0,1,1,0,-6,0,6,5,6,1,-1,2,3,1,1,0,0,2,0,2,4,6,2,0,0,0,1,-1,1,0,1
KR_6725718806,420,-1,32,25,1,-4,1,5,5,6,1,0,0,0,0,2,2,0,2,2,0,2,108,-1,4,3,2,0,0,1,-1,-1,-1,6,1
KR_6730369339,440,5,87,20,14,4,5,1,0,2,2,5,8,3,3,4,1,2,2,0,0,8,115,2,2,4,1,0,0,1,0,1,1,6,1
KR_6734212426,420,2,18,-19,4,5,5,0,-3,1,4,-3,0,3,4,4,0,1,1,0,0,10,1,3,6,9,5,0,1,1,1,1,1,2,1
KR_6741182682,440,6,62,24,13,-4,1,5,2,4,2,4,6,2,10,10,0,1,1,0,0,17,0,-4,5,1,3,0,1,1,1,1,-1,5,1
KR_6749026053,420,0,-40,-8,4,4,6,2,0,1,1,-1,0,1,2,4,2,-1,1,2,-1,4,1,-1,5,4,-3,0,-1,1,1,1,-1,4,1
KR_6690384916,420,2,27,10,0,1,1,0,5,7,2,-5,1,6,0,1,1,-1,1,2,0,3,-3,1,3,4,0,0,0,0,-1,1,-1,0,1
KR_6730931963,420,5,111,11,12,6,9,3,-1,2,3,4,4,0,2,3,1,1,1,0,-1,1,-103,2,3,5,-3,0,3,1,-1,1,-1,4,1
KR_6755363014,420,5,40,4,20,-3,0,3,3,6,3,12,13,1,7,7,0,1,1,0,0,20,-234,3,1,4,1,0,1,1,1,1,1,2,1
KR_6762522780,420,5,79,20,6,7,9,2,-1,0,1,-3,4,7,0,3,3,3,3,0,0,7,7,0,3,3,1,0,0,1,-1,1,1,3,1
KR_6729043059,420,-1,-43,13,1,0,1,1,1,2,1,1,3,2,-1,3,4,0,2,2,0,2,2,-7,11,4,3,0,0,1,1,1,-1,1,1
KR_6750615124,420,1,22,-36,2,2,3,1,-3,0,3,3,3,0,1,1,0,-1,0,1,0,0,-24,0,5,5,1,0,0,-1,-1,0,1,3,1
KR_6733609269,420,8,117,25,19,4,4,0,4,6,2,4,7,3,0,2,2,7,7,0,-1,13,5,1,4,5,5,0,2,1,1,1,-1,3,1
KR_6619418057,420,-1,-22,17,2,9,9,0,0,3,3,1,3,2,-4,0,4,-4,1,5,1,-6,-18,1,4,5,-2,0,2,-1,1,1,1,4,1
KR_6725779396,420,0,-2,16,3,1,2,1,2,5,3,-1,0,1,-1,1,2,2,6,4,0,7,-488,0,4,4,1,0,-2,-1,1,-1,1,6,1
KR_6761193456,420,1,-10,24,-7,-3,1,4,-1,2,3,-2,2,4,1,3,2,-2,0,2,0,-5,193,4,3,7,-4,0,1,1,-1,1,-1,2,1
KR_6697942701,420,3,13,-15,3,5,6,1,-1,1,2,1,2,1,0,0,0,-2,0,2,0,-1,-10,0,6,6,-2,0,0,1,1,-1,1,2,1
KR_6569022420,420,3,49,-4,7,4,4,0,2,5,3,0,2,2,1,2,1,0,0,0,1,6,-8,-3,9,6,5,0,1,1,1,1,1,3,1
KR_6759728046,420,1,24,-23,4,1,1,0,-3,1,4,1,3,2,4,5,1,1,4,3,0,2,6,3,4,7,-1,0,2,0,1,1,1,0,1
KR_6686512740,420,0,82,0,-2,2,3,1,-1,1,2,1,5,4,-3,1,4,-1,0,1,0,-4,-21,-8,11,3,-5,0,0,1,-1,-1,1,2,1
KR_6725360272,420,5,54,-1,7,2,2,0,5,8,3,2,3,1,-2,2,4,0,2,2,0,7,-6,-1,6,5,7,0,0,-1,-1,1,-1,5,1
KR_6763539592,440,1,37,-33,6,0,2,2,0,0,0,3,3,0,3,3,0,0,0,0,0,5,5,2,6,8,0,0,1,1,0,1,1,4,1
KR_6592709485,420,1,46,4,3,-2,1,3,-1,4,5,2,2,0,2,3,1,2,2,0,0,9,11,4,3,7,-2,0,0,1,-1,0,1,1,1
KR_6715724136,420,1,-23,-10,1,6,7,1,0,1,1,-6,0,6,1,4,3,0,1,1,0,-1,4,-1,5,4,-1,0,0,-1,1,-1,-1,6,1
KR_6669495555,420,-5,10,-13,-6,2,4,2,-4,1,5,2,2,0,-4,2,6,-2,0,2,-2,-12,16,-1,5,4,-8,0,-1,-1,1,-1,-1,4,1
KR_6657989020,420,3,40,-8,4,0,2,2,-1,3,4,6,8,2,0,1,1,-1,0,1,0,2,14,-1,5,4,0,0,2,1,1,1,1,4,1
KR_6756286694,420,3,15,-13,5,-4,2,6,0,2,2,1,2,1,8,8,0,0,1,1,0,11,-6,6,1,7,4,0,0,1,0,0,1,1,1
KR_6757365718,420,1,37,-8,2,1,3,2,2,3,1,1,2,1,0,2,2,-2,0,2,0,-4,-2,0,4,4,-3,0,1,-1,1,1,-1,1,1
KR_6683515627,420,4,64,42,11,0,3,3,-1,4,5,3,3,0,6,6,0,3,3,0,0,9,43,5,4,9,-8,0,3,-1,1,1,-1,2,1
KR_6601265483,420,0,12,-16,-5,2,3,1,1,4,3,-3,2,5,-3,0,3,-2,0,2,0,-8,-8,-1,8,7,6,0,1,-1,1,1,-1,1,1
KR_6754098835,420,1,-8,15,2,-2,2,4,2,2,0,-5,2,7,5,7,2,2,3,1,0,6,-3,4,6,10,0,0,0,1,0,1,1,2,1
KR_6454884255,420,2,-19,20,2,-1,0,1,4,5,1,-1,1,2,-1,0,1,1,1,0,0,1,-8,0,5,5,0,0,0,1,-1,0,-1,3,1
KR_6724761039,420,2,63,14,6,2,3,1,2,3,1,-1,2,3,3,3,0,0,1,1,0,3,24,4,3,7,3,0,2,1,1,1,-1,2,1
KR_6665267162,420,2,28,-10,3,4,4,0,-2,2,4,-1,1,2,1,3,2,1,2,1,1,-2,118,7,1,8,-1,0,1,1,1,1,1,4,1
KR_6673684199,420,-1,10,-16,1,-2,1,3,-1,4,5,-2,0,2,4,4,0,2,2,0,0,6,-28,0,4,4,0,0,0,1,-1,0,1,1,1
KR_6762606238,420,2,32,-8,9,-1,2,3,4,4,0,0,1,1,6,8,2,0,0,0,0,16,-37,0,2,2,16,0,1,-1,-1,1,1,6,1
KR_6625993569,420,4,113,-37,4,-1,4,5,2,3,1,3,7,4,2,3,1,-2,3,5,0,-2,2,4,2,6,1,0,3,1,1,1,1,5,1
KR_6747678246,420,4,76,0,10,2,6,4,7,8,1,1,1,0,0,3,3,0,0,0,0,5,10,5,3,8,0,0,1,1,1,1,1,6,1
KR_6733529053,420,-4,27,-19,-15,0,0,0,-9,0,9,-4,2,6,-1,0,1,-1,1,2,0,-27,-9,2,3,5,-22,0,0,-1,1,0,-1,5,1
KR_6644268106,420,5,31,45,3,1,3,2,-1,4,5,4,4,0,-3,3,6,2,2,0,0,-1,20,-1,4,3,5,0,1,-1,-1,1,1,2,1
KR_6728430471,440,2,22,-33,5,-1,3,4,-1,1,2,2,2,0,3,4,1,2,2,0,0,2,9,3,4,7,2,0,0,1,-1,-1,-1,2,1
KR_6728181886,420,1,-33,-16,8,-3,1,4,8,9,1,4,6,2,0,2,2,-1,1,2,0,14,-3,4,2,6,2,0,1,1,1,1,-1,1,1
KR_6637936400,420,1,-3,-33,1,1,4,3,-2,1,3,3,4,1,-2,0,2,1,1,0,-1,0,-9,-1,6,5,-5,0,0,1,0,0,-1,6,1
KR_6622810025,420,3,-40,53,3,0,2,2,1,4,3,6,7,1,-3,3,6,-1,1,2,-1,-3,-201,0,3,3,2,0,1,1,1,1,-1,1,1
KR_6712268820,420,0,3,8,0,2,3,1,1,4,3,-5,1,6,1,1,0,1,1,0,0,7,22,-3,5,2,1,0,-1,-1,0,-1,-1,3,1
KR_6749833217,420,2,44,0,6,0,1,1,-3,2,5,2,6,4,6,7,1,1,1,0,1,2,-32,1,3,4,1,0,0,1,-1,1,1,3,1
KR_6720463232,420,3,32,11,4,1,2,1,-1,1,2,1,1,0,4,4,0,-1,0,1,1,8,-7,-6,6,0,4,0,-1,1,-1,-1,1,4,1
KR_6756987696,420,3,54,9,1,3,4,1,1,2,1,1,3,2,-4,2,6,0,1,1,-1,-2,51,-2,5,3,-20,0,2,1,1,1,-1,1,1
KR_6704692522,420,2,-20,28,2,0,0,0,0,2,2,2,4,2,1,2,1,-1,1,2,0,6,2,1,4,5,-5,0,1,1,1,1,1,4,1
KR_6757015120,420,4,43,16,3,1,2,1,3,5,2,0,1,1,-2,6,8,1,1,0,0,4,2,1,2,3,0,0,0,1,-1,1,1,1,1
KR_6754337735,420,2,78,31,-2,1,3,2,-1,3,4,1,4,3,-2,0,2,-1,0,1,-1,-8,-4,-5,11,6,3,0,1,-1,1,1,-1,5,1
KR_6729822838,420,1,10,8,3,-2,1,3,4,4,0,-3,0,3,3,3,0,1,1,0,0,7,32,9,2,11,-2,0,1,1,-1,-1,-1,1,1
KR_6722634342,420,5,84,32,-1,2,3,1,-3,2,5,5,5,0,-2,3,5,-3,0,3,-1,-10,-56,-2,6,4,2,0,0,1,-1,-1,-1,2,1
KR_6614861783,420,1,19,-8,-5,-2,1,3,-1,4,5,3,6,3,-3,0,3,-2,0,2,0,-8,6,5,3,8,0,0,1,-1,-1,-1,-1,3,1
KR_6512322866,420,-3,-20,-12,-7,0,0,0,-1,1,2,-1,2,3,-6,0,6,1,1,0,0,-8,-9,-2,6,4,-1,0,-1,-1,-1,-1,-1,3,1
KR_6628836719,420,0,25,28,-7,3,3,0,-1,0,1,1,3,2,-6,0,6,-4,2,6,0,-16,-6,-4,5,1,-1,0,2,-1,1,1,1,6,1
KR_6731439015,420,4,5,28,8,-1,1,2,5,6,1,-1,0,1,3,4,1,2,2,0,0,13,32,0,5,5,-4,0,1,-1,1,1,1,5,1
KR_6708839824,420,3,52,3,7,1,1,0,5,11,6,-4,1,5,7,8,1,-2,0,2,0,0,5,1,4,5,2,0,2,-1,-1,1,1,5,1
KR_6759687172,420,4,-2,27,8,1,2,1,0,2,2,3,3,0,3,4,1,1,1,0,1,7,-47,2,3,5,39,0,-1,0,-1,-1,1,0,1
KR_6730307698,420,3,29,2,10,3,3,0,4,4,0,4,6,2,-2,2,4,1,2,1,0,15,0,2,3,5,4,0,1,-1,1,1,1,4,1
KR_6753260404,440,0,-18,-4,1,-1,4,5,1,2,1,0,1,1,1,1,0,0,3,3,0,-1,-20,-2,9,7,-3,0,0,1,-1,-1,1,3,1
KR_6724280310,420,2,62,-15,8,3,3,0,1,2,1,5,5,0,-1,1,2,0,2,2,0,11,-8,-3,9,6,3,0,1,1,0,1,-1,5,1
KR_6731856373,420,3,83,-24,13,1,2,1,0,4,4,3,4,1,9,9,0,0,2,2,0,8,2,-2,5,3,1,0,1,0,-1,1,1,0,1
KR_6661932186,420,1,-20,-31,5,3,4,1,-3,2,5,0,1,1,2,4,2,3,3,0,0,13,-7,-4,5,1,1,0,0,1,-1,-1,1,4,1
KR_6761660951,420,0,-42,-3,6,1,1,0,2,6,4,0,2,2,-2,3,5,5,5,0,0,9,-62,-2,4,2,37,0,0,1,-1,0,1,5,1
KR_6654915711,420,1,31,-17,6,1,2,1,3,4,1,-3,1,4,4,4,0,1,1,0,0,2,-2,2,6,8,6,0,0,1,-1,0,1,2,1
KR_6685930251,420,4,66,-16,8,-5,0,5,4,5,1,6,6,0,2,2,0,1,1,0,0,8,0,-3,4,1,0,0,0,-1,-1,1,-1,1,1
KR_6705599898,420,4,14,56,5,5,5,0,1,3,2,1,1,0,-1,1,2,-1,3,4,0,2,-5,-2,5,3,2,0,0,1,-1,0,1,4,1
KR_6761991057,420,0,22,13,0,0,0,0,2,4,2,-1,1,2,-1,1,2,0,1,1,0,0,0,-1,7,6,5,0,0,0,1,0,1,0,1
KR_6696596085,420,2,112,20,6,5,7,2,-1,4,5,4,5,1,-2,1,3,0,0,0,0,-4,11,3,1,4,2,0,1,1,1,1,-1,3,1
KR_6764014690,420,4,61,20,12,5,7,2,6,8,2,2,2,0,-1,1,2,0,1,1,0,8,4,4,4,8,2,0,1,1,1,1,1,6,1
KR_6761630498,420,1,24,19,1,-1,1,2,-3,1,4,4,5,1,0,3,3,1,1,0,0,3,6,1,4,5,4,0,0,0,0,0,-1,0,1
KR_6675452047,420,2,-48,48,2,-2,0,2,-2,2,4,0,1,1,5,5,0,1,3,2,0,1,8,4,4,8,-2,0,0,1,1,1,1,5,1
KR_6719732327,420,3,9,-13,5,2,2,0,1,4,3,1,4,3,0,1,1,1,1,0,0,10,-115,1,4,5,1,0,0,0,1,1,-1,0,1
KR_6751046547,420,1,4,-32,2,-2,4,6,-2,5,7,1,4,3,4,4,0,1,5,4,0,0,29,4,1,5,-5,0,0,1,-1,-1,1,4,1
KR_6697357564,440,-1,91,-28,0,3,3,0,0,3,3,-2,0,2,2,2,0,-3,1,4,0,7,-1,4,4,8,2,0,-1,0,-1,-1,1,0,1
KR_6724466853,420,-3,37,-39,0,2,2,0,0,3,3,-3,1,4,0,7,7,1,2,1,1,-4,174,-5,6,1,3,0,0,1,-1,0,1,2,1
KR_6606183022,420,5,18,20,8,3,5,2,-1,3,4,6,8,2,-1,2,3,1,1,0,0,8,-5,1,6,7,4,0,1,-1,1,1,1,1,1
KR_6731478374,440,-2,-37,24,1,-1,1,2,1,2,1,1,3,2,1,1,0,-1,1,2,0,-1,-2,2,1,3,-1,0,0,1,1,0,1,1,1
KR_6720192260,420,6,90,-13,17,4,5,1,0,3,3,6,6,0,7,8,1,0,0,0,0,13,-2,0,3,3,0,0,1,-1,1,1,1,1,1
KR_6522050234,420,0,44,8,3,1,1,0,-2,4,6,8,8,0,-3,0,3,-1,3,4,0,0,-4,4,5,9,0,0,-1,-1,1,-1,1,6,1
KR_6764684969,420,3,43,-16,2,3,4,1,1,2,1,-2,0,2,0,6,6,0,0,0,0,0,-7,1,3,4,-5,0,0,1,0,0,1,6,1
KR_6722446767,420,4,53,-8,12,1,3,2,2,3,1,7,7,0,3,3,0,-1,1,2,0,8,2,2,3,5,5,0,1,1,-1,1,-1,4,1
KR_6639288189,420,1,110,-5,8,5,5,0,3,4,1,0,2,2,0,1,1,0,1,1,0,0,116,5,2,7,-1,0,2,1,1,1,1,1,1
KR_6710141561,420,3,12,12,8,0,1,1,4,5,1,1,3,2,2,6,4,1,2,1,0,3,-9,-1,5,4,1,0,1,1,1,1,-1,2,1
KR_6649417313,420,0,-7,-3,-2,0,1,1,-5,1,6,3,4,1,0,1,1,0,0,0,0,-5,-8,-4,5,1,0,0,0,-1,0,0,-1,2,1
KR_6680069538,420,6,97,15,17,4,6,2,6,7,1,0,2,2,6,6,0,1,1,0,0,15,94,3,2,5,13,0,1,1,-1,1,1,5,1
KR_6764430182,420,1,-10,24,7,-3,1,4,1,5,4,5,6,1,3,3,0,1,1,0,0,11,-17,-5,7,2,0,0,0,1,-1,0,1,5,1
KR_6753059072,420,2,69,-4,0,-1,0,1,-1,1,2,4,4,0,0,2,2,-2,0,2,0,0,-290,0,7,7,2,0,0,1,1,-1,-1,4,1
KR_6715339695,420,0,27,13,-3,-3,1,4,-1,0,1,8,9,1,-6,0,6,-1,1,2,0,0,4,-2,6,4,0,0,0,-1,-1,0,-1,3,1
KR_6672418492,420,4,41,0,9,1,1,0,2,2,0,1,2,1,3,3,0,2,2,0,0,10,8,1,4,5,-3,0,1,1,-1,1,1,5,1
KR_6737240241,420,0,-51,-35,4,4,5,1,0,1,1,2,3,1,2,3,1,-4,1,5,0,3,12,11,0,11,-2,0,1,1,0,1,1,1,1
KR_6754112493,420,1,-36,22,-1,-2,2,4,4,5,1,-2,0,2,1,3,2,-2,0,2,0,-2,54,0,6,6,-8,0,0,0,-1,1,-1,0,1
KR_6660183765,420,2,29,12,3,-2,2,4,2,3,1,3,3,0,1,4,3,-1,0,1,0,2,-45,0,5,5,23,0,-1,-1,1,-1,-1,1,1
KR_6655937818,440,0,50,-16,-3,0,4,4,1,2,1,-1,0,1,-2,6,8,-1,5,6,-1,-17,-1,1,6,7,4,0,-1,1,-1,-1,-1,2,1
KR_6741522621,440,4,-2,2,8,-1,0,1,3,5,2,6,6,0,0,3,3,0,2,2,1,12,2,0,3,3,3,0,0,-1,1,1,1,2,1
KR_6761328862,420,-2,-24,8,-6,-3,0,3,-3,1,4,0,4,4,-2,0,2,2,2,0,0,-6,2,4,3,7,-2,0,0,-1,-1,1,-1,5,1
KR_6737998919,420,1,-1,4,10,-4,0,4,10,11,1,1,2,1,3,3,0,0,1,1,0,11,7,0,3,3,-1,0,0,-1,1,0,1,2,1
KR_6760192250,420,1,-30,8,8,0,0,0,0,1,1,6,6,0,2,3,1,0,0,0,1,19,72,5,1,6,-3,0,0,-1,0,1,1,6,1
KR_6740473707,420,3,54,12,6,1,3,2,-1,1,2,2,2,0,4,4,0,0,1,1,0,8,-19,4,3,7,3,0,0,1,-1,1,1,1,1
KR_6745627996,420,3,-2,-14,6,2,2,0,-1,1,2,5,5,0,-5,5,10,5,6,1,0,10,-5,-2,8,6,-4,0,0,1,-1,-1,-1,4,1
KR_6759997675,420,-3,-53,-21,-1,-2,1,3,2,2,0,0,2,2,0,1,1,-1,0,1,0,1,9,5,3,8,1,0,0,1,0,0,-1,5,1
KR_6756087123,420,1,65,48,1,-4,0,4,4,6,2,-1,3,4,4,5,1,-2,1,3,1,15,-343,3,5,8,1,0,0,1,1,1,1,3,1
KR_6748775272,440,1,-5,-5,3,0,1,1,-4,0,4,6,7,1,2,4,2,-1,0,1,0,5,13,1,6,7,-6,0,-1,0,-1,-1,1,0,1
KR_6604839153,420,7,145,27,14,0,4,4,4,4,0,7,7,0,4,8,4,-1,1,2,0,7,-7,-3,6,3,5,0,4,1,-1,1,1,5,1
KR_6674717070,420,-1,32,12,4,-1,0,1,0,3,3,1,1,0,2,2,0,2,3,1,0,6,-5,-2,4,2,2,0,0,-1,1,0,1,1,1
KR_6660404515,420,3,25,24,9,3,5,2,3,7,4,3,3,0,0,5,5,0,1,1,1,11,7,0,4,4,2,0,2,1,1,1,1,5,1
KR_6724541623,420,6,-13,60,4,3,3,0,2,2,0,-6,1,7,4,10,6,1,1,0,1,8,-5,-1,2,1,-4,0,2,1,1,1,1,3,1
KR_6679645811,440,8,106,36,11,1,1,0,2,4,2,5,8,3,1,2,1,2,3,1,1,11,9,0,3,3,2,0,2,1,1,1,1,4,1
KR_6634174404,420,0,-2,-2,1,3,3,0,0,3,3,0,1,1,-2,1,3,0,0,0,0,-4,-20,0,4,4,2,0,0,-1,1,0,-1,2,1
KR_6664594813,420,7,107,33,7,3,3,0,5,8,3,3,4,1,-4,2,6,0,1,1,0,8,44,-2,5,3,-19,0,1,1,-1,1,-1,4,1
KR_6751135820,420,1,21,0,4,0,1,1,-1,4,5,0,1,1,4,5,1,1,1,0,0,10,0,2,2,4,-1,0,0,1,1,1,-1,3,1
KR_6737934552,420,1,53,-14,1,-2,2,4,1,2,1,1,2,1,4,4,0,-3,0,3,0,-2,7,2,1,3,-1,0,2,1,-1,1,1,4,1
KR_6760028892,420,9,177,-4,20,2,2,0,3,4,1,8,8,0,7,9,2,0,0,0,1,13,42,2,0,2,-17,0,4,-1,1,1,1,1,1
KR_6738438249,420,-2,-18,26,0,-2,3,5,3,4,1,-3,0,3,3,6,3,-1,0,1,0,0,-64,1,2,3,22,0,1,1,-1,-1,1,4,1
KR_6681302284,420,-1,-29,4,-2,-1,0,1,1,4,3,0,5,5,1,3,2,-3,0,3,0,2,-9,-3,4,1,2,0,0,1,1,0,1,1,1
KR_6733434220,420,4,20,-8,8,4,4,0,0,4,4,1,1,0,3,4,1,0,1,1,0,9,43,7,0,7,-10,0,1,1,1,1,1,5,1
KR_6723008739,440,0,53,20,-5,0,2,2,1,6,5,-5,1,6,-2,1,3,1,2,1,0,-13,45,-4,6,2,0,0,0,0,1,1,-1,0,1
KR_6732189857,420,2,47,-24,2,0,1,1,3,5,2,5,5,0,-5,3,8,-1,0,1,0,-9,6,-6,7,1,-1,0,-1,-1,0,1,1,4,1
KR_6760356655,440,10,59,61,16,1,2,1,3,3,0,5,6,1,3,6,3,4,5,1,0,16,10,-1,3,2,1,0,2,1,1,1,1,2,1
KR_6720331405,420,-1,-22,-24,0,-1,4,5,0,1,1,-1,2,3,1,4,3,1,2,1,0,0,-5,-1,2,1,2,0,1,0,1,-1,1,0,1
KR_6707527296,420,4,-17,38,7,0,0,0,2,4,2,4,4,0,1,5,4,0,0,0,0,5,-9,-3,7,4,0,0,1,1,-1,1,-1,2,1
KR_6688483046,440,4,20,36,6,5,5,0,-1,0,1,2,2,0,0,4,4,0,0,0,0,2,3,-1,4,3,-1,0,1,1,1,1,-1,2,1
KR_6758524858,420,1,-93,28,1,0,1,1,0,2,2,2,2,0,-1,0,1,0,0,0,0,4,44,3,1,4,-28,0,0,1,1,-1,1,2,1
KR_6292940988,420,4,57,-7,16,1,1,0,8,9,1,4,6,2,1,3,2,2,3,1,0,25,9,2,1,3,1,1,4,1,1,1,1,5,1
KR_6673551276,420,3,12,-12,2,-1,2,3,2,3,1,2,3,1,-2,1,3,1,1,0,2,6,-25,0,6,6,3,0,0,-1,-1,0,1,2,1
KR_6657230917,420,-2,68,-2,-3,0,1,1,-4,0,4,2,2,0,0,3,3,-1,1,2,0,-8,3,3,6,9,3,0,-1,1,-1,-1,1,2,1
KR_6495712477,420,2,89,24,3,-1,0,1,6,7,1,4,4,0,-7,3,10,1,3,2,1,-3,-60,1,3,4,1,0,2,1,1,1,1,3,1
KR_6708338729,420,5,94,-9,13,3,4,1,5,5,0,-1,2,3,1,2,1,5,5,0,1,19,0,6,1,7,4,0,2,1,1,1,1,1,1
KR_6728763204,420,0,-51,-32,10,2,2,0,-4,1,5,4,4,0,8,8,0,0,1,1,2,16,-32,-1,5,4,23,0,-1,1,1,1,1,3,1
KR_6711240189,420,-3,-84,-20,-9,-3,1,4,-4,1,5,1,2,1,-1,5,6,-2,1,3,0,-8,10,-4,7,3,-1,0,-1,1,-1,-1,-1,1,1
KR_6715830011,420,1,6,-1,0,2,3,1,-2,4,6,3,4,1,1,4,3,-4,1,5,0,0,-119,2,4,6,-3,0,-1,-1,-1,-1,-1,2,1
KR_6739621343,440,0,-30,12,-1,0,1,1,3,7,4,0,2,2,-5,2,7,1,2,1,-1,-5,356,0,4,4,-1,0,0,0,1,1,-1,0,1
KR_6733752062,420,-1,-36,2,0,0,0,0,-3,1,4,1,6,5,2,3,1,0,1,1,0,2,-6,-5,8,3,4,0,0,-1,-1,0,-1,1,1
KR_6736968489,420,7,56,36,6,1,2,1,0,3,3,1,1,0,2,4,2,2,2,0,0,5,-112,2,1,3,2,0,1,1,-1,1,1,1,1
KR_6729385120,420,3,14,6,3,3,4,1,2,4,2,1,4,3,-3,1,4,0,1,1,0,4,0,0,4,4,8,0,1,1,-1,1,-1,1,1
KR_6672797415,420,2,65,31,8,2,3,1,2,3,1,1,3,2,4,4,0,-1,0,1,0,7,-11,1,2,3,-2,0,1,1,1,1,1,5,1
KR_6596744506,420,2,46,0,4,0,1,1,2,4,2,-3,0,3,3,4,1,2,3,1,0,4,0,-5,9,4,1,0,0,1,-1,0,1,1,1
KR_6663022403,420,1,-39,4,7,9,10,1,0,3,3,1,3,2,-4,0,4,1,1,0,0,5,346,-6,8,2,-3,0,1,-1,1,1,1,4,1
KR_6717266584,420,-2,-24,16,2,1,3,2,1,5,4,-2,2,4,4,6,2,-2,1,3,2,-2,-289,3,4,7,-3,0,0,-1,-1,0,1,3,1
KR_6661514806,420,3,67,27,6,-2,5,7,-2,3,5,2,3,1,7,7,0,1,2,1,-1,23,11,1,5,6,2,0,1,1,1,-1,-1,5,1
KR_6753029475,440,-2,-32,-42,-3,-3,2,5,1,3,2,0,2,2,2,5,3,-3,3,6,-1,0,8,-4,6,2,3,0,-1,-1,1,-1,-1,1,1
KR_6626281428,420,-3,46,-29,-5,1,2,1,-4,3,7,-1,2,3,1,4,3,-2,0,2,0,-8,-79,-5,5,0,2,0,0,-1,-1,1,-1,6,1
KR_6759887532,420,1,80,1,-1,-4,1,5,1,5,4,2,5,3,0,3,3,0,1,1,0,-4,-30,-8,13,5,-2,0,-2,-1,-1,-1,1,1,1
KR_6762523482,420,3,-54,6,11,-1,1,2,5,5,0,-3,1,4,3,7,4,7,8,1,0,8,-10,5,3,8,15,0,2,1,1,1,1,3,1
KR_6734084976,420,3,11,-2,9,-1,0,1,2,2,0,3,3,0,3,3,0,2,2,0,0,12,4,2,4,6,0,0,3,1,1,1,1,5,1
KR_6704455031,440,2,96,28,0,-3,1,4,3,4,1,0,0,0,0,2,2,0,1,1,-2,-3,-9,-2,5,3,4,0,0,1,-1,0,-1,3,1
KR_6549396817,420,-1,54,3,-6,-2,2,4,0,3,3,-2,0,2,-2,0,2,0,0,0,0,-10,-6,-6,8,2,1,0,-1,1,-1,-1,-1,4,1
KR_6714586596,420,-3,-39,-9,-8,3,4,1,-5,0,5,-3,3,6,-2,4,6,-1,0,1,1,-7,3,5,1,6,-4,0,-1,-1,1,-1,1,4,1
KR_6760394519,420,4,63,8,12,3,3,0,-2,1,3,5,6,1,5,5,0,1,3,2,0,9,-13,3,2,5,10,0,0,1,-1,1,1,6,1
KR_6760971045,420,6,41,6,11,-1,3,4,2,3,1,5,5,0,3,5,2,2,2,0,0,15,-7,-2,7,5,0,0,3,1,1,1,1,2,1
KR_6723674245,420,4,62,20,4,3,3,0,-2,4,6,2,3,1,2,3,1,-1,0,1,0,3,-6,0,5,5,6,0,2,1,1,1,-1,2,1
KR_6675647295,420,1,-69,-12,7,0,1,1,1,2,1,5,7,2,1,4,3,0,1,1,0,6,11,6,3,9,1,0,0,1,0,0,1,5,1
KR_6639946094,420,1,33,18,5,8,8,0,0,2,2,2,7,5,-1,2,3,-4,0,4,0,8,17,4,3,7,5,0,1,0,1,1,1,0,1
KR_6716044139,420,4,84,28,3,1,5,4,-2,3,5,3,5,2,1,2,1,0,1,1,1,-7,-21,-2,4,2,5,0,1,1,1,1,1,2,1
KR_6734728683,440,5,34,16,5,2,3,1,2,4,2,-3,0,3,3,3,0,1,1,0,0,4,27,1,6,7,1,0,0,1,-1,1,-1,4,1
KR_6667866804,420,2,18,7,2,0,1,1,0,1,1,1,3,2,-1,0,1,2,2,0,0,2,110,0,5,5,-1,0,0,1,0,1,1,2,1
KR_6671884191,420,5,178,-13,7,3,5,2,-2,3,5,2,2,0,1,3,2,3,4,1,0,6,-13,0,5,5,3,0,2,-1,1,1,1,5,1
KR_6754449181,420,-1,-67,-16,4,-1,1,2,2,2,0,-1,1,2,1,2,1,3,4,1,0,7,85,4,3,7,-2,0,0,0,1,-1,1,0,1
KR_6731168046,420,3,11,24,5,4,5,1,0,2,2,-1,1,2,-1,0,1,3,3,0,0,1,2,1,4,5,2,0,0,-1,1,1,1,6,1
KR_6712238074,420,0,-43,-8,4,6,7,1,-2,1,3,-1,2,3,-3,3,6,4,4,0,0,3,2,4,1,5,-4,0,0,1,-1,1,1,1,1
KR_6668837091,420,3,46,19,-2,1,3,2,-5,0,5,1,3,2,3,6,3,-2,0,2,0,-6,-6,1,6,7,3,0,1,-1,1,1,-1,1,1
KR_6471120424,420,6,99,33,12,-2,0,2,5,6,1,-1,1,2,6,6,0,4,4,0,0,11,13,1,3,4,-1,0,4,1,1,1,1,3,1
KR_6733597726,440,2,12,16,2,-4,2,6,2,2,0,-2,2,4,0,1,1,6,7,1,0,13,8,2,3,5,1,0,1,0,-1,-1,1,0,1
KR_6724709861,420,-5,-61,6,-10,0,4,4,-2,3,5,-3,1,4,-3,3,6,-2,1,3,0,-2,1,3,3,6,-3,0,-1,-1,1,-1,1,5,1
KR_6764147237,420,-2,-29,-12,-2,0,2,2,-3,3,6,-2,1,3,2,3,1,1,1,0,0,4,-8,0,4,4,1,0,-1,1,-1,-1,-1,2,1
KR_6743396188,420,3,23,-25,2,-2,1,3,4,7,3,0,5,5,2,5,3,-2,0,2,1,6,132,0,7,7,3,0,2,1,-1,1,1,6,1
KR_6710186428,420,3,25,11,5,4,4,0,-1,4,5,4,8,4,-1,1,2,-1,1,2,-1,3,-122,-1,4,3,3,0,1,-1,-1,1,-1,4,1
KR_6749203077,420,-3,-6,-20,-3,0,1,1,2,4,2,-2,2,4,-5,2,7,2,2,0,-1,-1,-2,0,4,4,0,0,0,-1,-1,0,-1,5,1
KR_6736025110,420,10,164,20,19,5,7,2,3,7,4,9,10,1,1,4,3,1,2,1,0,12,21,1,5,6,4,0,2,-1,-1,1,1,6,1
KR_6760883776,420,0,21,-1,3,2,3,1,0,2,2,1,4,3,0,3,3,0,1,1,0,-2,-10,-4,4,0,2,0,0,1,-1,1,1,1,1
KR_6741973048,440,3,33,14,7,0,3,3,3,5,2,2,3,1,-2,1,3,4,7,3,0,8,44,1,3,4,-21,0,0,-1,-1,1,1,3,1
KR_6745290328,420,2,24,14,5,0,2,2,2,7,5,2,4,2,2,2,0,-1,2,3,0,4,25,3,3,6,0,0,2,1,1,1,1,3,1
KR_6705869023,420,0,37,-39,-1,1,2,1,0,2,2,0,3,3,1,2,1,-3,1,4,0,-2,15,-5,8,3,1,0,0,-1,-1,0,1,2,1
KR_6737720973,420,2,-12,5,4,-1,0,1,-1,2,3,4,6,2,2,4,2,0,1,1,0,0,75,0,4,4,3,0,1,1,1,1,1,6,1
KR_6670266725,420,6,79,21,8,0,2,2,5,5,0,0,5,5,3,5,2,0,0,0,0,3,-2,-1,4,3,4,0,2,1,1,1,1,6,1
KR_6669259231,440,0,25,-5,6,1,1,0,-1,2,3,1,1,0,3,3,0,2,3,1,0,13,9,3,2,5,-2,0,1,1,0,1,1,4,1
KR_6757591387,420,1,7,-47,5,2,3,1,-1,6,7,6,9,3,3,5,2,-5,0,5,0,8,42,1,3,4,-20,0,0,0,0,1,1,0,1
KR_6730889547,420,7,39,16,11,4,4,0,1,2,1,-1,2,3,7,7,0,0,0,0,0,13,-7,4,1,5,1,0,1,0,1,1,-1,0,1
KR_6715094849,420,-1,-34,-9,-1,-3,1,4,3,4,1,-1,1,2,0,2,2,0,1,1,0,0,-9,4,3,7,4,0,2,-1,1,1,1,1,1
KR_6710396414,420,6,63,28,11,3,3,0,1,2,1,1,3,2,2,3,1,4,4,0,3,8,35,3,5,8,-2,0,2,1,1,1,1,2,1
KR_6748423555,420,-1,-8,-2,1,1,3,2,2,3,1,0,3,3,0,2,2,-2,0,2,1,-10,11,-2,7,5,-6,0,0,0,1,0,1,0,1
KR_6707505392,420,4,66,-12,6,0,2,2,2,4,2,1,3,2,2,3,1,1,1,0,0,5,12,8,2,10,-3,0,1,-1,-1,1,1,4,1
KR_6708197231,420,2,1,-2,7,-1,2,3,4,6,2,3,3,0,1,1,0,0,1,1,0,7,-20,-1,4,3,6,0,-1,1,-1,-1,1,2,1
KR_6730799434,440,1,-37,16,0,2,5,3,0,4,4,-1,2,3,-2,0,2,1,1,0,0,-2,9,1,4,5,-4,0,0,1,1,-1,1,2,1
KR_6701358458,440,3,14,39,10,0,2,2,2,4,2,5,5,0,1,2,1,2,3,1,0,9,10,-1,7,6,0,0,-1,1,-1,-1,-1,5,1
KR_6749240285,420,1,-21,-16,2,-2,1,3,-2,0,2,-2,0,2,7,10,3,1,2,1,0,2,4,2,6,8,2,0,1,1,-1,1,1,1,1
KR_6586523522,420,3,60,18,3,0,1,1,0,2,2,-3,3,6,6,7,1,0,1,1,0,6,53,-4,6,2,-3,0,0,1,-1,0,-1,5,1
KR_6652884604,420,3,113,-17,11,7,8,1,5,6,1,1,3,2,0,2,2,-2,1,3,1,8,1,0,4,4,0,0,1,1,-1,1,1,3,1
KR_6753893915,420,-4,-99,-20,-2,-3,1,4,2,3,1,-2,2,4,1,1,0,0,0,0,0,1,4,5,1,6,-1,0,0,-1,0,-1,1,4,1
KR_6729260568,420,4,27,15,7,-5,0,5,8,8,0,3,5,2,1,1,0,0,0,0,0,6,8,4,2,6,0,0,3,1,-1,1,1,1,1
KR_6700822361,420,0,-20,-16,8,1,1,0,3,5,2,2,3,1,0,1,1,2,2,0,0,12,-47,-1,3,2,26,0,0,1,1,-1,-1,6,1
KR_6685241123,420,0,-22,-33,2,1,2,1,0,3,3,-1,2,3,2,8,6,0,3,3,0,4,12,0,4,4,-5,0,0,-1,1,1,-1,2,1
KR_6759154463,420,-2,-22,-36,-10,-2,4,6,-1,0,1,-5,1,6,-1,3,4,-1,0,1,0,-12,0,-1,6,5,-4,0,0,-1,-1,0,1,1,1
KR_6707413806,420,0,35,-4,-1,2,2,0,-1,0,1,0,2,2,-1,0,1,-1,0,1,0,-6,11,6,1,7,5,0,0,1,1,0,1,5,1
KR_6669099268,420,-3,-12,-4,-2,0,0,0,1,3,2,-3,1,4,1,6,5,-1,1,2,0,-2,-2,-3,6,3,0,0,-1,1,-1,-1,1,5,1
KR_6759706011,420,3,-27,40,5,0,1,1,3,4,1,-4,2,6,2,4,2,4,4,0,0,9,-125,-3,5,2,3,0,-1,1,0,1,1,4,1
KR_6678159087,420,-1,42,-35,-6,3,4,1,-7,0,7,4,6,2,-3,0,3,-3,0,3,-3,-9,3,1,4,5,2,0,2,0,-1,1,-1,0,1
KR_6756250006,420,4,26,28,9,2,2,0,3,5,2,0,1,1,3,4,1,1,1,0,0,6,38,-3,6,3,-2,0,1,1,1,1,-1,5,1
KR_6752539111,420,0,29,-15,-3,-4,0,4,-1,2,3,5,5,0,-3,1,4,0,1,1,0,-6,-1,-3,7,4,-1,0,1,-1,1,1,-1,6,1
KR_6707348695,420,3,66,-18,4,1,3,2,2,4,2,0,2,2,1,3,2,0,0,0,0,4,4,0,5,5,2,0,3,1,-1,1,1,4,1
KR_6648882198,420,2,93,34,4,0,1,1,1,1,0,3,3,0,0,0,0,0,0,0,0,4,4,1,1,2,3,0,2,1,1,1,1,4,1
KR_6693979674,420,1,65,5,6,-2,0,2,4,6,2,2,3,1,2,3,1,0,0,0,0,7,10,-2,6,4,6,0,0,1,0,0,1,1,1
KR_6572920392,420,-3,-92,-18,1,-2,1,3,3,7,4,3,4,1,-1,2,3,-2,1,3,-2,-3,73,3,5,8,1,0,0,1,1,0,-1,1,1
KR_6680040484,420,4,54,28,8,2,3,1,0,3,3,5,6,1,0,4,4,1,1,0,0,0,118,-3,6,3,-2,0,1,0,1,1,1,0,1
KR_6710396343,420,3,5,4,4,-1,0,1,4,5,1,-1,2,3,1,5,4,1,2,1,0,7,-15,-1,4,3,2,0,0,-1,-1,1,-1,4,1
KR_6666805644,420,1,-43,19,5,0,3,3,4,4,0,-2,2,4,3,4,1,0,2,2,0,10,0,-2,5,3,-4,0,-1,1,-1,-1,-1,3,1
KR_6761667036,420,-1,-48,28,0,-2,2,4,-2,3,5,1,2,1,3,3,0,0,1,1,0,5,5,1,1,2,-1,0,-1,-1,-1,-1,-1,2,1
KR_6707535760,420,0,-49,12,3,0,3,3,1,1,0,-2,1,3,4,5,1,0,0,0,0,11,119,2,5,7,4,0,0,1,0,0,-1,5,1
KR_6753473359,420,5,95,5,15,8,8,0,-2,2,4,9,10,1,0,1,1,0,0,0,0,6,37,1,2,3,0,0,1,-1,1,1,1,4,1
KR_6756820385,420,4,45,36,4,0,0,0,1,3,2,-3,0,3,3,4,1,3,5,2,0,2,-112,-1,6,5,3,0,0,0,0,0,1,0,1
KR_6742864876,420,5,110,-5,7,8,8,0,1,1,0,-1,0,1,-3,0,3,2,2,0,0,1,-276,0,2,2,-1,0,1,1,1,1,1,2,1
KR_6741648160,420,0,40,14,-1,2,3,1,-5,4,9,1,4,3,2,4,2,-1,0,1,0,-3,4,-3,4,1,2,0,1,1,1,1,1,1,1
KR_6689655461,440,9,112,24,20,3,3,0,3,3,0,2,4,2,8,9,1,4,5,1,1,20,3,4,2,6,0,0,2,1,-1,1,1,3,1
KR_6593813135,420,-1,10,0,4,2,2,0,-2,2,4,2,2,0,1,3,2,1,1,0,0,2,8,1,3,4,-1,0,0,-1,1,1,-1,2,1
KR_6141237487,440,3,37,19,12,2,6,4,2,5,3,1,3,2,6,7,1,1,3,2,2,13,7,7,1,8,1,0,1,0,0,1,1,0,1
KR_6762677228,420,5,27,23,5,2,3,1,5,6,1,-3,2,5,0,1,1,1,1,0,0,5,0,3,1,4,0,0,1,1,-1,1,-1,4,1
KR_6762737704,420,5,104,9,5,7,8,1,-1,0,1,6,6,0,-3,0,3,-4,1,5,0,-2,13,0,6,6,-7,0,3,1,1,1,1,6,1
KR_6721113336,420,0,33,8,0,2,4,2,-1,1,2,-3,2,5,2,4,2,0,1,1,0,2,15,3,3,6,-6,0,1,-1,1,1,1,2,1
KR_6704097514,420,5,34,12,21,9,10,1,3,6,3,1,2,1,5,5,0,3,3,0,3,27,13,4,1,5,1,0,2,1,-1,1,1,6,1
KR_6690182009,420,5,67,4,12,3,4,1,3,8,5,5,5,0,0,3,3,1,2,1,0,9,-7,2,3,5,6,0,2,1,1,1,1,3,1
KR_6759669997,420,-1,-40,-2,5,2,2,0,3,4,1,-1,1,2,2,6,4,-1,0,1,0,2,-1,1,6,7,5,0,0,-1,1,0,1,5,1
KR_6744145155,420,3,53,16,4,2,3,1,0,2,2,6,9,3,-4,1,5,0,0,0,0,2,10,1,6,7,-3,0,1,-1,1,1,1,3,1
KR_6755005313,420,3,83,4,7,3,3,0,4,5,1,-3,0,3,0,6,6,3,5,2,0,2,-176,1,3,4,-2,0,0,1,0,0,-1,1,1
KR_6612026840,420,3,-2,8,5,-2,1,3,5,5,0,1,1,0,2,5,3,-1,0,1,0,2,7,2,5,7,2,0,3,1,-1,1,-1,4,1
KR_6715994260,420,1,-7,11,10,0,4,4,-1,4,5,7,7,0,3,5,2,1,2,1,1,21,12,1,2,3,-3,0,-2,1,-1,-1,1,3,1
KR_6619365675,420,4,111,-1,8,4,4,0,2,4,2,-1,1,2,2,5,3,1,1,0,0,11,5,3,4,7,2,0,2,1,1,1,1,6,1
KR_6675545967,420,3,58,8,4,2,3,1,2,2,0,2,4,2,-2,2,4,0,1,1,0,8,-27,1,6,7,9,0,1,1,1,1,-1,5,1
KR_6510826612,420,5,39,10,6,-1,0,1,1,4,3,3,4,1,3,3,0,0,0,0,0,6,16,3,5,8,2,0,1,1,-1,1,1,6,1
KR_6725981109,420,2,-14,20,3,0,6,6,6,8,2,4,5,1,-5,0,5,-2,0,2,1,7,-4,5,2,7,5,0,-1,1,1,-1,-1,4,1
KR_6667357116,440,-3,-52,-16,-8,-2,1,3,-3,3,6,0,3,3,1,3,2,-4,0,4,0,-9,-32,0,4,4,-2,0,-1,-1,1,-1,-1,1,1
KR_6738638560,420,1,-21,-2,3,1,4,3,0,2,2,-2,2,4,4,4,0,0,1,1,-1,-3,-19,3,4,7,-4,0,-1,1,1,-1,-1,6,1
KR_6729086563,420,2,50,15,8,2,3,1,0,1,1,-1,1,2,4,5,1,3,3,0,0,6,-1,0,4,4,2,0,1,1,-1,1,-1,5,1
KR_6711496855,420,2,53,7,12,1,2,1,4,7,3,1,2,1,7,9,2,-1,0,1,0,10,-73,-1,7,6,13,0,1,1,1,1,1,6,1
KR_6488299352,420,0,17,0,3,1,5,4,3,6,3,-1,2,3,1,2,1,-1,0,1,0,2,2,1,4,5,-3,0,0,-1,1,0,1,5,1
KR_6762739100,420,2,31,-28,16,4,4,0,4,10,6,3,5,2,4,4,0,1,1,0,0,15,7,3,1,4,-2,0,1,1,-1,1,1,5,1
KR_6545314929,420,5,39,-28,8,1,3,2,3,9,6,3,4,1,0,4,4,1,1,0,-3,5,-10,-1,7,6,-2,0,0,1,-1,0,-1,2,1
KR_6760343505,420,0,8,-11,4,1,2,1,0,3,3,1,2,1,2,5,3,0,1,1,0,5,1,5,1,6,1,0,1,1,1,1,1,3,1
KR_5681091762,420,1,35,4,4,1,1,0,5,6,1,0,1,1,-2,1,3,0,1,1,0,6,14,6,4,10,-6,0,-1,1,-1,-1,-1,5,1
KR_6680017715,420,2,19,8,6,0,1,1,2,4,2,2,3,1,1,2,1,1,1,0,0,9,-114,0,4,4,0,0,-2,0,-1,-1,1,0,1
KR_6748413936,420,3,50,-3,6,-2,2,4,0,4,4,6,11,5,-1,3,4,3,3,0,-1,-11,3,5,2,7,1,0,2,0,1,1,-1,0,1
KR_6762316066,420,3,85,8,1,0,2,2,1,2,1,2,3,1,-1,5,6,-1,3,4,0,-7,5,-2,5,3,-1,0,0,1,-1,0,-1,6,1
KR_6757659345,420,8,119,4,24,7,8,1,5,5,0,3,4,1,9,9,0,0,2,2,0,24,4,4,1,5,1,0,3,1,1,1,1,5,1
KR_6755691102,420,4,51,9,9,2,3,1,2,4,2,2,3,1,2,4,2,1,1,0,0,7,1,-3,6,3,5,0,0,1,1,1,1,3,1
KR_6715139168,420,4,106,12,0,0,1,1,1,1,0,-6,2,8,4,4,0,1,2,1,0,0,9,0,4,4,1,0,1,-1,-1,1,-1,3,1
KR_6731171164,440,5,99,32,19,1,3,2,7,8,1,1,2,1,9,10,1,1,6,5,2,15,83,-1,3,2,8,0,2,-1,0,1,1,2,1
KR_6459111095,420,-1,-44,4,-6,3,5,2,-1,3,4,-5,0,5,1,2,1,-4,1,5,0,-6,3,-3,4,1,0,0,-1,1,-1,-1,1,2,1
KR_6556359195,420,3,46,28,5,8,8,0,2,4,2,-1,2,3,-2,5,7,-2,1,3,1,-3,259,-3,7,4,-9,0,1,1,-1,1,1,5,1
KR_6751999244,420,0,-29,-1,1,1,2,1,2,2,0,7,7,0,-3,0,3,-6,0,6,0,-3,0,-3,7,4,1,0,0,0,1,1,-1,0,1
KR_6752151214,440,1,-9,-1,4,-3,0,3,7,8,1,0,1,1,2,3,1,-2,0,2,-1,6,-3,-3,7,4,0,0,-1,-1,-1,-1,-1,5,1
KR_6736583134,420,0,63,-8,6,0,2,2,-3,1,4,-1,4,5,7,10,3,3,4,1,1,5,1,-3,5,2,2,0,1,1,-1,-1,1,3,1
KR_6665200357,420,0,-5,-13,3,-1,1,2,8,9,1,-1,1,2,-2,0,2,-1,0,1,0,2,5,5,5,10,2,0,1,1,1,1,1,1,1
KR_6759273185,420,4,-6,6,9,2,2,0,5,6,1,1,3,2,-1,1,2,2,4,2,0,17,3,-2,7,5,-2,0,1,1,1,1,1,1,1
KR_6648225681,420,-3,12,0,-17,-5,0,5,-4,6,10,1,2,1,-9,5,14,0,0,0,-2,-20,-7,-4,7,3,-1,0,-1,0,1,-1,-1,0,1
KR_6751230570,420,3,55,28,1,6,6,0,-1,3,4,-2,3,5,-2,2,4,0,1,1,-2,0,-5,-1,4,3,2,0,1,-1,1,1,-1,3,1
KR_6731969323,420,-3,-33,-20,-8,-6,0,6,-3,0,3,2,6,4,-1,2,3,0,2,2,0,-4,-3,5,1,6,0,0,0,-1,1,0,1,4,1
KR_6562328228,420,1,19,-26,0,1,1,0,1,4,3,-1,0,1,-1,1,2,0,1,1,0,-1,-20,-1,5,4,4,0,2,1,-1,1,1,5,1
KR_6708282069,420,0,60,0,-1,1,1,0,1,3,2,-5,2,7,4,5,1,-2,1,3,0,3,1,0,5,5,-2,0,0,-1,1,1,1,5,1
KR_6563512700,420,2,72,14,0,-1,0,1,4,5,1,-1,4,5,-2,0,2,0,1,1,0,-6,15,1,4,5,-1,0,1,1,-1,1,-1,6,1
KR_6743283690,420,-6,-26,-10,-10,-1,2,3,-2,1,3,-3,0,3,-3,0,3,-1,1,2,0,-8,2,-4,8,4,6,0,-1,0,-1,-1,-1,0,1
KR_6733982529,420,-1,-5,19,-3,2,3,1,-9,1,10,1,4,3,0,1,1,3,3,0,1,-2,-226,3,5,8,1,0,1,-1,1,1,1,4,1
KR_6650264730,440,3,10,7,9,0,1,1,2,5,3,6,7,1,2,3,1,-1,0,1,0,6,47,1,6,7,-19,0,1,1,-1,1,1,5,1
KR_6728536865,420,1,63,8,-1,-3,3,6,-1,2,3,1,2,1,4,5,1,-2,0,2,1,-3,-12,-4,5,1,0,0,0,-1,1,0,1,3,1
KR_6731178718,420,4,22,36,5,1,5,4,2,5,3,1,2,1,2,2,0,-1,1,2,0,2,-5,3,3,6,3,0,-1,1,-1,-1,-1,1,1
KR_6749328871,420,-2,-26,-30,-1,-6,0,6,4,5,1,1,4,3,2,4,2,-2,1,3,1,6,-3,1,3,4,3,0,0,0,-1,-1,1,0,1
KR_6737827026,440,-1,-44,34,-1,-5,0,5,6,6,0,-5,0,5,-1,2,3,4,4,0,1,6,-11,-2,4,2,-3,0,0,0,1,-1,1,0,1
KR_6749623498,420,3,64,34,8,2,2,0,2,2,0,2,4,2,1,1,0,1,1,0,1,12,4,-1,4,3,4,0,2,1,0,1,1,3,1
KR_6731406329,420,0,3,-7,-2,0,1,1,1,3,2,-1,2,3,1,1,0,-3,0,3,0,-3,19,3,5,8,0,0,1,1,1,1,-1,1,1
KR_6664621947,420,-1,39,1,2,1,1,0,2,2,0,1,3,2,-1,2,3,-1,1,2,0,-3,-27,-4,6,2,19,0,0,1,1,0,1,2,1
KR_6668243166,420,-1,20,16,-5,1,3,2,-1,0,1,0,0,0,-3,0,3,-2,0,2,0,-9,-60,0,3,3,-3,0,1,-1,1,1,-1,6,1
KR_6761372543,420,0,33,-3,8,1,3,2,5,5,0,3,4,1,0,1,1,-1,1,2,0,7,-40,3,2,5,18,0,0,-1,1,0,1,4,1
KR_6629574828,420,5,126,20,7,8,8,0,1,6,5,-5,2,7,2,4,2,1,2,1,0,0,-33,3,2,5,23,0,3,-1,1,1,1,4,1
KR_6695512343,420,-2,-2,5,-3,1,3,2,4,7,3,-3,2,5,0,2,2,-5,1,6,0,1,-4,2,4,6,-2,0,0,-1,1,0,-1,2,1
KR_6732803083,420,3,42,-17,8,4,5,1,0,4,4,2,6,4,1,3,2,1,2,1,1,4,-4,3,1,4,0,0,2,1,1,1,1,1,1
KR_6740736726,440,2,49,23,-1,-1,0,1,1,3,2,3,3,0,-2,0,2,-2,1,3,0,1,-93,3,3,6,-4,0,0,-1,1,0,1,3,1
KR_6612802268,440,3,-54,5,3,-1,0,1,0,3,3,0,0,0,4,6,2,0,0,0,-2,3,4,-2,4,2,-3,0,0,-1,-1,-1,-1,6,1
KR_6675910323,420,7,145,28,8,1,2,1,4,7,3,2,3,1,0,0,0,1,1,0,0,1,-3,-3,7,4,2,0,2,-1,1,1,1,6,1
KR_6720500729,420,0,-31,-15,4,-5,0,5,4,5,1,2,4,2,4,7,3,-1,0,1,0,10,-10,1,2,3,2,0,0,1,-1,-1,-1,2,1
KR_6672021728,420,5,88,11,8,3,4,1,5,7,2,0,1,1,0,3,3,0,0,0,0,9,1,-2,7,5,-4,0,2,1,-1,1,-1,6,1
KR_6657129181,420,-2,-33,-8,-2,-1,0,1,1,3,2,0,4,4,-6,1,7,4,4,0,-1,-1,12,-2,5,3,0,0,-1,-1,1,-1,-1,1,1
KR_6566989645,420,1,-52,-45,5,4,5,1,5,6,1,-2,1,3,0,3,3,-2,1,3,0,7,232,-1,7,6,4,0,0,1,-1,-1,1,6,1
KR_6736841161,420,-1,-10,-34,4,2,4,2,-1,4,5,-1,4,5,4,4,0,0,0,0,0,-3,10,1,2,3,-2,0,2,1,1,1,1,5,1
KR_6675595342,420,5,25,34,5,-1,0,1,6,10,4,1,3,2,-1,3,4,0,0,0,0,1,2,1,3,4,-2,0,1,1,1,1,1,1,1
KR_6663674921,420,0,2,24,4,0,0,0,2,2,0,2,2,0,-1,1,2,1,2,1,0,5,8,0,4,4,2,0,1,0,1,1,-1,0,1
KR_6764296182,420,5,127,1,6,2,3,1,4,6,2,-1,2,3,-1,1,2,2,4,2,0,3,-3,-2,6,4,-1,0,1,1,1,1,1,6,1
KR_6658015645,420,-1,-22,9,-2,-5,1,6,-3,0,3,5,8,3,1,4,3,0,0,0,0,5,2,1,3,4,-2,0,-1,1,-1,-1,-1,1,1
KR_6707405062,420,6,63,26,8,2,3,1,-1,2,3,6,6,0,1,2,1,0,0,0,0,2,26,1,2,3,-6,0,1,1,-1,1,1,2,1
KR_6751921938,420,-2,26,-2,-6,8,8,0,-6,1,7,-4,4,8,-4,0,4,0,0,0,0,-19,-30,-3,5,2,6,0,2,-1,1,1,-1,4,1
KR_6761925548,420,0,-36,-16,-10,3,4,1,-6,1,7,-3,2,5,0,6,6,-4,0,4,-2,-13,8,2,6,8,-2,0,0,-1,1,0,-1,3,1
KR_6756282885,420,4,33,-8,6,6,7,1,-2,1,3,0,4,4,-1,4,5,3,3,0,0,9,-7,-5,8,3,6,0,1,-1,1,1,1,6,1
KR_6641693893,420,4,82,16,8,3,5,2,2,5,3,2,2,0,-2,3,5,3,3,0,0,7,1,1,4,5,1,0,1,1,1,1,-1,1,1
KR_6755845665,440,1,23,12,-3,1,2,1,-1,3,4,-3,2,5,-3,3,6,3,5,2,0,-8,-5,-1,7,6,0,0,0,1,0,-1,-1,4,1
KR_6745159512,420,-1,-4,12,-2,-3,1,4,1,3,2,0,2,2,-1,2,3,1,1,0,1,-4,-90,0,5,5,-2,0,0,-1,1,0,1,1,1
KR_6607937120,420,6,42,16,7,2,3,1,2,3,1,-3,1,4,5,5,0,1,1,0,0,6,1,-3,7,4,1,0,0,1,1,1,1,5,1
KR_6739556330,440,-1,-18,5,2,0,4,4,-2,3,5,4,6,2,1,2,1,-1,0,1,0,8,-9,3,5,8,-3,0,0,0,1,0,-1,0,1
KR_6729915595,420,2,54,-10,3,-2,1,3,4,4,0,-1,1,2,1,7,6,1,2,1,1,4,15,-1,6,5,0,0,1,-1,1,1,1,2,1
KR_6746079117,440,1,-34,-12,11,2,4,2,-1,3,4,2,2,0,4,5,1,4,5,1,2,15,8,3,4,7,-5,0,2,1,1,1,1,6,1
KR_6720227161,420,6,47,64,12,3,4,1,4,5,1,8,8,0,-2,2,4,-1,1,2,0,1,210,1,3,4,0,0,1,0,-1,1,1,0,1
KR_6642460203,420,-2,-27,-16,-4,1,1,0,-2,4,6,-3,2,5,1,1,0,-1,1,2,0,-6,-10,-4,8,4,5,0,0,1,1,0,-1,1,1
KR_6743289944,420,2,-43,9,3,3,5,2,-1,0,1,-1,1,2,3,3,0,-1,0,1,1,5,-2,-1,5,4,-4,0,0,1,-1,0,1,4,1
KR_6756125195,440,1,107,-3,6,-1,1,2,-1,3,4,-3,1,4,8,11,3,3,5,2,1,7,0,1,1,2,2,0,2,1,1,1,1,1,1
KR_6703983315,440,2,-14,18,2,0,2,2,1,4,3,2,3,1,-4,3,7,3,6,3,0,2,-1,0,5,5,3,0,0,-1,-1,0,1,6,1
KR_6699235846,440,1,43,16,6,0,0,0,3,9,6,-2,1,3,6,6,0,-1,1,2,0,13,22,1,5,6,-2,0,2,1,-1,1,1,4,1
KR_6758752620,420,-1,-28,-42,5,1,2,1,2,3,1,-1,2,3,2,6,4,1,1,0,0,13,7,-2,6,4,1,0,0,-1,-1,1,1,4,1
KR_6761457963,420,1,43,-11,1,1,3,2,0,3,3,-2,1,3,2,4,2,0,1,1,-1,4,-126,-1,7,6,-1,0,0,-1,1,0,-1,1,1
KR_6740775851,420,4,110,18,6,5,5,0,1,2,1,-6,0,6,3,4,1,3,4,1,0,4,243,-2,4,2,-5,0,1,1,0,1,1,5,1
KR_6740799482,440,1,29,-35,5,-4,0,4,1,4,3,4,4,0,4,4,0,0,0,0,0,9,-9,1,2,3,-2,0,0,1,0,0,1,6,1
KR_6650700251,420,-3,35,-23,-2,1,3,2,-1,2,3,2,4,2,-4,0,4,0,0,0,0,-3,-37,-1,5,4,20,0,0,-1,0,1,1,4,1
KR_6749784907,420,3,38,-18,9,6,6,0,-1,3,4,-1,1,2,5,7,2,0,1,1,0,1,-4,3,3,6,0,0,2,-1,1,1,1,5,1
KR_6748893336,420,3,11,0,6,7,8,1,1,2,1,0,2,2,-1,0,1,-1,1,2,0,5,1,-1,4,3,-2,0,0,-1,1,0,1,3,1
KR_6655603498,420,0,-21,-24,3,-1,2,3,2,4,2,1,4,3,-1,2,3,2,2,0,1,3,-196,3,2,5,0,0,-1,-1,-1,-1,1,3,1
KR_6764626941,420,1,-1,42,7,1,1,0,2,4,2,-1,2,3,4,6,2,1,2,1,0,5,-111,-1,4,3,4,0,3,1,1,1,1,4,1
KR_6759790652,420,1,-34,3,-3,0,4,4,1,3,2,0,3,3,-3,0,3,-1,0,1,0,-5,12,2,6,8,2,0,0,1,-1,1,1,1,1
KR_6725955181,440,1,27,-4,7,2,4,2,0,2,2,0,3,3,8,11,3,-3,1,4,0,-5,2,-1,6,5,0,0,0,1,-1,1,1,1,1
KR_6761163165,420,0,83,-24,-2,-1,3,4,1,4,3,0,3,3,-1,2,3,-1,1,2,0,-4,-41,-1,5,4,1,0,1,-1,-1,-1,1,3,1
KR_6365007081,420,3,88,-28,4,1,2,1,-1,1,2,-1,1,2,8,9,1,-3,1,4,0,0,0,0,0,0,0,0,2,-1,1,1,1,4,1
KR_6542886438,420,2,14,-20,7,4,5,1,0,1,1,2,7,5,0,3,3,1,4,3,0,15,2,0,6,6,3,0,2,1,-1,1,1,5,1
KR_6761674833,440,4,37,15,16,-2,1,3,3,4,1,-2,1,3,14,14,0,3,4,1,0,19,128,-1,4,3,-1,0,0,0,0,1,1,0,1
KR_6696350770,420,-2,-38,12,-3,-1,1,2,3,4,1,-7,2,9,3,3,0,-1,1,2,-1,3,6,-2,5,3,0,0,-2,1,1,-1,-1,1,1
KR_6730204993,420,2,19,31,5,4,4,0,0,3,3,0,2,2,3,4,1,-2,0,2,1,1,3,2,4,6,1,0,0,1,1,1,1,3,1
KR_6753675175,420,2,57,25,3,-2,0,2,4,4,0,-1,3,4,1,3,2,1,3,2,0,2,-6,-7,10,3,3,0,1,1,1,1,1,3,1
KR_6763463480,420,0,13,3,4,-2,1,3,6,7,1,-1,0,1,1,6,5,0,1,1,0,5,-1,-1,3,2,-1,0,0,-1,-1,0,1,5,1
KR_6737762312,420,3,33,1,10,2,3,1,4,5,1,0,0,0,3,3,0,1,1,0,0,11,-29,-9,11,2,7,0,1,-1,1,1,1,2,1
KR_6624506332,420,1,57,25,2,3,4,1,2,5,3,-4,0,4,2,2,0,-1,0,1,0,1,-27,3,4,7,-4,0,2,-1,1,1,-1,2,1
KR_6699738807,420,5,106,8,19,1,2,1,6,9,3,3,6,3,7,7,0,2,2,0,0,22,6,5,3,8,-7,0,1,1,1,1,1,5,1
KR_6662932320,420,1,-21,6,5,3,3,0,0,4,4,3,6,3,0,6,6,-1,0,1,0,-3,18,0,4,4,0,0,0,1,1,0,1,2,1
KR_6570945522,440,-2,-38,-19,-9,-4,1,5,-1,2,3,-2,2,4,0,1,1,-2,0,2,1,-10,1,2,4,6,-10,0,-3,-1,-1,-1,1,5,1
KR_6754480977,420,4,17,-4,11,3,3,0,0,0,0,1,2,1,3,4,1,4,4,0,0,10,-1,4,4,8,5,0,2,1,-1,1,1,1,1
KR_6572658608,420,0,-11,-5,-7,-1,1,2,7,9,2,-6,0,6,-5,1,6,-2,0,2,0,-16,-150,5,6,11,-10,0,1,-1,1,-1,1,6,1
KR_6764715882,440,-1,-98,1,-5,-8,1,9,4,5,1,0,0,0,-1,1,2,0,0,0,0,7,-8,-4,5,1,1,0,-2,-1,-1,-1,-1,5,1
KR_6679495530,420,2,13,7,7,3,3,0,4,5,1,3,4,1,-2,0,2,-1,0,1,0,10,1,0,6,6,4,0,1,-1,1,1,1,4,1
KR_6698473705,420,1,-28,10,5,5,7,2,6,8,2,-4,1,5,-2,1,3,0,0,0,0,3,-49,-1,4,3,18,0,0,-1,1,1,1,4,1
KR_6726205880,420,2,61,-4,3,3,5,2,3,5,2,-1,0,1,-1,1,2,-1,1,2,0,5,12,-4,6,2,-3,0,0,1,1,1,1,6,1
KR_6746677604,420,9,120,30,18,4,4,0,3,3,0,-2,1,3,3,3,0,10,10,0,0,17,-16,0,2,2,4,0,1,1,1,1,1,6,1
KR_6753292518,440,-1,15,1,8,1,2,1,-1,3,4,0,2,2,8,13,5,0,0,0,0,14,14,1,6,7,2,0,1,1,1,1,1,4,1
KR_6742971344,420,5,26,-8,8,-1,2,3,1,4,3,8,9,1,0,3,3,0,1,1,0,7,216,2,3,5,-6,0,3,1,1,1,-1,4,1
KR_6660277521,440,1,10,-12,0,2,2,0,0,1,1,-6,0,6,2,2,0,2,2,0,0,-4,3,-4,7,3,-1,0,0,-1,-1,-1,1,5,1
KR_6745665182,420,2,26,7,8,3,5,2,0,3,3,0,2,2,5,5,0,0,1,1,1,3,6,0,1,1,0,0,2,1,1,1,1,4,1
KR_6759615998,420,-2,37,-32,-9,0,0,0,-3,0,3,-4,0,4,-1,0,1,-1,1,2,0,-17,1,3,4,7,-2,0,0,-1,1,1,-1,3,1
KR_6759056817,420,3,11,-8,3,-1,2,3,2,3,1,2,4,2,3,4,1,-3,2,5,0,7,0,2,2,4,3,0,-1,1,-1,-1,1,3,1
KR_6759552899,420,5,100,24,8,2,2,0,2,3,1,5,6,1,-1,2,3,0,0,0,1,2,1,-3,5,2,0,0,1,1,1,1,1,5,1
KR_6716395785,440,2,-28,1,6,2,5,3,0,2,2,2,3,1,0,1,1,2,3,1,0,0,4,0,1,1,-3,0,3,1,1,1,1,1,1
KR_6752900265,420,2,-33,-2,4,0,0,0,6,6,0,2,3,1,-3,1,4,-1,0,1,0,4,1,3,4,7,0,0,-1,1,-1,-1,1,2,1
KR_6760500441,420,0,19,0,-4,0,1,1,0,0,0,5,6,1,-5,0,5,-4,2,6,0,-1,-7,-2,4,2,0,0,0,0,-1,-1,-1,0,1
KR_6727011467,440,3,90,20,12,5,9,4,4,6,2,-1,3,4,3,5,2,1,1,0,0,5,7,-1,4,3,-1,0,2,1,1,1,-1,2,1
KR_6629063871,420,0,76,16,-5,0,1,1,-3,2,5,1,1,0,-3,1,4,0,0,0,0,-15,6,-8,10,2,3,0,0,1,1,0,1,4,1
KR_6739803558,420,-1,5,-4,3,2,2,0,-4,3,7,2,3,1,0,4,4,3,3,0,2,-3,-14,2,3,5,-3,0,1,1,-1,1,-1,2,1
KR_6738933819,420,2,2,32,-1,2,2,0,-5,2,7,1,2,1,1,1,0,0,0,0,0,-5,7,4,3,7,0,0,1,1,1,1,-1,2,1
KR_6752957464,420,3,56,20,8,-3,1,4,5,7,2,6,9,3,1,4,3,-1,0,1,0,3,8,5,2,7,-1,0,1,1,-1,1,1,4,1
KR_6763489416,420,1,84,0,5,-1,1,2,0,2,2,2,4,2,4,4,0,0,0,0,0,0,-25,1,4,5,2,0,2,1,-1,1,1,2,1
KR_6761102684,420,3,-55,22,5,-1,1,2,1,2,1,0,3,3,2,5,3,3,3,0,0,3,0,-3,5,2,0,0,2,0,1,1,1,0,1
KR_6755486094,420,0,42,26,0,-3,0,3,3,5,2,2,5,3,-2,3,5,0,1,1,0,-1,-102,-1,7,6,2,0,-1,-1,-1,-1,1,3,1
KR_6765256623,440,1,106,28,2,0,1,1,-2,1,3,1,3,2,3,4,1,0,1,1,0,-5,9,-4,8,4,-1,0,2,1,1,1,1,2,1
KR_6757053354,420,-2,-37,28,-7,0,2,2,0,1,1,-5,2,7,-1,3,4,-1,2,3,1,-9,-3,-6,8,2,3,0,-1,1,-1,-1,-1,5,1
KR_6670779549,420,-1,-48,4,-2,0,1,1,-3,1,4,-6,2,8,8,9,1,-1,1,2,0,-1,-26,-3,5,2,-1,0,-1,1,1,1,1,5,1
KR_6745155509,420,4,-15,5,3,2,3,1,2,2,0,-4,0,4,1,5,4,2,2,0,0,4,-50,1,3,4,22,0,2,-1,1,1,-1,1,1
KR_6732061585,440,7,75,37,16,2,2,0,5,5,0,6,6,0,3,3,0,0,0,0,0,11,3,-3,4,1,2,0,2,1,1,1,1,6,1
KR_6765341766,440,-1,0,12,0,-2,1,3,3,6,3,-1,1,2,-1,3,4,1,3,2,0,4,-45,-3,6,3,21,0,0,1,-1,-1,1,4,1
KR_6693594661,420,1,2,24,3,5,6,1,4,7,3,-1,2,3,-1,0,1,-4,0,4,0,3,6,4,3,7,0,0,1,-1,1,1,-1,4,1
KR_6731937519,420,1,37,-16,-2,4,4,0,-6,1,7,0,1,1,1,1,0,-1,3,4,0,-7,-6,-1,4,3,0,0,0,-1,-1,0,-1,2,1
KR_6728692264,420,1,3,8,0,0,1,1,1,4,3,-1,4,5,-1,2,3,1,2,1,0,-3,44,-1,3,2,-15,0,0,0,1,1,1,0,1
KR_6626117294,420,2,92,-16,1,0,1,1,-2,1,3,2,4,2,1,7,6,0,1,1,0,-2,-3,4,5,9,-3,0,0,1,-1,0,-1,5,1
KR_6578935677,420,3,24,-2,5,1,1,0,2,6,4,-4,1,5,3,6,3,3,4,1,0,5,-47,-5,8,3,36,0,-1,1,1,-1,-1,1,1
KR_6717287557,420,-2,34,-16,-8,2,3,1,-3,2,5,-5,1,6,-2,5,7,0,0,0,-2,-11,-32,-4,8,4,1,0,1,1,-1,1,-1,5,1
KR_6716317295,420,-2,-30,-32,-3,-1,2,3,-1,2,3,-1,3,4,1,5,4,-1,1,2,-2,0,-5,2,4,6,-1,0,-2,-1,-1,-1,-1,5,1
KR_6742250299,420,-1,87,15,1,6,9,3,-6,1,7,2,2,0,-1,1,2,0,2,2,1,-7,-75,5,3,8,-7,0,0,1,1,1,1,4,1
KR_6758772674,420,0,-9,-2,4,3,5,2,4,4,0,-1,1,2,-2,0,2,0,1,1,0,1,-125,0,4,4,7,0,1,-1,-1,1,1,5,1
KR_6753136653,420,-2,-29,4,-5,-2,3,5,-1,0,1,-1,2,3,-1,1,2,0,1,1,-3,-11,5,0,2,2,1,0,0,1,1,0,-1,5,1
KR_6754282620,420,3,-3,15,10,2,5,3,-1,3,4,0,1,1,9,10,1,0,1,1,0,3,285,-3,5,2,0,0,3,0,1,1,-1,0,1
KR_6746173499,420,-2,-12,-26,-3,-5,0,5,1,2,1,-2,0,2,1,1,0,2,2,0,0,2,25,-1,4,3,-1,0,-1,1,-1,-1,-1,5,1
KR_6606047755,420,2,0,0,5,3,4,1,0,2,2,2,4,2,-1,1,2,1,1,0,-1,4,5,3,3,6,1,0,1,-1,-1,-1,-1,4,1
KR_6701928742,420,3,42,13,-1,2,3,1,-2,1,3,2,2,0,-1,2,3,-2,0,2,0,-2,-2,3,3,6,2,0,1,1,-1,1,1,3,1
KR_6751162854,420,-1,3,-19,-4,-5,2,7,1,2,1,-1,1,2,2,3,1,-1,1,2,0,-1,4,2,3,5,-2,0,-1,-1,-1,-1,1,3,1
KR_6694978812,420,2,3,12,0,-1,1,2,0,2,2,-1,0,1,4,6,2,-2,1,3,0,2,-5,3,2,5,2,0,1,1,0,1,1,1,1
KR_6758023700,420,-2,3,-8,-2,-1,2,3,-2,1,3,-1,3,4,2,5,3,0,2,2,0,-1,-8,-3,4,1,3,0,0,-1,1,0,-1,4,1
KR_6762306528,420,2,44,39,6,-1,1,2,0,5,5,-1,0,1,7,7,0,1,1,0,0,9,-8,3,2,5,1,0,0,1,-1,0,1,2,1
KR_6206540485,420,2,37,40,7,7,8,1,4,4,0,-1,1,2,1,1,0,-4,0,4,0,-5,-3,-2,6,4,3,0,1,-1,1,1,1,1,1
KR_6759704519,420,0,80,1,-1,1,2,1,-4,0,4,3,3,0,0,2,2,-1,3,4,0,-2,-54,0,1,1,1,0,0,0,0,0,1,0,1
KR_6765454690,420,4,-13,19,8,-1,2,3,0,1,1,-1,1,2,8,14,6,2,2,0,0,9,4,1,3,4,-4,0,0,1,-1,1,1,6,1
KR_6762732705,420,1,30,4,9,0,0,0,3,4,1,3,3,0,2,2,0,1,1,0,0,10,-6,1,3,4,0,0,1,1,1,1,1,5,1
KR_6744982125,420,1,53,-11,1,1,1,0,-3,2,5,6,7,1,-2,4,6,-1,0,1,0,3,-16,0,7,7,-5,0,1,0,1,1,1,0,1
KR_6755646170,420,0,6,7,-3,-5,0,5,0,5,5,-2,3,5,3,3,0,1,2,1,0,7,1,3,4,7,-3,0,1,1,1,1,1,2,1
KR_6715282320,420,2,51,4,-2,2,3,1,0,3,3,1,4,3,-3,0,3,-2,0,2,0,-3,32,-4,6,2,-19,0,1,-1,1,1,-1,2,1
KR_6763959048,420,-1,-29,-20,2,-1,2,3,-1,1,2,3,3,0,1,1,0,0,1,1,1,1,0,5,3,8,-2,0,0,1,1,0,1,1,1
KR_6697923152,420,2,39,-11,0,2,2,0,4,5,1,-5,1,6,-2,3,5,1,1,0,0,-4,12,-5,5,0,6,0,3,1,-1,1,-1,6,1
KR_6731488219,420,2,27,32,7,-2,1,3,0,0,0,0,1,1,5,6,1,4,4,0,0,6,-4,1,0,1,-1,0,2,1,1,1,1,1,1
KR_6707227521,420,-2,39,-4,-2,0,1,1,-3,0,3,-2,0,2,-2,1,3,5,5,0,0,0,0,-3,6,3,4,0,0,1,1,1,-1,4,1
KR_6762587910,420,4,56,-19,7,4,4,0,3,5,2,-2,2,4,2,3,1,0,0,0,0,3,-2,2,1,3,0,0,1,1,-1,1,1,3,1
KR_6655995955,420,1,-23,16,-4,2,3,1,-1,3,4,-2,2,4,-1,2,3,-2,0,2,0,-9,-5,-1,2,1,2,0,1,1,0,1,1,6,1
KR_6734187378,420,8,108,17,14,5,5,0,3,3,0,4,7,3,1,2,1,1,2,1,0,10,-5,6,2,8,0,0,4,1,1,1,1,3,1
KR_6611955596,420,2,0,12,2,4,4,0,0,2,2,0,2,2,-1,5,6,-1,0,1,0,0,-4,-4,7,3,-1,0,0,-1,1,1,-1,3,1
KR_6714186835,420,0,-2,-4,-5,-6,2,8,-4,2,6,3,4,1,0,1,1,2,4,2,1,-3,3,3,4,7,-1,0,0,-1,0,-1,1,6,1
KR_6696452054,420,0,-49,-15,2,0,2,2,0,1,1,-6,1,7,4,7,3,4,4,0,1,9,7,0,5,5,-5,0,0,0,1,0,1,0,1
KR_6620950797,420,2,-12,-24,6,2,2,0,4,6,2,-2,0,2,0,2,2,2,3,1,0,10,3,3,2,5,-1,0,0,1,-1,0,1,3,1
KR_6680026416,420,2,7,27,6,0,1,1,4,6,2,4,5,1,-2,1,3,0,0,0,0,0,14,0,4,4,-1,0,1,1,1,1,-1,1,1
KR_6767246614,420,4,10,44,10,4,4,0,1,2,1,3,3,0,0,2,2,2,3,1,0,7,-384,4,0,4,-2,0,1,1,1,1,1,1,1
KR_6767029769,420,0,43,-7,10,0,2,2,3,5,2,1,2,1,6,9,3,0,2,2,0,7,36,9,4,13,-22,0,-1,-1,-1,-1,1,4,1
KR_6644247045,420,3,23,28,0,1,1,0,0,3,3,-1,3,4,-1,3,4,1,1,0,-2,-6,5,2,4,6,0,0,0,1,1,0,-1,4,1
KR_6710514460,420,-2,14,-13,3,2,3,1,-6,1,7,-1,2,3,8,10,2,0,0,0,0,12,-124,1,6,7,0,0,1,1,-1,1,-1,1,1
KR_6635264574,420,0,-25,28,-4,0,1,1,-1,0,1,-2,2,4,-2,1,3,1,2,1,0,-11,7,6,3,9,-3,0,0,1,1,0,-1,3,1
KR_6741526992,420,1,-59,5,0,-4,1,5,2,4,2,2,2,0,0,1,1,0,0,0,0,0,-1,1,4,5,0,0,-1,1,-1,-1,-1,2,1
KR_6752392039,420,2,46,17,4,2,3,1,-3,1,4,3,7,4,3,4,1,-1,2,3,0,-1,-18,5,4,9,-2,0,0,1,1,0,1,2,1
KR_6759215542,420,2,80,11,-3,-2,0,2,-1,2,3,-1,6,7,0,3,3,1,3,2,-1,-15,6,7,2,9,-1,0,1,1,-1,-1,-1,5,1
KR_6764123271,420,4,11,-12,17,9,9,0,-2,1,3,3,3,0,6,8,2,1,2,1,0,6,10,1,4,5,-4,0,1,-1,1,1,1,1,1
KR_6734855697,420,5,53,32,5,3,4,1,-1,1,2,1,2,1,2,4,2,0,2,2,0,-1,257,-1,3,2,3,0,1,1,1,1,1,6,1
KR_6264239684,420,1,7,7,1,4,4,0,0,1,1,0,2,2,-1,2,3,-2,0,2,0,0,5,2,2,4,-5,0,1,-1,1,1,-1,5,1
KR_6620737533,420,-1,-56,-18,1,-1,2,3,3,5,2,-1,0,1,0,2,2,0,0,0,-1,-3,125,2,4,6,-1,0,0,1,1,0,-1,3,1
KR_6736737198,420,0,31,-11,-3,-5,2,7,0,0,0,1,3,2,1,1,0,0,1,1,0,-8,-1,-5,5,0,0,0,1,1,0,1,-1,2,1
KR_6724677043,420,4,1,17,2,-6,1,7,-1,1,2,-2,3,5,9,9,0,2,3,1,0,3,6,0,3,3,0,0,1,1,-1,1,-1,1,1
KR_6641425696,420,1,21,8,-1,-2,2,4,-1,1,2,-2,0,2,2,3,1,2,3,1,0,1,3,-2,6,4,0,0,-1,1,-1,-1,-1,1,1
KR_6722946428,420,-2,14,-3,0,2,2,0,0,1,1,0,3,3,-2,0,2,0,0,0,0,3,6,-4,7,3,-2,0,0,-1,0,0,-1,2,1
KR_6699362174,420,2,11,48,6,5,5,0,7,7,0,-3,0,3,0,1,1,-3,0,3,0,-7,8,5,4,9,-2,0,1,-1,1,1,1,1,1
KR_6726224780,440,5,92,32,14,-2,0,2,4,4,0,7,7,0,4,5,1,1,2,1,0,16,5,2,8,10,-2,0,2,1,1,1,1,1,1
KR_6767604419,420,3,10,3,7,1,1,0,3,3,0,1,2,1,2,4,2,0,0,0,0,10,0,-2,4,2,-1,0,0,-1,1,1,1,5,1
KR_6767904751,420,1,72,-4,11,6,6,0,0,2,2,1,2,1,3,4,1,1,2,1,0,5,-5,2,3,5,7,0,1,1,1,1,1,6,1
KR_6734909930,420,-2,-16,-34,1,0,1,1,1,7,6,3,3,0,-2,0,2,-1,0,1,-1,3,-3,0,5,5,1,0,0,-1,1,-1,-1,6,1
KR_6757768849,440,-1,134,-73,1,0,2,2,-3,3,6,5,6,1,-1,0,1,0,3,3,2,9,-2,-3,3,0,-3,0,1,-1,-1,-1,1,1,1
KR_6761580887,420,0,29,-4,5,0,3,3,5,6,1,-4,0,4,4,4,0,0,1,1,1,15,3,0,2,2,4,0,0,1,1,0,1,2,1
KR_6673279206,420,0,33,-40,1,-1,1,2,1,2,1,6,7,1,-3,0,3,-2,0,2,0,-1,-4,3,2,5,1,0,1,1,1,1,-1,5,1
KR_6636283938,420,3,13,-16,3,1,1,0,-1,2,3,-1,1,2,2,3,1,2,3,1,0,3,5,-1,3,2,1,0,2,-1,1,1,-1,3,1
KR_6757005285,420,5,-2,60,2,2,6,4,1,1,0,-2,1,3,0,4,4,1,2,1,0,0,7,2,2,4,-5,0,2,1,1,1,1,3,1
KR_6725811228,420,1,-37,30,-3,1,3,2,-1,2,3,1,3,2,-4,2,6,0,1,1,1,-8,77,-1,6,5,4,0,0,1,1,0,1,5,1
KR_6618737101,440,4,169,-12,10,2,3,1,2,4,2,-1,2,3,6,8,2,1,1,0,1,17,-10,-1,4,3,1,0,1,0,1,1,-1,0,1
KR_6719658115,420,3,-9,-25,10,-3,1,4,2,5,3,9,9,0,2,3,1,0,0,0,0,14,-19,4,3,7,2,0,1,1,0,1,1,1,1
KR_6715713601,420,2,19,5,3,-1,2,3,-5,2,7,6,6,0,3,4,1,0,2,2,0,-7,-32,3,4,7,5,0,-1,1,-1,-1,1,5,1
KR_6763897082,420,-3,0,-36,0,-1,1,2,2,3,1,-3,1,4,2,2,0,0,1,1,0,9,-36,3,3,6,31,0,-1,1,0,-1,-1,4,1
KR_6752340568,420,0,17,-8,1,4,4,0,4,5,1,-5,0,5,1,7,6,-3,0,3,0,-4,-3,0,4,4,-2,0,2,-1,1,1,1,3,1
KR_6753046499,440,3,86,27,11,-3,1,4,0,2,2,6,7,1,8,11,3,0,3,3,0,10,4,-1,5,4,3,0,2,1,1,1,1,1,1
KR_6740431842,440,4,52,8,11,3,3,0,3,3,0,1,2,1,6,7,1,-2,1,3,0,24,10,2,3,5,1,0,1,-1,0,1,1,1,1
KR_6708818725,440,5,38,12,10,1,1,0,0,0,0,4,5,1,-2,2,4,7,7,0,0,11,27,-9,13,4,-1,0,1,0,0,1,1,0,1
KR_6489571985,420,-2,13,8,-4,2,2,0,-5,1,6,0,1,1,1,2,1,-2,1,3,0,-7,-81,-4,7,3,2,0,-1,-1,1,1,1,4,1
KR_6760583985,420,0,44,12,0,-7,0,7,3,4,1,6,6,0,-1,3,4,-1,2,3,0,-3,0,-2,6,4,2,0,-1,1,-1,-1,-1,5,1
KR_6758971106,420,2,55,9,5,6,7,1,-1,3,4,-3,1,4,5,7,2,-2,0,2,1,4,-1,-1,2,1,1,0,2,1,0,1,1,3,1
KR_6753160497,420,5,34,36,13,1,2,1,5,6,1,4,5,1,1,2,1,2,3,1,0,3,14,2,2,4,-7,0,1,1,1,1,1,1,1
KR_6754651998,420,2,11,19,5,2,5,3,-4,0,4,4,4,0,1,4,3,2,2,0,0,-2,30,-1,6,5,5,0,2,-1,1,1,1,3,1
KR_6764114618,440,2,-54,-2,5,-1,0,1,1,3,2,1,2,1,2,3,1,2,2,0,0,4,-40,-2,3,1,3,0,0,1,0,1,-1,3,1
KR_6599716757,420,0,-16,4,3,-3,1,4,0,4,4,-2,1,3,5,6,1,3,3,0,0,8,-2,1,3,4,2,0,2,-1,1,1,1,1,1
KR_6755978285,420,2,0,-7,5,2,3,1,0,1,1,0,2,2,1,4,3,2,3,1,0,4,-13,0,7,7,-1,0,1,1,1,1,1,3,1
KR_6767372585,420,1,-7,16,6,1,2,1,1,2,1,-4,3,7,3,4,1,5,5,0,0,8,2,1,5,6,4,0,0,0,0,0,1,0,1
KR_6693232494,420,1,-2,1,7,2,3,1,-1,1,2,-1,3,4,12,15,3,-5,1,6,1,8,-6,5,3,8,0,0,1,1,1,1,1,5,1
KR_6726855433,420,3,56,11,6,0,1,1,1,3,2,-2,3,5,5,6,1,2,3,1,0,2,4,0,2,2,2,0,0,1,0,1,1,3,1
KR_6575079778,420,2,27,-36,13,5,6,1,6,9,3,1,2,1,0,3,3,1,3,2,1,6,-6,2,3,5,2,0,1,-1,-1,1,1,2,1
KR_6741344427,420,-2,19,16,-1,-1,0,1,1,4,3,-1,2,3,2,6,4,-2,1,3,0,-2,-11,-3,8,5,1,0,0,1,1,0,1,2,1
KR_6767262323,420,7,56,59,12,5,5,0,3,3,0,-3,1,4,3,6,3,4,5,1,1,4,-1,0,4,4,3,0,3,1,1,1,1,5,1
KR_6762728751,440,2,45,15,2,0,1,1,1,3,2,3,6,3,-3,0,3,1,1,0,1,1,-3,0,1,1,1,0,2,0,0,1,1,0,1
KR_6736207218,420,-3,-32,25,-7,-2,2,4,-2,2,4,0,1,1,-2,1,3,-1,1,2,0,-5,6,3,1,4,-1,0,-1,1,-1,-1,-1,5,1
KR_6610240989,420,2,64,-2,0,2,3,1,-4,3,7,-2,0,2,3,3,0,1,1,0,-1,-2,-56,0,4,4,2,0,2,-1,1,1,-1,3,1
KR_6751906929,420,4,89,-3,7,6,6,0,-1,2,3,4,4,0,-2,0,2,0,2,2,0,1,-26,0,1,1,0,0,1,1,-1,1,-1,3,1
KR_6748049685,420,3,25,13,2,-3,3,6,1,2,1,-1,1,2,2,2,0,3,3,0,-1,8,7,-1,5,4,-2,0,0,1,-1,1,-1,4,1
KR_6730274234,440,-2,-60,-10,-5,1,4,3,-3,1,4,-2,2,4,2,5,3,-3,2,5,-2,-7,15,7,6,13,-5,0,-1,-1,1,-1,-1,4,1
KR_6766633075,420,1,49,-4,4,2,3,1,0,2,2,0,3,3,-1,0,1,3,4,1,0,1,-6,-1,1,0,-1,0,0,-1,0,0,1,6,1
KR_6752109631,440,1,89,4,4,-1,0,1,0,4,4,1,5,4,4,6,2,0,1,1,1,6,2,2,1,3,2,0,2,1,0,1,1,4,1
KR_6663661545,420,3,39,60,6,-4,1,5,-1,2,3,4,5,1,5,7,2,2,3,1,0,4,-12,4,3,7,6,0,-1,1,0,-1,1,6,1
KR_6757579762,420,2,-8,8,0,0,2,2,2,2,0,0,1,1,-2,2,4,0,0,0,0,3,-3,-1,3,2,4,0,1,1,-1,1,-1,1,1
KR_6765359196,420,-3,-2,-31,-2,0,1,1,-1,3,4,-5,0,5,7,9,2,-3,1,4,0,1,-29,-4,6,2,7,0,1,-1,1,1,1,4,1
KR_6751009021,420,2,-31,16,-1,-3,1,4,5,6,1,-4,1,5,2,3,1,-1,0,1,0,2,15,4,3,7,3,0,-1,1,-1,-1,-1,4,1
KR_6751379807,440,-2,-66,-51,0,-3,2,5,2,2,0,2,3,1,-2,2,4,1,1,0,0,6,3,5,4,9,-4,0,0,-1,-1,-1,-1,3,1
KR_6762183693,440,2,116,20,2,7,9,2,-4,3,7,-1,3,4,1,1,0,-1,1,2,0,-6,41,-1,3,2,-14,0,1,0,1,1,1,0,1
KR_6765203523,440,5,92,16,5,2,3,1,-2,0,2,1,3,2,3,5,2,1,2,1,0,2,108,-2,2,0,1,0,0,1,-1,1,1,3,1
KR_6751873871,420,-2,17,-18,-2,1,2,1,4,5,1,-1,0,1,-5,0,5,-1,0,1,0,-1,-17,9,3,12,-5,0,0,1,-1,0,-1,2,1
KR_6755565265,420,0,-28,4,-2,-1,1,2,2,4,2,-1,2,3,1,3,2,-3,0,3,0,4,6,-5,7,2,-3,0,0,1,1,0,-1,6,1
KR_6719185443,440,2,43,4,-1,3,4,1,0,3,3,-5,0,5,0,1,1,1,3,2,0,-1,19,-1,3,2,1,0,2,-1,1,1,-1,3,1
KR_6763255005,420,3,27,-4,12,0,3,3,0,1,1,0,1,1,7,7,0,5,5,0,0,16,-9,-4,5,1,3,0,3,0,1,1,1,0,1
KR_6756306183,420,2,25,-12,3,3,4,1,-2,0,2,5,6,1,-3,0,3,0,1,1,0,-11,-61,4,2,6,0,0,1,1,1,1,1,2,1
KR_6759688404,420,1,16,-35,-3,-4,0,4,1,2,1,0,3,3,0,2,2,0,2,2,0,0,-4,-6,8,2,4,0,1,1,-1,1,-1,1,1
KR_6725496008,420,0,-8,-12,-4,3,4,1,4,5,1,-4,1,5,-6,0,6,-1,1,2,0,-10,-14,1,5,6,-3,0,-1,1,-1,-1,-1,3,1
KR_6661081281,440,3,32,13,6,1,1,0,-1,6,7,6,6,0,-3,2,5,3,4,1,0,7,20,3,4,7,-1,0,2,1,1,1,1,3,1
KR_6637901295,420,4,21,4,5,3,4,1,7,7,0,-6,1,7,0,6,6,1,1,0,1,12,-6,1,2,3,-1,0,1,1,0,1,1,3,1
KR_6648795455,420,0,-4,4,-2,3,5,2,0,3,3,-1,2,3,-2,0,2,-2,0,2,0,-7,0,-2,8,6,1,0,1,-1,1,1,1,1,1
KR_6734152153,420,0,31,44,2,-1,0,1,4,5,1,6,9,3,-7,0,7,0,1,1,0,-1,6,-1,6,5,7,0,0,1,-1,0,-1,1,1
KR_6670848391,420,3,25,0,9,0,1,1,-4,0,4,5,6,1,8,8,0,0,0,0,1,4,-1,-1,5,4,3,0,0,0,1,1,1,0,1
KR_6759449563,420,-2,51,-16,-2,0,1,1,0,1,1,-1,2,3,1,3,2,-2,0,2,0,-3,1,0,5,5,0,0,0,-1,-1,0,-1,1,1
KR_6729647729,420,-2,-22,13,-2,-1,1,2,1,4,3,-3,4,7,0,1,1,1,2,1,0,-3,61,3,0,3,-18,0,-1,0,0,-1,1,0,1
KR_6683085499,420,3,-3,8,7,6,7,1,3,4,1,0,3,3,-1,1,2,-1,2,3,0,8,-5,2,1,3,2,0,0,1,-1,0,-1,3,1
KR_6723728396,420,0,20,-36,5,-1,2,3,3,3,0,-1,2,3,3,4,1,1,2,1,0,6,52,3,5,8,-18,0,0,0,1,1,1,0,1
KR_6764573837,420,2,79,-4,1,5,8,3,-1,1,2,3,4,1,-5,2,7,-1,1,2,0,-5,-4,-5,7,2,2,0,0,-1,1,1,1,2,1
KR_6719521692,420,4,40,12,9,3,4,1,-4,0,4,6,7,1,4,7,3,0,0,0,2,15,1,3,4,7,5,0,0,1,-1,1,1,4,1
KR_6698260361,420,1,-11,-32,9,9,10,1,0,1,1,3,4,1,0,2,2,-3,0,3,0,3,-5,1,2,3,0,0,0,-1,-1,1,1,5,1
KR_6726191811,420,-2,-38,27,2,-4,1,5,3,7,4,1,3,2,2,4,2,0,0,0,0,6,-41,-3,7,4,8,0,0,0,-1,-1,-1,0,1
KR_6746236204,420,2,79,0,9,2,2,0,2,3,1,4,6,2,-2,2,4,3,6,3,0,5,-4,1,2,3,4,0,0,1,1,1,-1,6,1
KR_6665482701,420,3,47,12,10,5,7,2,2,2,0,6,6,0,-4,0,4,1,1,0,0,5,204,0,3,3,-1,0,0,1,0,0,1,3,1
KR_6327103810,440,0,63,9,-7,-1,2,3,0,1,1,-2,3,5,-4,2,6,0,0,0,0,-14,23,0,4,4,-2,0,0,-1,-1,0,-1,5,1
KR_6759531850,420,1,26,-1,6,2,2,0,6,6,0,3,5,2,-3,4,7,-2,1,3,0,1,3,3,1,4,-3,0,1,-1,-1,1,-1,1,1
KR_6759274885,440,4,35,-10,16,1,1,0,2,2,0,9,10,1,2,4,2,2,3,1,0,14,0,-2,2,0,-4,0,1,1,1,1,1,5,1
KR_6742071492,440,2,76,16,9,-2,4,6,4,6,2,6,8,2,1,2,1,0,0,0,1,-5,2,0,3,3,2,0,0,0,1,0,1,0,1
KR_6767361376,420,7,64,24,23,8,8,0,-1,3,4,5,5,0,5,8,3,6,6,0,0,16,-1,-5,6,1,5,0,3,-1,1,1,1,5,1
KR_6765835068,420,1,-10,-12,3,-1,1,2,2,5,3,2,4,2,-1,3,4,1,1,0,0,4,68,2,4,6,-34,0,0,0,1,0,-1,0,1
KR_6703764316,420,7,86,64,11,4,4,0,2,3,1,2,6,4,1,1,0,2,3,1,0,4,66,-1,3,2,0,0,1,-1,1,1,1,5,1
KR_6761839167,420,0,10,12,6,2,2,0,2,2,0,1,1,0,-1,0,1,2,4,2,0,4,4,0,3,3,-1,0,1,-1,0,1,1,3,1
KR_6731452545,440,-2,-14,8,4,3,3,0,0,1,1,0,3,3,1,2,1,0,1,1,0,8,-5,-1,4,3,3,0,0,1,0,0,1,2,1
KR_6740364076,420,2,32,-8,2,-1,2,3,3,4,1,1,3,2,1,2,1,-2,0,2,0,1,-103,-2,7,5,-1,0,2,1,1,1,1,2,1
KR_6763244508,420,-1,-74,8,-7,-2,1,3,-4,1,5,-2,0,2,1,4,3,0,0,0,0,-3,137,-4,9,5,-1,0,-1,-1,0,-1,-1,1,1
KR_6763210869,420,0,-25,12,-2,1,1,0,-1,2,3,-3,3,6,0,3,3,1,1,0,0,-4,2,0,2,2,-2,0,-1,-1,1,-1,-1,4,1
KR_6706032571,420,2,46,16,-1,-4,2,6,-1,1,2,2,3,1,2,3,1,0,0,0,1,3,13,-1,4,3,-2,0,0,1,-1,-1,1,1,1
KR_6733780733,420,5,110,40,13,0,2,2,2,3,1,6,7,1,5,6,1,0,0,0,1,16,7,4,2,6,0,0,0,1,-1,1,1,3,1
KR_6713871028,440,3,-1,4,9,3,4,1,-3,2,5,4,4,0,4,5,1,1,2,1,0,11,-84,8,1,9,-5,0,0,-1,1,0,1,4,1
KR_6715538696,420,4,15,28,15,3,4,1,2,4,2,5,6,1,0,3,3,5,5,0,0,12,16,-1,4,3,-2,0,3,1,1,1,-1,3,1
KR_6752610283,420,4,54,-4,6,-3,0,3,0,1,1,1,1,0,9,10,1,-1,0,1,0,8,1,0,6,6,6,0,0,1,-1,1,-1,6,1
KR_6756980546,420,2,140,1,11,1,4,3,2,3,1,0,4,4,8,8,0,0,0,0,0,19,1,-5,9,4,2,0,1,-1,1,1,1,3,1
KR_6761436232,440,2,-24,28,6,4,4,0,-2,1,3,2,3,1,1,2,1,1,1,0,0,9,2,-4,7,3,3,0,0,1,-1,0,1,1,1
KR_6625357903,420,4,64,57,7,-1,2,3,4,6,2,5,6,1,0,3,3,-1,0,1,1,1,12,8,2,10,-5,0,3,1,1,1,1,2,1
KR_6749165207,420,-2,2,-8,-5,4,5,1,-5,1,6,-3,0,3,1,5,4,-2,1,3,0,-12,-55,2,2,4,-3,0,-1,1,-1,-1,1,6,1
KR_6695429000,420,3,38,10,8,2,2,0,3,4,1,4,4,0,1,3,2,-2,0,2,2,9,6,1,3,4,0,0,0,1,1,0,1,1,1
KR_6640446314,420,2,-7,43,5,0,2,2,5,9,4,0,2,2,2,6,4,-2,0,2,1,-1,1,4,1,5,1,0,0,1,-1,0,1,2,1
KR_6761060248,420,0,-19,-7,2,2,2,0,0,2,2,-2,0,2,2,3,1,0,1,1,0,2,-89,0,3,3,-2,0,-1,1,-1,1,1,2,1
KR_6759972863,440,8,118,34,13,1,3,2,0,1,1,4,6,2,6,7,1,2,3,1,1,12,3,0,3,3,0,0,2,1,-1,1,1,2,1
KR_6757501247,420,1,5,12,3,-1,3,4,3,3,0,-1,2,3,2,2,0,0,0,0,0,4,1,1,2,3,2,0,1,-1,1,1,1,4,1
KR_5944444538,420,5,7,-13,16,0,3,3,2,4,2,4,5,1,6,6,0,4,4,0,0,22,12,3,3,6,0,0,1,1,0,1,-1,5,1
KR_6741230370,420,1,-22,-24,5,4,5,1,0,1,1,-3,0,3,2,3,1,2,2,0,0,5,10,0,4,4,2,0,-1,1,-1,-1,-1,2,1
KR_6758426234,420,0,8,11,0,0,2,2,2,4,2,2,3,1,-1,4,5,-3,0,3,1,5,7,0,6,6,0,0,-1,1,-1,-1,1,6,1
KR_6652457175,420,4,56,11,7,1,2,1,0,2,2,2,3,1,4,4,0,0,0,0,0,9,-131,-2,4,2,3,0,1,-1,1,1,1,2,1
KR_6766821222,420,4,98,-1,1,-2,2,4,1,2,1,-3,0,3,4,8,4,1,1,0,0,5,-21,-1,5,4,-6,0,0,0,1,0,1,0,1
KR_6766086160,440,1,-49,-28,2,2,3,1,-1,3,4,0,2,2,1,3,2,0,5,5,0,1,-4,-4,5,1,-2,0,0,1,-1,0,-1,4,1
KR_6762408781,420,3,54,16,9,-6,0,6,6,7,1,1,4,3,7,7,0,1,1,0,1,22,-27,2,3,5,3,0,2,1,1,1,1,5,1
KR_6754825641,420,-1,-7,-24,5,1,6,5,1,1,0,-2,0,2,5,6,1,0,0,0,0,2,4,-2,5,3,1,0,1,1,-1,1,1,2,1
KR_6748616581,420,-4,-30,-10,-6,-3,0,3,1,4,3,-2,1,3,-2,2,4,0,0,0,0,-4,405,1,2,3,1,0,-1,0,0,-1,1,0,1
KR_6676445865,420,1,35,21,7,-5,1,6,4,4,0,3,4,1,6,8,2,-1,0,1,0,14,35,1,3,4,1,0,2,1,1,1,1,4,1
KR_6678139014,420,2,13,11,0,-1,1,2,1,3,2,-4,2,6,5,6,1,-1,0,1,0,5,-27,1,2,3,4,0,1,0,-1,1,-1,0,1
KR_6758111947,420,-2,25,12,-3,-3,0,3,0,2,2,1,3,2,-1,4,5,0,0,0,0,-11,8,1,3,4,-2,0,1,0,1,1,1,0,1
KR_6765665755,420,4,37,24,11,1,5,4,-3,3,6,7,7,0,4,4,0,2,3,1,0,1,16,2,0,2,-2,0,1,0,1,1,1,0,1
KR_6667714357,420,1,0,8,7,3,3,0,7,7,0,-1,1,2,-2,1,3,0,0,0,1,11,13,6,5,11,0,0,0,1,1,-1,1,1,1
KR_6761521076,440,1,33,-24,2,8,8,0,-1,0,1,3,3,0,-7,0,7,-1,0,1,0,2,-43,-2,6,4,6,0,0,-1,-1,1,-1,1,1
KR_6755142892,420,6,109,-7,15,8,9,1,4,4,0,9,9,0,-5,1,6,-1,1,2,0,15,-7,-1,3,2,0,0,1,1,1,1,1,2,1
KR_6762642536,440,0,-39,-5,0,3,4,1,-1,1,2,-2,2,4,1,3,2,-1,1,2,0,-4,-23,0,3,3,1,0,1,1,1,1,-1,2,1
KR_6649136455,420,8,64,37,7,-1,1,2,1,5,4,3,3,0,2,3,1,2,2,0,0,8,28,-3,7,4,5,0,2,1,1,1,1,5,1
KR_6726988874,440,1,9,-8,5,1,2,1,3,3,0,-4,0,4,0,1,1,5,5,0,0,9,-2,-1,3,2,-1,0,0,1,0,0,1,4,1
KR_6733006346,440,7,62,4,14,4,6,2,1,2,1,-1,1,2,8,9,1,2,4,2,-1,12,11,1,2,3,3,0,2,1,-1,1,-1,5,1
KR_6694945115,420,2,47,-4,4,3,3,0,1,3,2,-1,4,5,3,3,0,-2,3,5,0,4,404,0,3,3,2,0,1,1,1,1,1,3,1
KR_6756399271,420,-1,28,16,6,1,3,2,1,4,3,2,3,1,0,1,1,2,2,0,0,8,6,1,6,7,-1,0,1,-1,1,1,1,3,1
KR_6765521204,420,1,24,12,1,0,0,0,1,3,2,-1,1,2,1,2,1,0,1,1,0,1,26,1,0,1,-3,0,1,0,1,1,-1,0,1
KR_6697445380,420,1,37,-20,-2,1,3,2,-2,4,6,0,1,1,0,4,4,-1,1,2,0,7,4,3,3,6,-4,0,0,-1,-1,0,1,5,1
KR_6763203564,440,0,22,4,2,1,1,0,-1,1,2,-2,1,3,1,1,0,3,3,0,0,3,-4,-1,4,3,2,0,2,1,1,1,1,3,1
KR_6736829589,420,3,45,2,9,3,3,0,1,3,2,2,3,1,0,0,0,3,3,0,0,3,-43,-1,10,9,20,0,2,1,1,1,1,1,1
KR_6630547203,420,0,9,-4,-1,-2,1,3,0,2,2,2,2,0,-1,3,4,0,1,1,0,1,1,4,4,8,-4,0,0,1,-1,0,1,1,1
KR_6707849974,420,-1,-86,28,-2,-2,1,3,-3,3,6,0,3,3,2,4,2,1,2,1,0,0,-303,-2,7,5,-3,0,0,1,1,0,-1,6,1
KR_6661384003,420,5,70,20,10,0,0,0,1,3,2,1,1,0,8,8,0,0,3,3,0,7,27,4,2,6,-4,0,1,-1,1,1,1,3,1
KR_6664928808,420,2,23,12,5,1,2,1,3,4,1,2,3,1,-1,0,1,0,0,0,0,-1,8,2,6,8,1,0,1,-1,1,1,1,5,1
KR_6766051144,420,1,-13,4,-1,3,4,1,3,3,0,-5,0,5,-2,0,2,0,1,1,0,-3,-9,-3,6,3,5,0,0,-1,0,0,1,2,1
KR_6701962468,420,1,50,0,11,3,5,2,1,4,3,1,3,2,6,8,2,0,1,1,-1,11,2,-3,5,2,-1,0,1,-1,-1,1,-1,3,1
KR_6761550707,420,1,58,0,-5,1,2,1,-6,1,7,3,3,0,-3,3,6,0,1,1,-1,-9,12,-8,8,0,0,0,0,-1,0,0,-1,4,1
KR_6732427991,420,2,108,-8,9,-4,1,5,0,1,1,6,7,1,5,6,1,2,2,0,1,11,-2,1,5,6,4,0,0,1,-1,1,1,4,1
KR_6705583855,420,3,102,-12,14,5,6,1,7,7,0,3,5,2,1,3,2,-2,0,2,2,15,7,-1,6,5,-2,0,1,1,-1,1,1,6,1
KR_6708699634,440,3,66,1,10,0,2,2,2,2,0,-1,1,2,6,6,0,3,4,1,0,2,18,2,5,7,-2,0,2,1,1,1,1,2,1
KR_6655767434,420,3,-4,-16,12,2,3,1,-1,0,1,1,1,0,5,5,0,5,5,0,1,23,-3,3,3,6,1,0,0,1,-1,1,1,4,1
KR_6549009215,420,1,3,0,0,-1,1,2,0,7,7,0,1,1,0,3,3,1,1,0,-1,6,-19,-1,6,5,5,0,-1,1,-1,-1,1,3,1
KR_6695393792,420,1,-2,44,3,1,2,1,4,5,1,-2,4,6,1,3,2,-1,0,1,0,7,-1,0,2,2,3,0,0,0,0,0,-1,0,1
KR_6666285394,420,5,73,44,11,-1,3,4,1,2,1,3,4,1,4,6,2,4,4,0,0,9,-7,-1,4,3,-1,0,1,-1,0,1,1,2,1
KR_6756915318,420,2,90,28,8,4,4,0,-2,3,5,6,8,2,1,4,3,-1,0,1,3,-8,3,3,2,5,4,0,1,1,1,1,1,3,1
KR_6649107250,420,9,126,24,18,4,4,0,1,7,6,5,5,0,6,8,2,2,3,1,0,11,-8,-3,7,4,4,0,1,1,-1,1,-1,6,1
KR_6745700506,420,-2,-60,12,-1,-3,0,3,-5,1,6,3,4,1,5,7,2,-1,0,1,0,2,12,-6,10,4,1,0,1,1,1,-1,1,1,1
KR_6756795489,420,-2,19,0,0,3,3,0,2,4,2,-3,2,5,0,3,3,-2,1,3,1,3,1,0,6,6,6,0,-1,-1,-1,-1,1,5,1
KR_6742530111,440,4,6,15,2,-3,1,4,-1,2,3,1,2,1,5,5,0,0,0,0,0,10,12,-1,5,4,0,0,0,1,-1,-1,1,1,1
KR_6672827234,420,0,37,-28,-5,-1,0,1,-5,3,8,-2,1,3,3,5,2,0,1,1,0,0,8,1,6,7,-1,0,0,1,-1,0,-1,1,1
KR_6745147906,420,-1,-12,-16,1,4,7,3,-3,0,3,-1,0,1,2,3,1,-1,1,2,0,3,102,8,1,9,-9,0,2,-1,1,1,-1,5,1
KR_6737892548,420,1,-22,16,5,0,1,1,-1,2,3,-2,0,2,2,3,1,6,6,0,0,5,-10,-1,5,4,3,0,1,1,1,1,1,5,1
KR_6338250071,420,2,25,28,3,-1,1,2,3,6,3,3,3,0,-1,4,5,-1,0,1,0,0,8,1,4,5,2,0,0,1,-1,0,1,3,1
KR_6761092252,420,3,39,20,5,1,1,0,2,5,3,0,1,1,3,4,1,-1,1,2,0,7,-4,-4,9,5,0,0,2,1,1,1,-1,5,1
KR_6767683954,420,4,10,-8,2,-2,0,2,1,2,1,0,1,1,2,3,1,1,2,1,0,3,11,1,5,6,-3,0,0,1,1,0,1,5,1
KR_6734427444,420,4,57,-4,12,1,2,1,5,7,2,7,8,1,0,3,3,-1,0,1,0,13,-14,1,6,7,7,0,1,-1,1,1,1,5,1
KR_6706398413,420,4,-44,96,1,-2,0,2,2,2,0,0,3,3,2,4,2,-1,0,1,0,7,-3,1,3,4,-1,0,-1,1,0,-1,-1,2,1
KR_6767017019,420,3,50,1,6,6,6,0,4,5,1,-5,0,5,-1,1,2,2,2,0,0,0,-6,-2,4,2,-2,0,-1,1,-1,-1,-1,4,1
KR_6720392267,420,4,13,28,3,-2,2,4,2,2,0,-1,2,3,0,1,1,4,4,0,1,9,68,-4,7,3,-11,0,0,1,-1,1,1,3,1
KR_6612645814,440,1,40,24,-1,0,1,1,-3,1,4,3,5,2,0,0,0,-1,0,1,0,-3,6,-1,4,3,-1,0,0,1,-1,0,-1,4,1
KR_6755746428,420,0,7,-24,3,1,2,1,-1,1,2,4,5,1,-1,0,1,0,0,0,0,-3,-24,1,2,3,1,0,1,-1,1,1,1,3,1
KR_6729085562,420,-1,19,-5,2,-4,0,4,-1,4,5,5,6,1,0,5,5,2,3,1,1,7,1,2,5,7,-6,0,0,1,-1,1,1,5,1
KR_6635246359,420,5,50,4,9,5,7,2,5,7,2,-3,2,5,2,5,3,0,1,1,0,11,12,5,4,9,0,0,1,1,-1,1,1,1,1
KR_6735099557,420,2,-20,-22,6,1,1,0,6,6,0,-3,1,4,1,3,2,1,1,0,0,7,3,1,2,3,-2,0,1,-1,1,1,-1,1,1
KR_6752427795,420,-2,-9,-4,-10,0,5,5,0,4,4,-3,2,5,-8,0,8,1,2,1,0,-7,-18,-2,6,4,3,0,0,1,0,0,1,6,1
KR_6365697683,420,3,25,-25,7,1,2,1,3,4,1,3,5,2,1,1,0,-1,0,1,0,8,0,0,0,0,0,0,2,-1,1,1,-1,4,1
KR_6741814248,420,5,62,16,3,1,3,2,-3,1,4,5,6,1,0,0,0,0,0,0,-2,-4,-1,3,3,6,-2,0,1,1,1,1,-1,6,1
KR_6722273190,420,2,-59,12,9,3,4,1,1,3,2,-4,1,5,9,9,0,0,0,0,0,9,16,7,0,7,-1,0,1,1,0,1,-1,4,1
KR_6751245898,420,5,0,44,12,3,4,1,2,5,3,3,6,3,4,4,0,0,0,0,0,11,-25,1,4,5,2,0,1,0,1,1,-1,0,1
KR_6741186682,420,1,19,12,0,-4,0,4,-4,1,5,5,5,0,3,6,3,0,1,1,0,-3,-4,3,5,8,-1,0,0,-1,1,1,-1,1,1
KR_6614101832,440,1,-26,-28,8,0,0,0,4,7,3,0,1,1,3,3,0,1,1,0,0,10,-5,0,5,5,3,0,0,0,1,1,1,0,1
KR_6721025490,440,3,44,3,3,-1,1,2,3,4,1,2,6,4,0,2,2,-1,1,2,0,4,-10,1,7,8,0,0,0,1,1,0,1,4,1
KR_6727076147,420,3,66,0,4,7,8,1,2,3,1,-3,0,3,0,5,5,-2,2,4,-1,4,-26,3,4,7,-5,0,0,1,1,1,-1,4,1
KR_6761561816,420,-1,16,-8,-5,2,3,1,-5,0,5,-2,0,2,-1,0,1,1,1,0,0,-5,-39,3,3,6,5,0,0,1,1,0,-1,5,1
KR_6642044989,420,8,73,-5,20,4,5,1,2,4,2,6,6,0,8,8,0,0,0,0,0,17,25,5,3,8,1,0,1,1,-1,1,1,3,1
KR_6720654408,420,3,21,-19,5,3,4,1,1,4,3,1,4,3,-2,3,5,2,3,1,0,2,-85,1,4,5,0,0,0,1,-1,1,1,4,1
KR_6762605329,440,1,26,-4,-3,-2,0,2,-1,3,4,1,1,0,0,1,1,-1,0,1,0,1,-30,-2,6,4,16,0,0,-1,-1,0,-1,2,1
KR_6761792094,420,5,41,4,10,2,5,3,7,7,0,2,2,0,0,1,1,-1,0,1,1,9,32,0,3,3,-22,0,1,1,1,1,1,5,1
KR_6767466546,420,-3,-77,-34,-4,2,5,3,1,2,1,-1,3,4,-2,4,6,-4,0,4,-1,1,-6,4,0,4,-1,0,-1,-1,1,-1,-1,5,1
KR_6730054607,440,2,27,-15,-2,-4,0,4,-1,2,3,3,6,3,1,1,0,-1,3,4,0,2,5,-2,5,3,1,0,-1,1,-1,-1,-1,6,1
KR_6760444121,440,5,85,35,11,-1,1,2,0,2,2,1,4,3,4,5,1,7,8,1,0,11,6,8,3,11,-1,0,0,1,1,0,-1,6,1
KR_6728263544,420,3,18,-8,7,3,4,1,0,3,3,2,4,2,0,5,5,2,3,1,-1,8,17,-3,9,6,0,0,0,-1,1,0,-1,5,1
KR_6658708947,440,1,-33,2,3,-2,0,2,6,7,1,-1,3,4,0,1,1,0,1,1,0,3,-31,-2,4,2,28,0,0,0,0,0,1,0,1
KR_6757423390,420,0,25,29,1,2,2,0,-1,1,2,-1,1,2,2,5,3,-1,0,1,2,7,-7,4,3,7,-1,0,0,1,-1,0,-1,2,1
KR_6713007804,420,3,56,16,9,6,6,0,4,7,3,-3,0,3,1,3,2,1,2,1,1,4,-4,2,7,9,0,0,3,1,1,1,1,3,1
KR_6762984949,420,-1,-15,-16,0,-2,0,2,3,4,1,-2,1,3,2,4,2,-1,0,1,0,1,-7,-2,10,8,5,0,0,-1,1,0,1,6,1
KR_6624724071,420,4,4,-12,13,3,4,1,9,11,2,1,3,2,0,3,3,0,2,2,0,11,7,0,7,7,-2,0,1,-1,-1,1,-1,3,1
KR_6723122536,420,6,24,-16,13,0,1,1,0,1,1,3,3,0,7,8,1,3,3,0,1,10,4,0,4,4,-6,0,0,1,1,1,1,2,1
KR_6650113445,420,0,25,-16,-2,2,3,1,-4,0,4,-1,0,1,0,0,0,1,1,0,0,0,6,0,5,5,1,0,1,1,-1,1,-1,3,1
KR_6745406362,420,5,67,3,7,0,1,1,1,4,3,0,0,0,4,7,3,2,2,0,0,7,-93,6,3,9,-1,0,0,1,1,1,-1,2,1
KR_6751725416,420,3,90,-68,11,4,5,1,-2,0,2,1,4,3,4,5,1,4,6,2,0,1,-29,1,4,5,1,0,2,-1,-1,1,-1,5,1
KR_6612562766,420,1,-6,0,3,-2,1,3,-4,2,6,4,7,3,1,1,0,4,4,0,-1,1,-12,-3,5,2,-1,0,1,1,1,1,-1,6,1
KR_6764791566,440,1,27,20,-2,1,5,4,1,2,1,3,3,0,-4,0,4,-3,0,3,0,-7,-4,-1,4,3,-3,0,1,-1,1,1,-1,5,1
KR_6761637891,420,-3,35,6,-7,0,1,1,-5,2,7,0,4,4,-2,6,8,0,1,1,0,-10,-24,1,2,3,2,0,0,-1,-1,0,-1,2,1
KR_6737713375,420,1,-6,6,-1,-1,0,1,3,8,5,0,3,3,-3,1,4,0,0,0,0,-6,-15,-3,7,4,-1,0,0,-1,1,1,-1,5,1
KR_6742046676,440,2,-22,31,-1,3,4,1,1,2,1,-2,1,3,-2,3,5,-1,0,1,0,-1,-14,3,3,6,1,0,1,1,0,1,1,2,1
KR_6764605818,420,-2,50,0,-5,-4,1,5,-1,0,1,-1,2,3,1,3,2,0,4,4,0,0,8,5,2,7,-5,0,-1,1,1,-1,1,3,1
KR_6766829506,420,3,80,0,12,-2,0,2,3,3,0,4,4,0,0,0,0,7,7,0,0,14,-7,3,4,7,-1,0,0,1,-1,-1,1,3,1
KR_6638776708,420,-3,-13,-20,-2,-2,0,2,4,5,1,-1,1,2,-1,1,2,-2,2,4,-1,-2,19,-1,3,2,-2,0,0,1,-1,0,-1,1,1
KR_6763163561,440,4,62,46,10,-2,1,3,2,4,2,6,6,0,4,6,2,0,0,0,0,8,-208,-5,6,1,2,0,3,-1,1,1,1,6,1
KR_6766966294,420,1,-56,16,6,1,2,1,0,1,1,2,4,2,-2,0,2,5,5,0,-1,5,-53,-1,3,2,22,0,-2,-1,0,-1,-1,1,1
KR_6755051558,420,1,15,23,-4,-2,0,2,-2,0,2,0,5,5,0,1,1,0,3,3,0,-9,13,-5,5,0,-2,0,0,-1,1,1,-1,3,1
KR_6767797820,420,2,123,26,6,0,2,2,6,6,0,0,3,3,0,2,2,0,0,0,0,4,41,4,3,7,5,0,3,1,1,1,1,2,1
KR_6764742278,420,0,67,24,-2,1,3,2,-1,2,3,-4,0,4,4,5,1,-2,0,2,0,-3,3,-4,9,5,2,0,1,-1,1,1,-1,2,1
KR_6634885664,420,3,7,16,3,-1,0,1,3,3,0,1,1,0,0,1,1,0,1,1,0,7,-31,-3,6,3,1,0,1,1,1,1,-1,1,1
KR_6763363317,440,2,61,29,4,-2,1,3,3,4,1,-2,1,3,2,3,1,3,6,3,0,1,-66,-1,6,5,28,0,1,1,0,1,1,4,1
KR_6724787942,420,2,66,4,11,4,6,2,2,5,3,4,6,2,-1,2,3,2,2,0,0,-8,5,3,1,4,-1,0,2,1,1,1,1,4,1
KR_6767478221,420,4,70,-5,10,1,2,1,4,6,2,5,6,1,0,2,2,0,1,1,0,6,3,3,5,8,-2,0,2,-1,1,1,1,6,1
KR_6722105073,420,4,-1,8,6,3,3,0,4,7,3,-2,1,3,0,1,1,1,3,2,0,6,-7,2,1,3,2,0,1,-1,1,1,1,6,1
KR_6765461716,440,2,50,9,8,0,0,0,-5,1,6,0,2,2,6,7,1,7,7,0,0,10,-11,-2,11,9,3,0,1,0,1,1,1,0,1
KR_6748138896,420,4,104,24,15,3,3,0,6,8,2,7,7,0,-2,2,4,1,1,0,0,8,23,-4,6,2,4,0,2,1,1,1,1,6,1
KR_6735280824,420,0,50,-16,6,-1,0,1,1,3,2,0,1,1,6,6,0,0,1,1,1,8,18,1,1,2,0,0,1,-1,1,1,1,3,1
KR_6765860197,420,-2,-41,12,-1,1,1,0,3,3,0,-3,2,5,-1,2,3,-1,1,2,0,2,-1,-3,5,2,-1,0,-2,-1,-1,-1,-1,5,1
KR_6751705792,420,0,-31,-36,6,-3,0,3,3,3,0,0,2,2,4,6,2,2,2,0,0,12,32,0,5,5,-24,0,0,1,-1,0,-1,5,1
KR_6755098740,420,2,48,22,0,3,5,2,-1,1,2,-1,3,4,-2,1,3,1,1,0,0,-5,142,-2,5,3,3,0,0,1,-1,0,1,6,1
KR_6697936214,420,-3,-48,-4,-4,0,1,1,1,4,3,-2,0,2,-1,1,2,-2,0,2,0,-2,11,-2,4,2,-5,0,0,0,1,0,-1,0,1
KR_6651799722,420,4,59,16,7,3,3,0,3,7,4,2,2,0,-2,1,3,1,2,1,0,1,-1,-2,3,1,2,0,1,-1,1,1,1,5,1
KR_6719260431,420,4,1,13,11,2,5,3,-1,1,2,9,11,2,-1,2,3,2,3,1,1,8,-1,-5,8,3,-1,0,1,1,0,1,1,3,1
KR_6749027139,420,3,40,-24,11,3,3,0,0,2,2,4,4,0,0,2,2,4,4,0,0,5,-32,-1,5,4,8,0,1,1,0,1,1,4,1
KR_6751006464,440,0,-9,0,3,0,1,1,-1,1,2,3,6,3,2,4,2,-1,0,1,0,3,17,-3,5,2,2,0,2,1,1,1,1,6,1
KR_6658662540,420,-2,-12,-34,-3,-1,0,1,1,4,3,5,6,1,-5,0,5,-3,0,3,0,-5,388,0,3,3,-3,0,0,-1,1,1,-1,6,1
KR_6653795828,420,4,120,4,0,0,3,3,-2,2,4,3,3,0,-3,1,4,2,3,1,0,-7,42,-3,5,2,-24,0,2,1,1,1,1,2,1
KR_6747743827,420,4,-11,3,5,-1,2,3,4,6,2,-1,1,2,2,4,2,1,1,0,-2,-1,13,3,1,4,-1,0,1,0,-1,1,-1,0,1
KR_6655829151,420,-3,-39,0,2,-3,0,3,1,3,2,-1,0,1,3,3,0,2,2,0,0,10,6,-1,2,1,2,0,0,1,-1,-1,1,5,1
KR_6677672698,420,-3,-51,0,-9,-6,1,7,-1,3,4,3,5,2,-1,1,2,-4,0,4,0,-12,28,1,3,4,0,0,-1,1,-1,-1,1,5,1
KR_6765710168,420,3,49,9,1,1,4,3,3,7,4,2,2,0,-2,2,4,-3,0,3,0,-9,10,2,3,5,-2,0,0,1,1,1,-1,1,1
KR_6733835206,440,4,54,19,13,1,2,1,3,7,4,10,10,0,-1,4,5,0,2,2,0,8,-42,5,1,6,3,0,1,1,1,1,1,3,1
KR_6649326221,420,2,96,-20,-2,0,2,2,-1,2,3,-1,1,2,2,3,1,-2,1,3,0,-1,-28,3,3,6,5,0,0,1,-1,0,-1,1,1
KR_6648051285,420,0,0,28,0,-2,3,5,3,4,1,2,2,0,-3,0,3,0,0,0,-1,-8,21,-3,4,1,0,0,0,-1,1,0,-1,5,1
KR_6750332521,420,5,70,17,6,1,2,1,1,7,6,0,2,2,4,4,0,0,0,0,0,17,9,-2,4,2,7,0,1,1,-1,1,-1,4,1
KR_6738846452,440,3,30,23,5,3,4,1,0,4,4,1,1,0,2,4,2,-1,0,1,0,4,0,4,1,5,3,0,0,1,1,0,-1,3,1
KR_6673920628,420,-1,-19,20,-2,0,3,3,-1,1,2,-2,2,4,2,3,1,-1,1,2,0,-9,-104,-1,5,4,-2,0,0,1,-1,0,-1,1,1
KR_6632870467,420,2,-20,16,0,0,0,0,0,2,2,1,4,3,0,2,2,-1,0,1,0,0,1,1,3,4,0,0,1,1,1,1,1,4,1
KR_6767448000,420,-2,-10,-22,-3,-2,1,3,-4,1,5,0,0,0,5,9,4,-2,1,3,0,-2,-111,-3,4,1,-3,0,0,0,0,-1,-1,0,1
KR_6733685514,420,-3,-1,-12,-1,-3,0,3,2,3,1,-1,0,1,-2,2,4,3,3,0,0,2,-3,1,3,4,2,0,1,1,-1,1,1,3,1
KR_6761988877,420,3,57,16,4,4,5,1,1,2,1,-1,1,2,0,3,3,0,2,2,0,-1,-2,-3,8,5,-2,0,1,0,1,1,1,0,1
KR_6672659667,420,1,26,-4,9,0,2,2,1,3,2,6,7,1,2,3,1,0,0,0,0,19,-6,4,3,7,0,0,1,1,-1,1,-1,2,1
KR_6748832436,420,3,24,0,7,2,4,2,3,3,0,1,5,4,1,1,0,0,0,0,0,14,-22,4,4,8,7,0,0,0,1,0,1,0,1
KR_6747871554,440,-1,-31,0,-3,-2,2,4,2,4,2,1,4,3,-7,1,8,3,3,0,-1,-1,42,4,1,5,0,0,-1,-1,1,-1,-1,3,1
KR_6765249738,420,0,31,-19,1,-6,0,6,4,4,0,1,1,0,3,3,0,-1,1,2,1,8,10,-3,5,2,1,0,-2,1,-1,-1,1,1,1
KR_6731418170,420,3,27,32,6,4,8,4,0,4,4,0,4,4,2,2,0,0,3,3,0,-8,14,-1,2,1,2,0,1,1,1,1,-1,2,1
KR_6730000743,440,4,87,28,9,-1,2,3,6,8,2,4,4,0,2,6,4,-2,4,6,0,5,4,3,4,7,1,0,3,0,1,1,-1,0,1
KR_6756551127,420,-2,-65,16,0,-6,0,6,6,6,0,1,2,1,-1,1,2,0,1,1,0,2,-132,-3,5,2,3,0,-1,1,1,-1,-1,5,1
KR_6757369179,420,4,-59,1,13,1,2,1,2,3,1,4,5,1,0,4,4,6,8,2,2,11,1,1,3,4,1,0,0,1,0,0,1,3,1
KR_6749195025,420,1,53,-16,0,-2,1,3,-4,1,5,2,4,2,3,5,2,1,1,0,1,0,0,1,3,4,-3,0,1,-1,1,1,1,2,1
KR_6723237353,440,-1,-60,8,1,1,2,1,-4,2,6,0,1,1,-1,3,4,5,5,0,1,4,11,-3,6,3,-5,0,-1,0,-1,-1,1,0,1
KR_6642957277,420,-1,-6,28,-8,6,6,0,-5,0,5,-4,0,4,-2,3,5,-3,2,5,-1,-19,-9,0,7,7,1,0,2,-1,1,1,-1,1,1
KR_6672670858,420,6,52,38,9,3,3,0,0,3,3,4,5,1,2,4,2,0,0,0,0,8,-24,1,2,3,0,0,0,1,0,0,1,1,1
KR_6746302931,420,3,36,32,-3,0,2,2,1,5,4,0,1,1,-3,1,4,-1,0,1,0,-8,-2,3,4,7,3,0,1,1,1,1,-1,5,1
KR_6633006308,420,-2,9,24,-4,1,1,0,0,1,1,-3,1,4,0,2,2,-2,0,2,0,-7,-206,2,6,8,4,0,0,1,-1,0,1,1,1
KR_6689309938,420,3,66,12,17,2,5,3,4,7,3,8,8,0,2,5,3,1,3,2,3,20,-3,1,3,4,2,0,-1,1,-1,-1,1,1,1
KR_6759997836,420,8,85,31,16,0,1,1,4,7,3,8,8,0,2,3,1,2,2,0,0,10,-3,-3,5,2,3,0,3,-1,1,1,-1,1,1
KR_6746000943,420,1,-15,-3,2,2,2,0,2,2,0,-3,4,7,1,1,0,0,1,1,0,9,-12,0,5,5,-7,0,-1,-1,-1,-1,-1,2,1
KR_6739057008,420,4,105,-12,19,3,3,0,4,5,1,5,7,2,3,3,0,4,4,0,0,15,-3,2,6,8,0,0,1,1,1,1,1,5,1
KR_6758099987,420,-2,-5,-40,2,-1,0,1,0,0,0,1,1,0,3,3,0,-1,1,2,0,3,-3,1,4,5,2,0,0,-1,1,0,1,2,1
KR_6720329806,420,5,45,20,6,0,1,1,3,4,1,0,2,2,2,3,1,1,3,2,0,4,-8,-2,5,3,6,0,0,1,1,0,1,6,1
KR_6618181733,420,1,-1,12,-1,0,1,1,0,1,1,-2,0,2,0,3,3,1,1,0,0,-2,-10,-6,10,4,0,0,0,1,1,0,-1,3,1
KR_6764201179,420,0,-5,16,-2,-3,2,5,-1,0,1,3,4,1,-2,0,2,1,1,0,0,0,-2,-2,5,3,4,0,1,-1,1,1,-1,1,1
KR_6757669652,440,-1,-31,-7,-7,-4,0,4,0,2,2,3,4,1,1,3,2,-7,1,8,-1,-7,13,5,0,5,-3,0,0,0,-1,-1,-1,0,1
KR_6724966137,440,-3,-2,-1,-12,-2,1,3,0,3,3,-6,1,7,-2,0,2,-2,0,2,0,-13,-9,-3,5,2,5,0,-1,0,-1,-1,-1,0,1
KR_6749884241,420,3,-16,49,0,4,5,1,-3,0,3,-4,1,5,1,3,2,2,3,1,0,-4,18,1,2,3,-3,0,1,0,0,1,1,0,1
KR_6672006534,420,4,74,4,12,1,2,1,3,5,2,5,6,1,3,4,1,0,0,0,0,16,7,8,1,9,0,0,2,1,-1,1,-1,3,1
KR_6654542024,420,0,78,-5,0,-1,1,2,2,5,3,-1,1,2,0,1,1,0,1,1,2,0,3,-1,4,3,-2,0,0,1,-1,1,1,2,1
KR_6760776465,440,-2,21,1,-4,4,5,1,1,2,1,0,1,1,-3,1,4,-6,0,6,1,0,5,5,3,8,-6,0,-2,0,0,-1,1,0,1
KR_6631764933,420,6,28,20,16,7,7,0,0,2,2,3,3,0,2,3,1,4,4,0,0,5,1,2,6,8,7,0,2,1,1,1,1,4,1
KR_6327167471,440,0,74,23,2,3,6,3,-1,0,1,3,5,2,-4,1,5,1,2,1,1,-9,-11,-2,6,4,-6,0,4,1,1,1,1,6,1
KR_6744717100,420,1,44,4,7,6,7,1,-4,1,5,0,2,2,2,4,2,3,4,1,0,-5,296,3,2,5,1,0,2,-1,1,1,1,1,1
KR_6766962720,420,1,18,0,2,2,2,0,7,8,1,-4,4,8,-4,1,5,1,2,1,0,2,-8,-2,5,3,3,0,0,-1,-1,0,1,6,1
KR_6767319774,420,2,15,4,2,-2,1,3,0,0,0,1,1,0,4,4,0,-1,0,1,0,2,-20,1,3,4,3,0,1,1,-1,1,-1,5,1
KR_6762302892,420,8,65,18,10,5,5,0,4,4,0,3,5,2,-1,1,2,-1,1,2,-1,6,11,-2,4,2,3,0,0,0,1,0,-1,0,1
KR_6730985864,420,2,3,-12,0,-1,3,4,-2,1,3,4,7,3,1,5,4,-2,0,2,-2,-6,-188,5,3,8,7,0,0,0,-1,-1,-1,0,1
KR_6749576021,440,4,41,26,7,-1,1,2,1,3,2,6,7,1,2,4,2,-1,0,1,0,6,6,4,1,5,-2,0,0,1,1,0,-1,5,1
KR_6731742032,420,2,49,-26,4,2,4,2,1,1,0,-1,1,2,4,5,1,-2,1,3,1,0,12,-1,5,4,-4,0,1,1,-1,1,1,1,1
KR_6717011237,420,1,5,8,2,3,3,0,-3,2,5,2,2,0,-2,1,3,2,3,1,0,5,7,8,1,9,4,0,1,1,-1,1,1,5,1
KR_6754544290,440,3,9,12,1,5,6,1,-4,2,6,3,6,3,0,4,4,-3,0,3,0,-7,-5,-1,5,4,0,0,1,0,1,1,1,0,1
KR_6760283645,440,0,20,-9,1,-4,1,5,-1,3,4,2,6,4,8,8,0,-4,4,8,0,2,-20,1,3,4,-2,0,0,1,-1,1,1,6,1
KR_6713741269,420,3,39,19,-1,-1,1,2,1,7,6,0,4,4,-1,2,3,0,0,0,0,-10,4,-7,7,0,4,0,0,1,1,-1,-1,2,1
KR_6646207141,420,6,75,19,12,3,3,0,3,6,3,3,3,0,2,3,1,1,3,2,0,10,-2,-1,4,3,1,0,2,1,1,1,1,5,1
KR_6762280919,440,2,-4,17,6,0,1,1,2,2,0,1,2,1,2,3,1,1,2,1,1,9,4,-2,3,1,-1,0,1,1,-1,1,1,1,1
KR_6732701739,420,5,94,25,17,1,3,2,10,11,1,2,2,0,2,3,1,2,2,0,0,9,4,1,2,3,5,0,2,1,1,1,1,3,1
KR_6743408691,420,4,134,15,0,3,3,0,1,3,2,-5,3,8,-4,0,4,5,5,0,3,-3,16,1,4,5,-1,0,2,1,1,1,1,6,1
KR_6748818498,440,2,-49,3,8,1,1,0,3,3,0,4,5,1,0,0,0,0,0,0,0,6,14,2,4,6,4,0,0,1,1,0,1,4,1
KR_6743328498,420,4,87,32,13,5,6,1,-1,3,4,3,3,0,6,8,2,0,0,0,0,9,50,5,3,8,-16,0,1,-1,1,1,1,2,1
KR_6763456900,440,0,-38,9,2,-1,1,2,1,3,2,1,2,1,-1,3,4,2,2,0,2,6,14,1,3,4,1,0,0,1,1,0,1,5,1
KR_6764561075,420,0,-43,-12,7,1,1,0,3,3,0,4,6,2,0,2,2,-1,1,2,0,16,-3,1,4,5,4,0,-1,1,-1,-1,1,3,1
KR_6760706011,420,2,-35,45,1,2,2,0,1,3,2,3,3,0,-5,0,5,0,0,0,0,-1,-3,-4,10,6,-1,0,0,-1,1,0,-1,1,1
KR_6745315764,420,3,89,-4,4,4,5,1,-5,0,5,3,4,1,0,1,1,2,2,0,0,-1,-7,-1,6,5,4,0,1,1,1,1,-1,4,1
KR_6633134163,420,0,8,-14,0,1,1,0,-3,2,5,-1,2,3,3,4,1,0,1,1,0,1,6,1,2,3,0,0,1,-1,-1,1,1,5,1
KR_6757185608,420,0,36,4,-9,-4,0,4,-1,3,4,-5,0,5,0,4,4,1,1,0,-1,2,1,-1,3,2,-1,0,0,1,-1,-1,-1,4,1
KR_6760495719,440,3,40,18,12,2,3,1,7,7,0,4,4,0,4,5,1,-5,0,5,0,3,-1,-2,7,5,5,0,1,-1,1,1,1,5,1
KR_6534555814,420,2,-18,28,2,-5,1,6,2,5,3,2,4,2,3,3,0,0,1,1,0,0,132,1,3,4,6,0,0,1,-1,1,-1,1,1
KR_6762489011,420,4,-12,26,11,5,5,0,-1,3,4,4,5,1,3,3,0,0,0,0,0,8,-7,-3,7,4,3,0,1,1,1,1,-1,3,1
KR_6764486113,420,-4,-65,-28,-6,-2,0,2,2,4,2,-2,0,2,2,4,2,-6,1,7,0,-1,2,-2,6,4,-4,0,0,-1,-1,-1,1,3,1
KR_6767932480,420,-4,-36,4,-8,-3,1,4,1,1,0,-6,1,7,3,6,3,-3,0,3,0,-2,3,3,3,6,-1,0,-1,-1,-1,-1,-1,6,1
KR_6680264341,420,2,24,20,8,4,7,3,-1,2,3,-2,1,3,4,7,3,3,3,0,0,12,18,-6,10,4,2,0,-1,-1,1,-1,1,1,1
KR_6446777869,420,-1,36,-25,-3,-2,0,2,1,6,5,-2,0,2,-1,0,1,1,1,0,0,0,52,0,7,7,-17,0,2,1,1,1,1,5,1
KR_6763656488,420,1,49,13,-1,1,2,1,3,6,3,-3,0,3,-2,1,3,0,0,0,0,4,-8,-4,7,3,1,0,1,-1,-1,1,1,2,1
KR_6738768119,440,4,29,28,9,2,2,0,0,0,0,-1,2,3,7,8,1,1,2,1,0,8,1,-1,2,1,0,0,2,1,1,1,-1,4,1
KR_6651877885,420,6,36,-4,10,0,3,3,0,0,0,4,5,1,4,7,3,2,3,1,0,12,22,4,1,5,0,0,0,-1,1,0,1,6,1
KR_6688757426,420,3,92,17,13,4,5,1,7,8,1,4,6,2,-2,0,2,0,2,2,1,13,-7,-3,4,1,1,0,2,0,1,1,1,0,1
KR_6749239958,420,5,35,-3,16,4,4,0,-1,1,2,1,1,0,11,11,0,1,1,0,0,20,12,7,2,9,-1,0,1,1,-1,1,1,3,1
KR_6755479986,420,1,40,-20,0,-3,1,4,-2,2,4,1,2,1,5,6,1,-1,0,1,0,2,14,4,1,5,-4,0,1,1,0,1,1,5,1
KR_6763654744,420,8,6,24,14,4,5,1,3,7,4,1,3,2,6,8,2,0,1,1,0,20,-2,0,5,5,4,0,1,1,0,1,-1,6,1
KR_6614661937,420,3,109,32,2,7,8,1,-1,2,3,-1,0,1,-1,0,1,-2,0,2,0,-3,267,1,2,3,1,0,0,1,1,1,1,2,1
KR_6589641087,420,-1,5,2,3,-1,3,4,3,8,5,2,4,2,-1,2,3,0,2,2,0,0,1,0,7,7,-6,0,-2,1,0,-1,1,4,1
KR_6749103592,420,3,67,-1,7,5,8,3,0,2,2,1,2,1,3,6,3,-2,1,3,1,7,0,1,7,8,0,0,2,1,0,1,1,3,1
KR_6767527494,420,3,6,0,6,-4,0,4,4,4,0,5,7,2,-3,6,9,4,5,1,1,12,93,2,4,6,3,0,-1,1,-1,1,1,3,1
KR_6733259847,420,3,28,-11,8,1,3,2,1,2,1,5,5,0,-2,2,4,3,3,0,0,9,-6,-6,8,2,-3,0,-1,-1,1,-1,1,6,1
KR_6751753539,420,2,25,4,3,2,3,1,5,6,1,-2,1,3,2,4,2,-4,0,4,0,3,-108,-1,6,5,-5,0,0,1,-1,0,-1,1,1
KR_6736330176,420,4,-17,-12,5,2,5,3,1,1,0,1,4,3,1,4,3,0,3,3,-2,0,3,-1,3,2,0,0,2,-1,1,1,-1,3,1
KR_6751127606,420,-1,18,-1,-1,-3,0,3,-3,0,3,-1,4,5,5,5,0,1,1,0,0,3,-11,1,2,3,1,0,1,1,1,1,1,5,1
KR_6765839077,420,1,85,16,-3,0,0,0,2,5,3,1,4,3,-6,0,6,0,1,1,-1,-7,27,-2,4,2,-22,0,0,-1,-1,0,-1,5,1
KR_6764938245,420,1,12,4,0,0,2,2,3,4,1,-3,3,6,0,2,2,0,2,2,0,4,-7,0,3,3,6,0,-1,-1,1,1,1,3,1
KR_6728102268,420,5,86,-19,12,-3,1,4,1,2,1,2,2,0,13,14,1,-1,0,1,0,15,-14,-1,4,3,0,0,2,1,-1,1,1,1,1
KR_6710337884,420,-2,7,-15,-5,0,2,2,2,3,1,-5,1,6,-2,0,2,0,1,1,0,1,-6,-2,6,4,1,0,0,-1,1,0,1,6,1
KR_6721941062,420,4,-35,-32,8,1,1,0,1,2,1,2,4,2,3,5,2,1,2,1,0,9,31,0,5,5,3,0,0,-1,-1,0,-1,4,1
KR_6762769796,420,2,38,-20,2,0,1,1,-1,1,2,5,6,1,-1,2,3,-1,1,2,-1,5,-305,2,3,5,0,0,1,1,-1,1,-1,5,1
KR_6740944139,420,2,34,-7,6,0,3,3,-1,3,4,2,2,0,3,5,2,2,2,0,0,7,98,-2,6,4,3,0,2,1,-1,1,1,5,1
KR_6701983273,420,0,38,-24,1,-2,0,2,-1,4,5,1,4,3,1,2,1,2,2,0,0,8,-8,-1,3,2,3,0,1,-1,-1,1,1,3,1
KR_6636513466,420,5,110,2,14,2,2,0,4,5,1,2,2,0,5,5,0,1,2,1,0,16,9,2,1,3,-1,0,1,-1,-1,1,1,1,1
KR_6735659096,420,3,5,48,6,0,1,1,1,2,1,7,7,0,-2,0,2,0,0,0,0,4,-1,2,0,2,-2,0,1,1,1,1,-1,5,1
KR_6646446931,420,-2,-42,-5,-9,-2,1,3,0,3,3,-2,2,4,-3,5,8,-2,0,2,1,-6,-230,-1,6,5,-3,0,-1,-1,1,-1,1,4,1
KR_6581556250,420,-1,-8,14,-4,1,2,1,-7,3,10,3,4,1,2,2,0,-3,2,5,-1,-2,-308,2,3,5,-4,0,3,-1,1,1,-1,2,1
KR_6751458023,440,0,35,16,-6,2,3,1,-2,0,2,1,1,0,-6,0,6,-1,0,1,0,-10,-8,-5,6,1,1,0,1,0,1,1,1,0,1
KR_6732366470,420,1,-31,42,-8,1,1,0,1,3,2,-2,1,3,-8,0,8,0,1,1,0,-8,7,3,5,8,-7,0,0,1,-1,-1,-1,1,1
KR_6756785870,440,1,23,-36,2,3,3,0,-7,0,7,0,0,0,6,7,1,0,0,0,0,-1,-34,-2,6,4,2,0,1,1,1,1,1,4,1
KR_6726319431,420,1,4,6,3,1,2,1,-1,3,4,0,1,1,0,4,4,3,3,0,0,5,32,-5,8,3,2,0,-1,1,-1,-1,-1,4,1
KR_6715716443,420,6,64,-6,24,3,5,2,10,10,0,3,3,0,8,9,1,0,1,1,0,19,5,3,3,6,3,0,2,0,-1,1,1,0,1
KR_6735135135,420,5,103,13,13,0,1,1,-6,0,6,5,7,2,12,12,0,2,3,1,1,20,-1,7,0,7,0,0,2,-1,1,1,1,5,1
KR_6709662935,420,4,29,4,0,4,4,0,1,2,1,-2,1,3,-1,1,2,-2,0,2,0,-4,147,2,2,4,0,0,1,0,1,1,-1,0,1
KR_6767344160,420,1,79,-3,3,2,2,0,3,5,2,0,1,1,-5,1,6,3,6,3,0,4,-7,2,2,4,5,0,0,1,1,1,-1,3,1
KR_6673223567,420,3,37,12,12,-1,3,4,0,1,1,3,4,1,3,4,1,7,9,2,-1,6,-35,-2,4,2,28,0,1,1,1,1,-1,1,1
KR_6762093266,420,3,91,-5,11,5,6,1,3,3,0,1,2,1,2,2,0,0,4,4,0,2,-15,0,4,4,3,0,1,1,-1,1,1,6,1
KR_6632259496,420,2,99,8,2,8,8,0,-2,1,3,0,2,2,-3,5,8,-1,0,1,0,-3,17,4,5,9,-4,0,1,1,1,1,-1,4,1
KR_6755007722,420,2,32,9,6,4,4,0,-1,3,4,-3,2,5,6,8,2,0,3,3,-1,-5,7,1,4,5,2,0,1,-1,1,1,-1,5,1
KR_6762242017,420,2,89,19,8,4,5,1,3,6,3,-1,2,3,1,5,4,1,2,1,0,1,421,1,3,4,-3,0,1,1,1,1,1,5,1
KR_6706997193,420,2,17,9,-3,-2,1,3,1,2,1,-3,1,4,0,2,2,1,2,1,0,-2,-77,0,4,4,-3,0,1,1,1,1,-1,5,1
KR_6705959350,420,3,26,21,-4,1,2,1,-2,0,2,-1,2,3,-2,3,5,0,1,1,0,-8,0,6,6,12,-2,0,1,1,1,1,1,3,1
KR_6746412044,420,3,-7,11,1,2,3,1,-1,2,3,0,1,1,-2,0,2,2,2,0,0,-5,-11,-6,9,3,-2,0,0,-1,-1,-1,1,2,1
KR_6722113893,420,-3,-20,14,-7,2,5,3,-3,1,4,-1,1,2,-3,0,3,-2,0,2,0,-13,2,1,3,4,-6,0,1,-1,-1,-1,1,2,1
KR_6739625995,420,4,42,7,5,-1,1,2,2,3,1,-3,1,4,7,7,0,0,0,0,0,6,0,1,4,5,-1,0,1,1,1,1,1,4,1
KR_6755275353,420,2,-71,40,9,2,4,2,2,2,0,2,4,2,3,4,1,0,0,0,1,9,-5,0,2,2,4,0,0,1,-1,1,1,5,1
KR_6764808461,440,2,22,-4,8,6,8,2,2,4,2,2,4,2,-3,0,3,1,5,4,2,14,0,-1,9,8,-2,0,1,-1,1,1,1,1,1
KR_6632115441,420,4,27,10,6,4,4,0,2,3,1,-1,0,1,1,1,0,0,0,0,0,4,8,-1,5,4,0,0,1,1,-1,1,1,5,1
KR_6760018655,420,-4,-7,-14,-4,-1,1,2,0,2,2,-1,2,3,-2,1,3,0,1,1,-1,-4,-2,1,2,3,0,0,-1,-1,-1,-1,-1,4,1
KR_6641270039,420,1,-44,20,8,0,3,3,2,7,5,5,5,0,-1,3,4,2,2,0,2,18,-1,1,4,5,0,0,-1,-1,1,-1,1,2,1
KR_6604002054,420,-1,-17,21,-4,1,2,1,3,5,2,-4,2,6,0,3,3,-4,2,6,-1,-5,-4,1,5,6,-2,0,0,-1,1,1,-1,5,1
KR_6686112932,420,2,25,21,1,-1,2,3,1,3,2,2,3,1,0,3,3,-1,1,2,0,-2,6,7,3,10,3,0,1,1,0,1,1,6,1
KR_6664921760,420,3,28,-4,14,3,3,0,0,3,3,1,3,2,6,8,2,4,4,0,0,11,11,5,2,7,-1,0,1,-1,1,1,1,1,1
KR_6648380021,420,3,72,9,1,2,2,0,-3,0,3,-4,1,5,4,5,1,2,4,2,0,4,5,5,0,5,0,0,1,0,0,1,1,0,1
KR_6743376582,420,4,-19,36,5,-5,0,5,9,9,0,1,1,0,0,2,2,0,0,0,0,5,-1,-3,8,5,-4,0,0,1,1,0,1,5,1
KR_6762492921,420,5,71,8,8,1,1,0,1,7,6,1,3,2,3,4,1,2,2,0,0,6,4,-6,10,4,-6,0,2,-1,1,1,1,1,1
KR_6761098578,420,0,-25,-4,7,-3,2,5,6,8,2,3,4,1,2,4,2,-1,0,1,0,8,0,-3,7,4,-1,0,0,-1,-1,-1,1,5,1
KR_6766169082,420,1,-10,1,8,2,2,0,0,1,1,7,8,1,2,4,2,-3,0,3,0,10,0,0,6,6,-1,0,0,1,1,0,-1,4,1
KR_6744785355,420,1,89,-36,7,5,5,0,-1,1,2,0,1,1,3,4,1,0,2,2,1,6,11,9,2,11,-2,0,2,1,1,1,1,4,1
KR_6722077678,420,3,72,-4,2,1,1,0,3,6,3,1,5,4,-3,1,4,0,1,1,0,-3,407,5,4,9,2,0,0,1,-1,0,-1,5,1
KR_6759805944,420,3,21,35,10,2,2,0,2,3,1,3,4,1,0,2,2,3,3,0,1,11,8,-2,7,5,4,0,1,1,-1,1,1,2,1
KR_6754357753,420,0,2,-14,3,-3,0,3,7,8,1,-1,0,1,1,2,1,-1,0,1,0,7,1,-1,4,3,3,0,1,0,0,1,1,0,1
KR_6554035238,420,1,-21,18,5,1,3,2,3,3,0,2,7,5,0,2,2,-1,0,1,0,-4,10,0,7,7,-4,0,0,1,1,1,1,1,1
KR_6692630929,420,4,27,8,9,0,3,3,1,4,3,2,3,1,1,4,3,5,7,2,2,15,8,2,1,3,3,0,0,-1,-1,1,1,3,1
KR_6711587545,420,2,20,4,2,0,2,2,-1,1,2,2,3,1,0,1,1,1,1,0,0,1,28,-2,4,2,-2,0,1,-1,1,1,-1,1,1
KR_6731622979,420,-4,0,-1,-5,2,3,1,-2,1,3,-5,1,6,1,6,5,-1,1,2,0,2,307,1,5,6,-1,0,0,1,-1,0,-1,5,1
KR_6672069257,420,0,-44,-8,3,2,3,1,5,6,1,-2,0,2,0,4,4,-2,1,3,0,6,-29,0,6,6,2,0,1,-1,1,1,-1,2,1
KR_6756956271,420,0,41,-4,-1,1,1,0,-1,1,2,-2,2,4,2,3,1,-1,0,1,0,-3,-13,-4,7,3,2,0,1,-1,0,1,-1,5,1
KR_6755254308,420,4,23,22,9,4,4,0,3,5,2,2,7,5,0,3,3,0,1,1,0,1,-6,2,3,5,-2,0,3,0,0,1,1,0,1
KR_6748416445,420,4,64,9,8,3,4,1,0,2,2,-1,3,4,2,3,1,4,4,0,0,4,7,-3,5,2,2,0,2,1,1,1,1,5,1
KR_6685625513,420,2,19,-68,8,1,2,1,3,7,4,-2,1,3,3,4,1,3,3,0,0,7,-19,-6,6,0,0,0,1,-1,-1,1,1,1,1
KR_6759278968,420,1,21,12,1,1,2,1,-3,1,4,-1,1,2,5,6,1,-1,2,3,0,1,333,2,5,7,1,0,-1,-1,1,-1,1,1,1
KR_6595233553,420,0,13,15,2,0,3,3,4,6,2,0,2,2,0,5,5,-2,1,3,0,2,-3,0,4,4,-1,0,0,0,1,1,1,0,1
KR_6627791338,420,1,14,-19,1,5,5,0,-5,3,8,-2,1,3,2,3,1,1,2,1,-2,-3,-7,-1,6,5,5,0,1,1,1,1,-1,3,1
KR_6750236050,420,3,39,37,0,2,2,0,-1,2,3,0,1,1,0,4,4,-1,1,2,0,-9,2,2,4,6,0,0,0,1,1,0,-1,6,1
KR_6755832960,420,2,32,3,4,2,2,0,5,6,1,1,4,3,0,0,0,-4,0,4,0,-3,-128,0,3,3,2,0,-1,-1,1,-1,1,5,1
KR_6183156799,420,1,47,9,7,-3,2,5,4,5,1,4,4,0,1,2,1,1,2,1,0,5,-298,0,7,7,-3,0,1,-1,-1,1,1,1,1
KR_6606738955,420,0,0,14,4,-3,1,4,5,9,4,9,11,2,-5,2,7,-2,4,6,0,1,106,0,3,3,2,0,0,1,1,-1,-1,2,1
KR_6380868819,440,-2,-7,-36,-2,0,0,0,-2,2,4,-6,1,7,5,5,0,1,2,1,0,6,-141,1,4,5,5,0,0,-1,-1,0,-1,5,1
KR_6759590535,440,1,-5,24,-3,-6,1,7,3,3,0,1,4,3,-2,4,6,1,1,0,0,-3,-4,-4,5,1,2,0,0,1,1,-1,-1,1,1
KR_6551631315,420,1,21,24,-1,1,4,3,3,7,4,-3,3,6,-1,3,4,-1,0,1,0,-12,-2,2,5,7,2,0,1,-1,1,1,-1,6,1
KR_6764461686,420,-1,34,8,5,2,4,2,-1,4,5,0,1,1,-2,1,3,6,6,0,0,12,14,-4,4,0,1,0,0,-1,0,0,1,6,1
KR_6735572310,420,3,6,20,4,-5,0,5,3,4,1,5,6,1,0,0,0,1,1,0,0,6,-1,1,4,5,1,0,1,1,1,1,-1,1,1
KR_6757369644,440,1,18,20,7,-5,3,8,2,3,1,-1,2,3,7,8,1,4,5,1,0,13,25,2,1,3,6,0,1,1,-1,-1,-1,2,1
KR_6760903874,420,3,41,-12,9,-1,0,1,6,6,0,1,1,0,0,2,2,3,3,0,0,11,-14,-6,9,3,1,0,0,1,0,1,1,4,1
KR_6764243993,420,0,27,15,-2,-3,1,4,2,4,2,5,7,2,0,2,2,-6,0,6,-1,-7,3,1,4,5,-3,0,1,-1,-1,1,-1,2,1
KR_6725924990,420,1,52,42,5,8,9,1,-2,1,3,-5,1,6,4,5,1,0,0,0,0,-6,6,1,1,2,3,0,2,-1,1,1,1,5,1
KR_6764977659,420,1,-31,20,0,-2,2,4,0,2,2,0,1,1,3,3,0,-1,0,1,0,1,-9,2,4,6,-3,0,0,1,1,0,-1,6,1
KR_6728366542,420,2,7,28,3,-5,0,5,-2,3,5,4,4,0,2,5,3,4,5,1,0,3,14,-3,11,8,-4,0,-1,1,-1,-1,-1,2,1
KR_6732958593,420,2,-71,0,5,-1,1,2,8,8,0,3,5,2,-5,1,6,0,0,0,0,5,41,-2,5,3,4,0,2,-1,1,1,-1,6,1
KR_6760387343,420,1,9,53,0,-3,0,3,2,8,6,2,5,3,-2,2,4,1,4,3,0,-12,8,2,7,9,3,0,-1,1,1,-1,-1,5,1
KR_6764099047,420,0,4,4,3,0,4,4,2,2,0,-6,1,7,7,8,1,0,2,2,1,9,-7,-1,4,3,-1,0,0,-1,-1,-1,1,3,1
KR_6767455104,440,0,107,-34,-7,3,4,1,-3,1,4,-3,1,4,0,4,4,-4,0,4,-1,-19,-11,-6,9,3,-1,0,-1,-1,1,-1,-1,2,1
KR_6746474942,420,0,-61,27,9,0,1,1,4,5,1,1,2,1,3,4,1,1,1,0,0,10,-45,-1,4,3,21,0,-1,-1,0,-1,1,6,1
KR_6647359877,420,2,6,9,10,1,4,3,7,7,0,-2,0,2,3,3,0,1,2,1,1,14,4,-4,4,0,7,0,0,1,-1,1,1,5,1
KR_6762823988,420,-3,-18,-20,-11,-4,0,4,1,5,4,-7,1,8,4,11,7,-5,1,6,-2,-16,5,4,1,5,-2,0,-2,1,-1,-1,-1,3,1
KR_6768043747,420,1,2,-12,4,3,4,1,4,5,1,-2,3,5,-2,2,4,1,1,0,0,5,-6,1,3,4,4,0,0,1,1,0,1,3,1
KR_6762484627,420,-1,59,-20,-3,2,4,2,-5,3,8,2,2,0,0,4,4,-2,1,3,-2,-7,2,2,2,4,4,0,0,-1,-1,0,-1,6,1
KR_6695268362,420,-3,-69,-28,-6,-3,0,3,-1,2,3,0,2,2,1,1,0,-3,1,4,0,-1,-6,1,5,6,0,0,0,0,1,0,-1,0,1
KR_6733679347,420,4,74,0,10,4,7,3,3,4,1,3,4,1,-3,2,5,3,4,1,0,2,2,-2,5,3,-1,0,2,1,1,1,-1,4,1
KR_6605790691,420,5,37,40,13,4,4,0,3,5,2,5,5,0,6,7,1,-5,1,6,0,7,-4,-6,7,1,3,0,2,-1,1,1,1,4,1
KR_6762089187,420,0,4,12,4,3,3,0,3,4,1,6,7,1,-7,1,8,-1,0,1,0,0,-10,2,4,6,5,0,1,0,1,1,1,0,1
KR_6756528675,420,8,66,18,13,5,5,0,3,4,1,4,5,1,1,4,3,0,0,0,0,8,-3,2,3,5,2,0,2,1,1,1,-1,5,1
KR_6762779334,420,1,41,-4,9,-1,2,3,4,4,0,-1,2,3,1,3,2,6,6,0,1,15,8,1,1,2,1,0,1,1,1,1,1,1,1
KR_6755253160,420,2,-10,20,5,-6,2,8,6,6,0,2,4,2,1,4,3,2,2,0,0,12,8,6,2,8,1,0,0,1,1,-1,-1,1,1
KR_6739815311,420,-3,-34,-12,-3,-2,0,2,-2,3,5,-2,2,4,3,3,0,0,0,0,0,2,-38,-1,4,3,26,0,-2,1,-1,-1,-1,1,1
KR_6605990070,420,1,25,8,2,0,0,0,-3,0,3,3,4,1,2,2,0,0,0,0,0,2,-10,0,4,4,2,0,0,1,0,0,-1,6,1
KR_6743272695,420,6,49,10,12,2,2,0,4,7,3,2,2,0,5,7,2,-1,0,1,0,6,4,2,1,3,-3,0,1,-1,1,1,1,3,1
KR_6682569351,420,6,68,-15,14,2,4,2,4,5,1,5,6,1,2,5,3,1,2,1,1,17,7,5,4,9,0,0,1,1,1,1,1,1,1
KR_6729250826,420,1,-38,2,8,0,0,0,2,5,3,-1,3,4,6,7,1,1,2,1,0,12,21,1,2,3,3,0,0,1,1,1,-1,2,1
KR_6755308261,420,0,6,13,-5,2,4,2,-1,4,5,-2,0,2,-4,0,4,0,0,0,0,-4,1,-1,2,1,-2,0,-1,1,-1,-1,-1,6,1
KR_6759866527,420,2,19,17,-1,0,4,4,-3,1,4,2,4,2,0,5,5,0,2,2,0,0,43,-2,7,5,-8,0,2,-1,-1,1,1,5,1
KR_6618744772,420,3,-17,24,7,-2,0,2,0,0,0,1,2,1,4,4,0,4,5,1,0,7,-20,3,4,7,3,0,1,1,1,1,1,6,1
KR_6661716056,420,2,9,18,11,-2,1,3,6,8,2,7,9,2,0,3,3,0,0,0,1,19,-2,1,3,4,-2,0,-1,1,-1,-1,1,1,1
KR_6761894068,440,-4,-13,-4,-8,4,4,0,-6,0,6,-3,0,3,-4,2,6,1,3,2,0,-10,0,3,5,8,-5,0,-1,-1,-1,-1,-1,4,1
KR_6755361154,420,0,36,4,0,-2,0,2,7,10,3,1,3,2,-3,2,5,-3,0,3,1,2,-7,1,2,3,2,0,1,1,0,1,1,5,1
KR_6644002234,440,5,71,28,13,6,6,0,3,4,1,1,3,2,-2,0,2,5,5,0,0,10,2,5,3,8,-2,0,1,1,1,1,-1,5,1
KR_6764226853,420,4,51,16,9,-1,0,1,-1,1,2,4,4,0,6,7,1,1,1,0,0,8,-2,0,4,4,0,0,0,1,-1,0,1,5,1
KR_6755384638,420,1,8,-8,7,-3,0,3,-5,0,5,2,3,1,7,8,1,6,8,2,0,10,-212,4,3,7,-1,0,1,1,-1,1,1,6,1
KR_6764393078,440,3,-35,0,10,0,2,2,-2,2,4,8,9,1,3,4,1,1,2,1,0,8,10,4,1,5,1,0,1,-1,0,1,1,1,1
KR_6672644828,420,5,110,4,9,2,2,0,-1,1,2,2,2,0,4,4,0,2,2,0,1,13,-141,4,2,6,-2,0,3,1,1,1,1,1,1
KR_6690754686,420,-2,-51,3,-6,-2,0,2,1,2,1,-2,3,5,-2,2,4,-1,0,1,0,-9,-3,3,1,4,1,0,1,-1,0,1,-1,1,1
KR_6742163892,420,2,27,4,8,1,1,0,3,3,0,1,3,2,0,5,5,3,3,0,0,5,0,5,3,8,-6,0,1,-1,1,1,1,1,1
KR_6649547454,420,2,72,8,0,2,2,0,-2,2,4,-2,1,3,1,2,1,1,1,0,0,-3,-108,0,6,6,-4,0,0,1,0,0,1,1,1
KR_6625243337,420,4,26,44,7,7,8,1,-4,2,6,3,3,0,3,3,0,-2,0,2,-1,2,-3,1,6,7,1,0,2,1,1,1,-1,6,1
KR_6729872751,440,2,-17,29,8,-3,1,4,0,4,4,7,8,1,4,5,1,0,1,1,1,13,28,0,3,3,5,0,0,0,1,0,1,0,1
KR_6710269738,420,-1,-30,12,4,0,0,0,1,2,1,4,5,1,-1,1,2,0,0,0,0,1,7,-1,5,4,0,0,-1,1,1,-1,1,1,1
KR_6757726005,420,-3,-47,-4,-7,-3,0,3,-2,2,4,1,1,0,-4,0,4,1,1,0,0,-4,-102,1,7,8,-25,0,0,0,1,0,-1,0,1
KR_6753722036,420,2,52,4,5,1,2,1,0,2,2,0,1,1,3,4,1,1,3,2,-1,8,11,-1,7,6,0,0,-1,-1,-1,-1,-1,6,1
KR_6748080645,420,4,130,-9,13,1,6,5,1,1,0,5,8,3,2,3,1,4,5,1,1,9,-2,1,2,3,-2,0,2,-1,-1,1,1,4,1
KR_6765545820,420,2,12,-25,6,1,2,1,1,7,6,-1,1,2,5,7,2,0,0,0,0,12,-5,-1,3,2,2,0,2,1,1,1,-1,6,1
KR_6638019799,420,8,83,48,18,5,6,1,3,3,0,1,3,2,9,10,1,0,0,0,0,15,-6,-2,4,2,0,0,1,1,-1,1,1,5,1
KR_6716139539,420,2,-19,30,8,-1,2,3,3,3,0,5,5,0,2,3,1,-1,0,1,0,12,127,2,2,4,-5,0,1,-1,1,1,-1,6,1
KR_6767559432,420,1,-11,31,-1,-3,1,4,-4,0,4,1,3,2,5,5,0,0,0,0,0,2,18,-1,4,3,2,0,1,1,1,1,-1,5,1
KR_6678623586,420,3,28,6,8,1,2,1,6,8,2,1,3,2,0,3,3,0,0,0,0,7,-10,2,4,6,3,0,1,0,1,1,1,0,1
KR_6763378887,440,-3,-24,-8,-1,0,0,0,-2,1,3,2,2,0,-1,4,5,0,0,0,0,3,-33,2,2,4,-4,0,0,1,-1,-1,1,6,1
KR_6751158302,420,4,25,52,-1,-1,0,1,-3,1,4,-2,1,3,5,6,1,0,1,1,0,-2,0,1,3,4,2,0,0,1,1,0,-1,4,1
KR_6762199338,420,2,-1,50,3,-6,1,7,6,7,1,1,3,2,2,2,0,0,0,0,0,7,-4,-2,6,4,-5,0,-1,1,-1,-1,-1,2,1
KR_6765772893,440,-2,-30,22,-5,2,3,1,-4,1,5,0,3,3,-2,3,5,-1,0,1,0,-10,-7,0,4,4,-2,0,-1,0,1,1,1,0,1
KR_6659147763,440,3,-17,16,3,2,3,1,1,1,0,4,4,0,-2,1,3,-2,0,2,0,-2,108,0,4,4,-2,0,0,1,1,1,1,4,1
KR_6756856442,420,3,18,0,7,0,1,1,-1,2,3,2,3,1,0,0,0,6,7,1,-1,8,-2,2,4,6,1,0,0,1,1,0,-1,1,1
KR_6705658013,420,2,40,-4,9,6,7,1,0,3,3,3,3,0,0,0,0,0,1,1,0,4,3,0,7,7,3,0,1,-1,1,1,1,3,1
KR_6489101055,420,2,30,20,-5,3,3,0,-5,0,5,-3,0,3,1,2,1,-1,0,1,0,-10,10,-4,6,2,2,0,0,1,-1,0,-1,4,1
KR_6765306782,420,2,26,-20,5,3,4,1,4,4,0,0,4,4,-6,1,7,4,4,0,-2,4,145,3,4,7,-2,0,0,1,1,1,1,3,1
KR_6766868444,420,2,-30,24,12,6,6,0,3,4,1,5,5,0,-2,3,5,0,0,0,0,9,6,3,2,5,2,0,2,0,1,1,1,0,1
KR_6656985249,440,0,14,10,-7,2,4,2,-2,0,2,-3,1,4,-1,1,2,-3,1,4,0,-5,120,3,3,6,-1,0,-1,1,-1,-1,-1,3,1
KR_6760972882,440,-2,4,-1,-3,0,2,2,0,1,1,1,2,1,-1,0,1,-3,1,4,0,-2,-12,1,4,5,-4,0,0,-1,-1,-1,-1,6,1
KR_6611213231,420,4,69,-3,6,0,2,2,2,3,1,-1,1,2,3,4,1,2,2,0,0,7,-1,-1,3,2,1,0,2,-1,1,1,-1,1,1
KR_6765319504,420,7,67,-12,12,8,9,1,5,5,0,-1,0,1,0,2,2,0,1,1,0,-2,15,6,3,9,-2,0,3,1,1,1,1,1,1
KR_6763639354,440,5,62,8,12,3,3,0,4,4,0,3,4,1,0,2,2,2,2,0,0,11,-9,1,2,3,2,0,3,-1,1,1,1,3,1
KR_6679873403,420,-1,-42,-3,2,-1,1,2,4,7,3,-3,1,4,2,3,1,0,0,0,0,7,22,3,6,9,-2,0,-1,1,1,-1,1,3,1
KR_6673147686,420,1,34,4,6,3,4,1,1,8,7,-2,2,4,4,6,2,0,1,1,0,5,5,4,1,5,4,0,1,1,1,1,-1,2,1
KR_6677249564,420,3,14,-4,4,1,2,1,2,6,4,1,2,1,0,1,1,0,0,0,0,0,-16,3,3,6,-2,0,1,-1,0,1,1,1,1
KR_6739802161,420,1,7,0,2,1,1,0,1,4,3,3,3,0,-3,1,4,0,0,0,0,1,-16,0,3,3,-2,0,1,1,1,1,1,2,1
KR_6767144673,420,1,-11,-16,10,-2,1,3,3,3,0,5,7,2,4,4,0,0,0,0,0,14,16,-2,7,5,0,0,0,-1,1,0,1,2,1
KR_6758833148,420,4,62,25,4,2,3,1,2,4,2,1,2,1,-2,0,2,1,1,0,0,-3,-26,4,2,6,-2,0,1,0,1,1,-1,0,1
KR_6718970870,420,2,51,-6,8,7,8,1,2,4,2,-2,0,2,2,5,3,-1,0,1,-1,12,1,2,4,6,0,0,1,1,1,1,-1,4,1
KR_6626997344,420,1,7,9,3,4,4,0,-1,1,2,-2,2,4,2,2,0,0,0,0,0,0,-13,2,1,3,6,0,1,-1,1,1,1,1,1
KR_6766000290,420,3,42,-8,3,1,2,1,4,4,0,4,4,0,-7,0,7,1,3,2,-1,-4,-23,-2,4,2,4,0,-1,0,0,-1,-1,0,1
KR_6753009253,440,2,70,-16,4,2,2,0,0,3,3,7,7,0,-1,5,6,-4,1,5,1,8,1,2,4,6,3,0,1,-1,0,1,1,4,1
KR_6742682619,420,-1,-70,17,-8,0,1,1,-1,2,3,-5,0,5,0,3,3,-2,1,3,0,-5,1,-3,4,1,1,0,-1,-1,1,-1,-1,1,1
KR_6760956175,420,1,15,-16,7,4,4,0,4,8,4,-6,1,7,0,4,4,5,5,0,1,12,-3,0,3,3,2,0,3,-1,1,1,1,5,1
KR_6732586528,420,1,33,12,0,1,2,1,2,4,2,0,4,4,-3,0,3,0,0,0,0,-4,-3,-2,4,2,1,0,0,1,1,1,-1,6,1
KR_6765087021,420,5,113,8,8,4,4,0,1,3,2,2,3,1,3,3,0,-2,0,2,0,9,-13,2,2,4,6,0,2,1,1,1,1,2,1
KR_6767429528,420,5,-36,24,15,7,8,1,6,6,0,3,5,2,-1,1,2,0,1,1,0,11,1,4,1,5,-9,0,0,1,1,1,1,5,1
KR_6708172379,440,0,-12,-4,0,0,2,2,3,6,3,-5,0,5,4,6,2,-2,1,3,0,0,-7,-2,5,3,4,0,0,-1,-1,0,-1,1,1
KR_6724145001,440,0,-47,4,3,-1,1,2,5,5,0,-3,0,3,2,5,3,0,0,0,0,10,-257,5,3,8,-1,0,-1,1,-1,-1,1,6,1
KR_6481113218,420,2,14,-4,7,0,2,2,7,7,0,-5,0,5,2,5,3,3,3,0,0,15,0,0,6,6,1,0,0,1,-1,0,1,5,1
KR_6711080303,420,5,61,18,13,4,4,0,2,3,1,1,1,0,4,4,0,2,2,0,0,10,10,4,2,6,0,0,3,-1,1,1,1,5,1
KR_6759203403,420,7,65,11,20,5,8,3,3,3,0,5,7,2,3,3,0,4,4,0,0,12,13,-1,4,3,1,0,2,0,1,1,1,0,1
KR_6760759756,440,1,6,12,1,0,2,2,-3,0,3,5,5,0,-2,0,2,1,1,0,0,2,4,5,1,6,-1,0,0,-1,-1,0,1,2,1
KR_6755347446,420,0,25,0,2,5,5,0,-2,0,2,3,5,2,-4,0,4,0,0,0,1,-17,2,0,4,4,0,0,0,0,0,0,1,0,1
KR_6760192477,420,1,-27,-13,0,-3,0,3,1,5,4,4,4,0,-2,0,2,0,0,0,0,-3,2,3,3,6,-3,0,1,0,-1,1,-1,0,1
KR_6722568654,420,1,55,-15,-4,-2,1,3,5,6,1,1,3,2,-4,2,6,-4,1,5,-2,-16,-7,-1,5,4,4,0,1,-1,1,1,-1,6,1
KR_6765431890,420,-3,41,8,-5,-1,1,2,0,1,1,2,5,3,-4,4,8,-2,0,2,1,-17,26,-2,5,3,1,0,0,-1,0,-1,1,3,1
KR_6753480798,420,6,41,43,1,1,2,1,3,5,2,-7,0,7,2,3,1,2,2,0,0,5,-235,5,0,5,4,0,2,-1,1,1,1,2,1
KR_6619708179,420,2,18,3,6,5,5,0,-3,2,5,2,2,0,0,4,4,2,7,5,0,7,6,1,5,6,0,0,2,-1,1,1,-1,3,1
KR_6748844609,420,-1,50,23,-1,0,2,2,0,1,1,-5,0,5,3,4,1,1,2,1,0,1,45,2,2,4,-32,0,2,-1,-1,1,1,1,1
KR_6762531059,420,3,72,8,8,3,3,0,1,1,0,0,1,1,4,5,1,0,1,1,-1,4,-5,3,1,4,0,0,2,0,1,1,-1,0,1
KR_6754978125,420,2,36,45,-1,0,3,3,-1,1,2,-1,1,2,2,5,3,-1,0,1,0,-1,-7,-3,7,4,0,0,0,1,1,0,-1,4,1
KR_6720349174,420,-2,-24,12,-8,-2,0,2,2,5,3,0,1,1,-4,2,6,-4,0,4,0,-10,117,0,5,5,3,0,0,-1,1,-1,1,2,1
KR_6185933128,440,5,-18,28,11,0,1,1,5,7,2,7,7,0,0,1,1,-1,0,1,0,10,2,-5,9,4,2,0,0,0,1,0,-1,0,1
KR_6765630251,420,3,26,-20,6,6,6,0,-1,0,1,-1,3,4,2,3,1,0,2,2,0,1,-2,5,0,5,1,0,1,-1,1,1,-1,2,1
KR_6637240477,420,5,90,16,8,2,4,2,-1,3,4,2,3,1,4,7,3,1,3,2,0,4,8,-1,4,3,1,0,2,1,-1,1,-1,4,1
KR_6758696811,420,0,7,-16,3,2,3,1,1,2,1,0,1,1,2,4,2,-2,1,3,0,-3,24,0,2,2,-2,0,0,-1,-1,0,1,3,1
KR_6605580063,420,1,16,6,6,0,0,0,2,2,0,2,4,2,2,5,3,0,3,3,0,4,-54,0,7,7,0,0,0,0,-1,0,1,0,1
KR_6678713255,420,2,15,20,-4,2,3,1,1,3,2,-6,0,6,-4,0,4,3,4,1,0,-8,-5,-4,5,1,2,0,-1,-1,1,1,1,4,1
KR_6745728862,440,5,61,-4,12,1,3,2,2,2,0,1,5,4,5,6,1,3,3,0,1,13,1,1,3,4,-2,0,3,1,1,1,1,3,1
KR_6746984728,420,-1,13,7,-2,-1,2,3,0,2,2,1,3,2,-1,0,1,-1,0,1,0,-4,9,-2,6,4,-4,0,0,1,1,0,-1,5,1
KR_6752506009,420,0,12,2,8,1,2,1,4,5,1,1,2,1,1,7,6,1,1,0,0,13,-474,8,2,10,0,0,-1,-1,1,-1,-1,4,1
KR_6760689209,420,2,11,12,11,1,1,0,4,4,0,9,10,1,-3,0,3,0,0,0,0,6,-5,1,2,3,5,0,-1,1,1,1,1,6,1
KR_6767007336,420,-2,-12,-48,-2,-4,0,4,-1,2,3,1,3,2,1,3,2,1,1,0,0,-1,16,2,5,7,-5,0,-1,1,-1,-1,1,4,1
KR_6764095689,440,-1,12,-8,-1,-2,2,4,0,0,0,1,2,1,0,1,1,0,1,1,-1,0,-10,1,4,5,0,0,0,-1,1,0,-1,6,1
KR_6447890235,420,4,-28,6,8,0,3,3,-1,2,3,6,6,0,0,3,3,3,5,2,2,12,-71,5,4,9,-1,0,0,1,1,1,1,3,1
KR_6726177980,420,4,62,20,9,3,4,1,-1,1,2,6,6,0,3,7,4,-2,1,3,0,0,107,0,4,4,3,0,2,1,1,1,1,3,1
KR_6625811223,420,2,61,-3,5,2,3,1,3,3,0,0,2,2,3,5,2,-3,0,3,0,10,0,2,2,4,0,0,-1,1,-1,-1,1,6,1
KR_6757460554,420,-1,66,13,-2,1,1,0,-7,2,9,1,2,1,3,8,5,0,0,0,0,-3,-10,-3,3,0,-1,0,0,1,0,1,1,5,1
KR_6751063293,420,-1,-27,-4,1,1,2,1,2,5,3,-4,1,5,4,6,2,-2,1,3,0,-1,-6,-4,7,3,-1,0,-1,1,-1,-1,1,1,1
KR_6748632130,420,-1,-28,16,-1,-2,1,3,2,2,0,-2,4,6,1,5,4,0,1,1,-1,2,2,0,3,3,1,0,-1,1,-1,-1,-1,5,1
KR_6704835704,420,9,96,36,7,3,3,0,1,5,4,1,4,3,2,4,2,0,1,1,0,-1,7,-2,6,4,-1,0,2,1,1,1,-1,2,1
KR_6731896996,440,2,42,19,5,2,3,1,0,1,1,-2,3,5,6,6,0,-1,1,2,0,11,2,-3,8,5,2,0,2,-1,1,1,1,3,1
KR_6762248963,420,2,37,10,2,0,1,1,1,1,0,1,1,0,-5,0,5,5,6,1,0,0,-42,-4,6,2,18,0,0,1,1,0,1,6,1
KR_6627173312,420,1,-26,20,8,2,3,1,4,6,2,-2,1,3,3,4,1,1,1,0,0,12,-228,8,0,8,-4,0,0,-1,-1,1,1,3,1
KR_6766023929,440,2,127,24,6,0,3,3,-4,0,4,2,2,0,5,7,2,3,3,0,0,4,-2,1,3,4,3,0,2,1,1,1,1,3,1
KR_6751920489,420,0,-22,0,4,0,3,3,7,7,0,-2,3,5,0,2,2,-1,4,5,2,11,3,2,1,3,1,0,0,1,0,1,1,4,1
KR_6748446165,440,5,70,40,11,2,2,0,2,4,2,1,3,2,0,2,2,6,6,0,0,10,-15,-1,3,2,1,0,1,1,1,1,1,3,1
KR_6767393707,420,4,52,16,14,3,5,2,5,7,2,4,5,1,-1,4,5,3,3,0,1,14,5,-6,8,2,-2,0,2,1,1,1,1,4,1
KR_6723102794,420,3,75,24,0,1,3,2,0,1,1,0,2,2,-2,1,3,1,1,0,0,-3,-1,3,2,5,4,0,2,1,1,1,-1,5,1
KR_6733520929,420,4,52,-13,4,3,5,2,1,2,1,0,2,2,-3,0,3,3,3,0,0,7,28,3,4,7,-3,0,2,-1,1,1,-1,2,1
KR_6733717486,420,5,74,12,10,1,2,1,5,5,0,4,4,0,1,3,2,-1,4,5,0,20,27,4,4,8,-1,0,1,-1,1,1,1,5,1
KR_6730670184,420,-3,-71,-16,-4,1,3,2,0,1,1,-6,0,6,0,1,1,1,1,0,0,-1,-3,-3,6,3,0,0,0,1,1,0,-1,5,1
KR_6673997851,420,5,14,13,9,0,1,1,6,7,1,1,1,0,1,4,3,1,2,1,0,8,13,-1,4,3,-2,0,2,1,1,1,1,2,1
KR_6726168833,420,3,99,56,10,2,4,2,2,3,1,2,3,1,5,6,1,-1,1,2,0,0,-10,2,4,6,5,0,0,0,0,0,1,0,1
KR_6729607659,420,-2,65,-36,3,0,2,2,-2,2,4,3,5,2,1,2,1,1,1,0,-1,-4,-8,-3,6,3,-1,0,-1,1,-1,-1,-1,5,1
KR_6554076579,420,1,-22,-15,0,1,5,4,-1,1,2,4,5,1,-1,3,4,-3,1,4,0,-2,89,-3,9,6,1,0,0,1,-1,0,-1,6,1
KR_6753145723,420,1,60,0,4,0,2,2,3,5,2,-2,1,3,3,4,1,0,1,1,0,5,-35,1,4,5,18,0,1,-1,1,1,-1,5,1
KR_6747273626,420,4,117,17,4,2,3,1,3,4,1,-2,1,3,1,3,2,0,0,0,0,-4,21,0,5,5,2,0,0,-1,1,1,-1,1,1
KR_6733036407,420,2,16,5,-10,1,2,1,-5,2,7,3,4,1,-8,0,8,-1,2,3,-1,-18,43,-3,4,1,-9,0,1,-1,-1,1,-1,5,1
KR_6755323178,420,1,17,-2,6,-1,0,1,7,8,1,-2,0,2,3,4,1,-1,1,2,0,7,-2,4,1,5,-4,0,0,1,1,0,-1,4,1
KR_6679495488,420,3,-1,-11,6,0,2,2,3,5,2,2,5,3,0,2,2,1,1,0,0,-2,18,-1,5,4,7,0,-1,0,0,-1,1,0,1
KR_6749421989,440,-1,-36,-6,-5,-5,1,6,6,6,0,-1,4,5,-5,0,5,0,2,2,1,-2,12,4,2,6,1,0,1,0,-1,1,-1,0,1
KR_6642325683,420,1,31,1,3,5,6,1,-2,2,4,-3,0,3,1,2,1,2,3,1,0,6,128,0,5,5,-4,0,1,0,1,1,1,0,1
KR_6766636886,440,0,27,-32,2,-1,1,2,0,0,0,0,2,2,0,3,3,3,3,0,0,3,-101,-2,3,1,3,0,0,-1,1,0,1,1,1
KR_6749874501,420,-1,18,-24,-1,1,3,2,-3,3,6,-2,2,4,3,6,3,0,0,0,0,2,-18,6,1,7,7,0,1,-1,1,1,-1,3,1
KR_6766673471,420,2,75,37,2,3,4,1,0,1,1,1,1,0,-5,0,5,3,3,0,0,-10,-2,-3,7,4,2,0,3,1,1,1,-1,4,1
KR_6749494687,440,3,15,28,2,1,3,2,-2,1,3,-4,0,4,6,6,0,1,1,0,1,-3,13,2,3,5,-4,0,1,-1,1,1,1,6,1
KR_6710947127,440,3,36,-3,5,0,1,1,-2,2,4,2,3,1,4,5,1,1,2,1,1,7,14,-2,7,5,1,0,0,-1,1,0,-1,6,1
KR_6762977544,420,0,40,-8,6,5,6,1,-1,1,2,-1,5,6,2,3,1,1,1,0,0,6,-7,-1,7,6,4,0,-1,0,1,-1,1,0,1
KR_6762839827,420,0,7,24,-1,-2,0,2,3,4,1,-3,2,5,2,4,2,-1,1,2,0,4,-2,2,0,2,-1,0,1,-1,-1,1,-1,6,1
KR_6741188422,420,1,69,0,6,0,1,1,1,2,1,3,5,2,1,4,3,1,3,2,0,9,-10,-4,6,2,5,0,0,1,1,0,1,3,1
KR_6766140259,420,2,87,24,5,-2,0,2,-2,1,3,0,2,2,8,8,0,1,2,1,-1,6,5,-1,6,5,0,0,2,1,0,1,-1,3,1
KR_6764319608,420,0,28,33,-3,-1,0,1,0,2,2,-1,3,4,-4,3,7,3,3,0,0,0,-74,1,6,7,-2,0,-2,1,-1,-1,-1,1,1
KR_6765566098,420,1,4,-9,2,-2,2,4,0,2,2,2,3,1,-1,1,2,3,5,2,0,-2,-1,0,4,4,-3,0,0,1,-1,-1,1,2,1
KR_6732951546,440,4,87,-8,8,3,4,1,0,0,0,2,3,1,6,7,1,-3,0,3,0,7,5,3,0,3,-2,0,1,0,-1,1,1,0,1
KR_6694473533,420,3,-13,19,8,1,3,2,3,4,1,1,2,1,0,3,3,3,3,0,0,6,58,4,2,6,-3,0,0,1,1,1,-1,2,1
KR_6761154379,420,-1,51,1,-1,-1,0,1,-3,2,5,1,4,3,1,3,2,1,2,1,0,-4,-8,-9,10,1,0,0,1,1,1,1,1,6,1
KR_6482457627,420,8,73,57,12,6,7,1,3,5,2,-1,3,4,3,3,0,1,3,2,0,4,-17,2,3,5,1,0,3,1,1,1,1,6,1
KR_6766576289,420,5,111,4,0,0,2,2,1,2,1,0,1,1,1,2,1,-2,1,3,0,3,-2,-1,3,2,3,0,2,-1,1,1,1,3,1
KR_6751175808,420,0,-3,29,-1,-3,0,3,3,3,0,-3,0,3,1,3,2,1,3,2,0,3,-4,-3,7,4,0,0,2,1,1,1,-1,2,1
KR_6755324136,420,2,39,40,2,2,3,1,2,2,0,-5,1,6,1,5,4,2,2,0,-2,-3,-105,0,3,3,2,0,1,1,1,-1,-1,2,1
KR_6762746444,440,1,-9,-8,-2,3,6,3,-3,2,5,-3,0,3,1,3,2,0,1,1,0,-2,-35,-2,5,3,4,0,-1,-1,1,-1,-1,1,1
KR_6763444970,440,0,-74,20,-4,-1,1,2,-3,2,5,-3,0,3,2,2,0,1,3,2,-1,-2,-14,-2,4,2,0,0,0,0,-1,-1,-1,0,1
KR_6751862583,420,2,4,19,9,2,2,0,-2,2,4,0,2,2,5,6,1,4,4,0,0,4,-2,0,5,5,2,0,0,-1,1,0,1,1,1
KR_6724697687,420,3,109,16,6,6,6,0,1,3,2,1,2,1,-2,1,3,0,0,0,0,4,-14,-1,3,2,1,0,1,1,-1,1,-1,2,1
KR_6764173036,420,1,16,-12,5,0,2,2,-3,3,6,6,7,1,0,3,3,2,3,1,0,1,11,-2,4,2,1,0,1,1,-1,1,1,1,1
KR_6753192526,420,6,93,40,3,7,8,1,0,0,0,-3,3,6,-1,4,5,0,3,3,-1,-3,7,1,5,6,-3,0,2,-1,-1,1,-1,4,1
KR_6753572617,420,-2,49,-26,1,3,5,2,1,3,2,-3,1,4,-1,0,1,1,1,0,0,-3,13,1,4,5,0,0,2,1,1,1,1,4,1
KR_6748395457,420,3,86,-15,11,4,4,0,1,2,1,4,4,0,1,4,3,1,1,0,0,8,0,3,2,5,4,0,3,1,0,1,1,3,1
KR_6723287005,420,3,61,30,6,2,3,1,0,5,5,1,5,4,2,2,0,1,2,1,0,6,6,5,3,8,4,0,1,1,1,1,-1,1,1
KR_6763234509,440,1,-39,29,-1,-4,2,6,3,3,0,-1,2,3,-3,0,3,4,4,0,0,-7,-15,-4,7,3,3,0,0,0,-1,0,1,0,1
KR_6593228713,420,8,77,1,19,8,8,0,5,7,2,-2,1,3,6,6,0,2,2,0,0,18,3,4,2,6,8,0,2,1,-1,1,1,3,1
KR_6672368713,420,0,20,16,-2,-4,0,4,0,2,2,4,6,2,0,3,3,-2,0,2,0,-5,-5,-2,5,3,1,0,0,1,0,0,-1,4,1
KR_6551543227,420,3,46,21,9,2,3,1,4,4,0,0,4,4,3,3,0,0,0,0,0,4,-6,0,5,5,-3,0,0,1,-1,0,1,6,1
KR_6706698540,420,2,53,8,7,-1,1,2,4,6,2,2,4,2,2,4,2,0,1,1,0,9,30,2,6,8,4,0,0,1,1,1,1,1,1
KR_6705766324,420,2,49,-8,5,2,3,1,1,2,1,6,6,0,-2,3,5,-2,0,2,0,3,-2,-2,5,3,2,0,0,-1,-1,1,-1,5,1
KR_6763610210,420,4,29,16,6,2,2,0,6,6,0,5,5,0,-7,3,10,0,1,1,0,8,-6,-2,3,1,4,0,1,-1,1,1,1,2,1
KR_6761839110,440,3,21,14,14,5,5,0,2,5,3,7,9,2,2,3,1,-2,2,4,0,5,-175,-9,9,0,4,0,2,-1,1,1,1,4,1
KR_6642984576,420,-2,3,8,-8,-1,2,3,4,7,3,-8,1,9,-3,1,4,0,1,1,-1,-2,5,2,2,4,-1,0,0,-1,-1,0,-1,1,1
KR_6762431505,420,-1,-55,20,2,-2,2,4,-1,2,3,-1,2,3,4,6,2,2,3,1,0,3,14,1,3,4,2,0,0,1,0,-1,1,2,1
KR_6746554902,440,2,17,32,6,1,3,2,2,3,1,4,5,1,0,3,3,-1,1,2,0,0,9,3,1,4,0,0,1,0,1,1,1,0,1
KR_6670370607,420,1,35,37,-1,-9,1,10,4,6,2,-2,2,4,4,6,2,2,4,2,3,-3,-17,-6,8,2,9,0,0,1,1,0,1,1,1
KR_6753228336,420,3,35,-9,2,5,6,1,2,4,2,-2,1,3,-1,0,1,-2,0,2,0,-1,2,4,1,5,0,0,3,1,-1,1,1,3,1
KR_6752272510,420,1,20,1,2,2,3,1,1,5,4,-1,1,2,0,3,3,0,1,1,0,-1,-1,-6,9,3,2,0,0,-1,1,-1,1,1,1
KR_6754970269,440,0,-35,20,8,4,5,1,2,6,4,2,3,1,-1,2,3,1,1,0,0,11,-4,-1,4,3,1,0,0,0,0,0,1,0,1
KR_6663887807,420,1,30,24,5,-1,2,3,0,0,0,-2,2,4,5,5,0,3,3,0,0,12,18,3,2,5,-2,0,0,-1,-1,-1,-1,4,1
KR_6673186121,420,-2,-18,-11,-12,-4,1,5,-6,0,6,0,3,3,-1,3,4,-1,1,2,0,-11,-46,0,4,4,1,0,-2,-1,-1,-1,-1,1,1
KR_6761229021,440,1,63,-4,6,-2,0,2,2,3,1,-1,2,3,-1,0,1,8,8,0,0,10,7,0,5,5,0,0,0,1,-1,1,1,5,1
KR_6761924025,440,2,79,3,-1,2,4,2,-3,0,3,3,4,1,-3,3,6,0,2,2,0,-9,8,2,5,7,2,0,2,-1,1,1,-1,5,1
KR_6763427677,440,0,19,-32,5,1,3,2,-5,0,5,3,5,2,5,5,0,1,1,0,0,6,-153,0,4,4,-10,0,2,0,1,1,1,0,1
KR_6704827013,420,0,-13,16,-5,-5,1,6,4,5,1,0,0,0,-2,2,4,-2,0,2,-1,-10,-15,-4,7,3,1,0,-4,-1,-1,-1,-1,6,1
KR_6761766443,440,2,36,35,2,4,4,0,-2,1,3,-3,0,3,1,3,2,2,2,0,0,0,113,4,2,6,1,0,3,1,1,1,1,4,1
KR_6758076626,440,1,-32,12,6,1,1,0,7,7,0,-3,3,6,-1,2,3,2,2,0,-1,18,34,1,7,8,1,0,0,1,-1,0,1,5,1
KR_6631565834,420,4,18,0,8,-1,1,2,2,7,5,0,1,1,5,5,0,2,4,2,0,1,15,1,4,5,3,0,1,-1,1,1,1,6,1
KR_6745905102,420,-2,-39,28,-3,1,1,0,-4,4,8,-2,0,2,2,2,0,0,0,0,0,-7,-18,-1,4,3,3,0,-1,1,-1,-1,-1,6,1
KR_6665871089,420,1,-12,13,7,-1,1,2,1,4,3,6,7,1,1,1,0,0,2,2,0,5,-21,-3,6,3,7,0,0,1,-1,0,-1,3,1
KR_6607003307,420,1,1,6,12,0,3,3,1,4,3,10,12,2,4,4,0,-3,1,4,2,7,-6,2,1,3,0,0,2,1,-1,1,1,4,1
KR_6708910974,440,2,30,-6,12,3,4,1,1,2,1,4,8,4,3,3,0,1,2,1,0,16,-245,-1,8,7,-2,0,0,1,1,0,1,1,1
KR_6763489399,420,6,16,41,23,4,5,1,0,1,1,2,4,2,15,15,0,2,3,1,2,20,13,2,1,3,13,0,2,1,1,1,1,2,1
KR_6750337392,420,1,91,-2,10,1,2,1,6,7,1,4,6,2,-5,1,6,4,5,1,0,1,161,-2,5,3,3,0,3,1,1,1,1,2,1
KR_6764299560,420,3,57,-15,12,-3,2,5,5,6,1,4,7,3,6,6,0,0,0,0,0,16,-24,-2,6,4,2,0,1,1,1,1,-1,1,1
KR_6766123558,420,5,35,24,12,1,1,0,4,6,2,1,5,4,2,3,1,4,4,0,0,12,187,7,0,7,-2,0,3,-1,1,1,1,1,1
KR_6526366595,420,0,36,38,0,-4,0,4,-3,2,5,2,4,2,3,6,3,2,5,3,1,-7,1,0,2,2,2,0,1,1,1,1,1,1,1
KR_6725725255,420,4,51,-10,0,5,5,0,1,4,3,2,3,1,-7,2,9,-1,2,3,0,-10,-56,-1,5,4,0,0,1,-1,1,1,-1,6,1
KR_6676464848,420,1,1,-14,9,-2,0,2,5,5,0,5,6,1,1,3,2,0,1,1,0,11,17,6,2,8,-1,0,1,0,1,1,-1,0,1
KR_6735195664,420,1,-21,-20,3,3,3,0,-3,1,4,5,6,1,0,2,2,-2,0,2,0,1,3,0,2,2,-4,0,0,-1,0,0,1,3,1
KR_6679105962,420,9,72,32,14,4,5,1,4,4,0,0,2,2,3,5,2,3,3,0,0,3,-7,0,1,1,0,0,3,1,1,1,1,2,1
KR_6749324125,420,3,123,-4,11,6,7,1,3,4,1,0,4,4,1,3,2,1,2,1,-2,6,4,2,2,4,2,0,4,1,1,1,-1,5,1
KR_6761770366,420,-5,-33,-27,-10,-3,0,3,-5,0,5,-1,6,7,1,4,3,-2,0,2,1,-9,3,0,3,3,-5,0,0,0,-1,-1,1,0,1
KR_6621067812,420,1,40,4,-3,-5,0,5,3,5,2,-5,1,6,1,2,1,3,5,2,0,9,7,2,5,7,-2,0,1,-1,-1,1,1,3,1
KR_6742290818,440,2,-12,6,7,5,5,0,0,2,2,2,3,1,-1,0,1,1,2,1,0,10,-4,0,5,5,5,0,1,1,1,1,-1,2,1
KR_6538545930,420,4,-28,9,4,0,2,2,0,3,3,0,2,2,4,4,0,0,0,0,0,2,-280,-2,5,3,2,0,-1,1,-1,-1,-1,5,1
KR_6767155719,420,1,-13,8,6,2,2,0,1,2,1,-1,1,2,5,5,0,-1,0,1,0,6,10,-1,5,4,1,0,0,1,-1,0,1,3,1
KR_6698766246,420,4,78,-23,8,5,5,0,2,5,3,1,4,3,-2,3,5,2,2,0,0,-1,-2,0,4,4,2,0,1,1,-1,1,1,2,1
KR_6739073800,420,2,-3,39,10,1,2,1,7,11,4,1,1,0,0,2,2,1,1,0,2,11,-422,5,2,7,20,0,-1,1,1,1,1,6,1
KR_6683865109,420,0,14,-5,-3,-1,2,3,0,2,2,-1,1,2,-2,2,4,1,3,2,0,-3,-25,-2,7,5,1,0,0,-1,-1,0,-1,2,1
KR_6731494282,420,0,-10,-27,-1,-1,1,2,-1,1,2,5,6,1,-4,1,5,0,3,3,0,-5,-186,2,1,3,-5,0,2,1,1,1,-1,3,1
KR_6705304488,420,4,18,32,5,4,4,0,1,2,1,3,4,1,-3,4,7,0,1,1,0,5,-5,-1,6,5,-6,0,-1,-1,1,-1,1,6,1
KR_6757132582,420,0,0,27,3,4,5,1,-4,5,9,2,3,1,1,2,1,0,3,3,0,-1,-7,-6,8,2,0,0,0,1,1,0,-1,3,1
KR_6740562631,440,-1,81,-4,-5,0,1,1,1,2,1,-3,2,5,1,1,0,-4,0,4,0,-6,5,0,5,5,-2,0,1,-1,1,1,1,2,1
KR_6767222531,420,1,-10,43,0,0,1,1,-4,0,4,4,4,0,0,2,2,0,1,1,0,2,36,1,3,4,-18,0,0,1,1,1,-1,4,1
KR_6655598921,420,6,113,38,6,5,5,0,1,4,3,1,1,0,-5,0,5,4,4,0,0,2,322,0,2,2,1,0,1,1,1,1,1,3,1
KR_6569447763,440,-1,-17,-12,1,-1,1,2,-3,2,5,4,5,1,1,1,0,0,1,1,0,0,9,3,4,7,-3,0,1,-1,1,1,1,5,1
KR_6646137271,420,1,16,1,0,1,1,0,1,2,1,-5,2,7,2,6,4,1,1,0,0,-1,-2,-3,6,3,0,0,0,-1,1,1,-1,2,1
KR_6764482122,420,-2,20,-40,-2,-1,3,4,-2,0,2,0,4,4,0,1,1,1,1,0,0,4,-124,0,2,2,2,0,0,-1,0,0,1,1,1
KR_6744456149,420,2,91,0,5,0,1,1,2,4,2,2,4,2,0,0,0,1,4,3,0,8,3,1,4,5,1,0,1,0,1,1,1,0,1
KR_6759422327,420,-1,-56,4,3,4,4,0,2,5,3,4,5,1,-3,0,3,-4,0,4,0,-3,69,2,4,6,-5,0,1,1,1,1,1,6,1
KR_6680895491,420,6,95,-10,19,5,5,0,5,5,0,4,5,1,4,5,1,1,1,0,1,19,-2,-2,5,3,2,0,3,-1,1,1,1,6,1
KR_6762426500,420,3,-4,19,11,1,3,2,2,2,0,-1,0,1,4,6,2,5,5,0,0,11,28,-5,8,3,1,0,1,1,1,1,-1,4,1
KR_6745323032,420,5,48,4,6,3,4,1,1,1,0,-1,3,4,2,2,0,1,1,0,1,11,-19,1,3,4,-22,0,0,-1,1,0,1,4,1
KR_6665774702,420,0,-20,-8,-3,-2,0,2,-2,2,4,1,4,3,-1,4,5,1,3,2,0,-4,-1,-1,4,3,1,0,0,0,-1,0,-1,0,1
KR_6327141805,440,7,7,8,18,6,8,2,2,2,0,0,3,3,5,5,0,5,5,0,0,11,-34,1,4,5,4,0,1,1,1,1,1,2,1
KR_6759860422,420,2,63,26,7,-1,0,1,4,5,1,0,1,1,5,6,1,-1,3,4,1,2,-210,-1,6,5,4,0,1,1,1,1,1,6,1
KR_6702715460,420,3,52,-32,5,-1,2,3,3,3,0,5,5,0,1,3,2,-3,1,4,0,-1,7,-3,6,3,0,0,0,1,-1,0,-1,2,1
KR_6746605996,420,3,29,-29,4,3,5,2,3,5,2,0,1,1,-3,2,5,1,2,1,0,0,1,-2,7,5,-1,0,1,-1,-1,1,-1,6,1
KR_6608196457,420,1,-11,12,4,4,4,0,2,3,1,-2,0,2,0,3,3,0,2,2,0,3,50,0,5,5,-13,0,0,1,-1,0,1,6,1
KR_6746605429,440,4,34,28,-1,-1,0,1,1,2,1,4,5,1,-4,2,6,-1,1,2,1,2,3,1,2,3,3,0,1,1,1,1,1,2,1
KR_6742079368,420,-2,-17,-20,-6,0,0,0,-3,0,3,2,3,1,-4,0,4,-1,2,3,0,-9,-4,-4,7,3,3,0,0,-1,-1,-1,-1,3,1
KR_6554062682,420,3,90,-21,4,3,5,2,1,3,2,3,3,0,-2,1,3,-1,2,3,0,2,-3,3,2,5,5,0,1,1,-1,1,1,6,1
KR_6702816920,420,0,76,5,6,2,4,2,-2,6,8,2,3,1,3,5,2,1,3,2,0,8,6,2,3,5,-2,0,0,1,1,1,1,5,1
KR_6756554131,420,6,75,8,12,2,3,1,10,11,1,3,6,3,-4,0,4,1,3,2,1,5,12,3,1,4,0,0,2,1,1,1,1,5,1
KR_6661442151,420,4,-17,36,7,-3,1,4,2,5,3,3,5,2,3,5,2,2,2,0,0,11,7,0,4,4,-3,0,1,1,1,1,-1,3,1
KR_6762661583,420,2,28,4,4,-3,2,5,1,3,2,-1,3,4,7,8,1,0,0,0,0,10,3,-1,5,4,0,0,0,0,-1,-1,-1,0,1
KR_6751267112,420,5,67,36,11,1,2,1,7,9,2,-1,1,2,5,10,5,-1,1,2,0,11,12,1,3,4,-2,0,1,1,0,1,1,3,1
KR_6694386685,420,3,52,4,8,2,3,1,2,6,4,3,3,0,0,2,2,1,3,2,-1,9,9,3,0,3,3,0,2,1,1,1,-1,3,1
KR_6755988417,420,-2,-47,1,-2,1,2,1,0,3,3,-1,3,4,-2,1,3,0,0,0,-1,-4,45,-5,9,4,-33,0,1,-1,1,1,-1,1,1
KR_6686086493,420,2,60,-12,10,1,2,1,4,5,1,1,2,1,2,2,0,2,2,0,0,13,-18,5,5,10,5,0,0,1,1,1,1,2,1
KR_6760539692,420,3,-27,12,6,3,4,1,4,5,1,1,2,1,1,2,1,-3,1,4,0,2,28,6,1,7,-1,0,-1,-1,1,-1,1,1,1
KR_6731623496,420,3,75,10,3,1,1,0,-1,2,3,3,4,1,2,4,2,-2,2,4,0,-4,-2,-2,6,4,4,0,1,-1,1,1,1,6,1
KR_6727716766,440,3,0,22,2,1,4,3,4,8,4,-2,1,3,1,5,4,-2,1,3,-1,-2,23,2,3,5,0,0,0,1,-1,0,-1,6,1
KR_6319117983,420,6,29,32,7,-2,0,2,6,8,2,5,6,1,-4,0,4,2,2,0,0,4,-4,-2,6,4,4,0,2,1,1,1,1,5,1
KR_6639938321,420,2,76,1,2,0,2,2,2,4,2,-1,0,1,0,2,2,1,1,0,0,7,-3,-4,9,5,1,0,1,-1,-1,1,1,5,1
KR_6644093642,420,3,-28,4,8,-1,1,2,3,5,2,2,3,1,3,3,0,1,1,0,0,8,-50,4,2,6,27,0,0,1,1,1,1,5,1
KR_6755442189,420,2,98,18,5,-1,1,2,1,3,2,3,4,1,1,2,1,1,2,1,1,6,-2,-3,5,2,1,0,2,1,1,1,1,2,1
KR_6767563898,420,2,48,-20,4,3,3,0,0,1,1,7,7,0,-4,1,5,-2,0,2,0,5,11,0,2,2,-2,0,0,0,1,-1,1,0,1
KR_6722205181,420,2,35,-14,2,1,2,1,2,7,5,-3,1,4,2,2,0,0,1,1,0,2,-4,2,5,7,-3,0,0,-1,1,0,1,5,1
KR_6739905117,420,2,-4,51,6,2,3,1,1,7,6,-1,2,3,1,2,1,3,3,0,1,5,67,-2,3,1,3,0,2,1,1,1,1,4,1
KR_6703018670,420,-3,-9,-5,-4,-1,2,3,-4,1,5,0,3,3,0,3,3,1,1,0,0,0,1,-3,6,3,-5,0,1,1,1,1,1,2,1
KR_6695624299,420,0,52,-43,5,2,2,0,-1,2,3,0,4,4,3,3,0,1,1,0,-1,4,-7,0,4,4,-2,0,2,-1,1,1,-1,3,1
KR_6615292635,420,1,1,-33,7,5,5,0,0,2,2,1,3,2,-1,2,3,2,3,1,0,-1,297,-4,7,3,4,0,0,-1,1,0,1,4,1
KR_6467156492,420,5,40,8,11,2,5,3,2,4,2,4,5,1,3,5,2,0,2,2,1,0,3,-4,10,6,1,0,0,-1,-1,-1,1,6,1
KR_6765385565,420,4,75,-8,12,4,4,0,1,4,3,4,8,4,2,4,2,1,2,1,0,-3,-3,3,2,5,12,0,0,0,1,1,1,0,1
KR_6736527671,420,5,102,20,10,-1,0,1,2,2,0,7,9,2,2,3,1,0,1,1,0,5,7,-1,4,3,1,0,1,1,0,1,1,3,1
KR_6606093213,420,0,13,10,0,-2,0,2,-1,3,4,2,2,0,2,3,1,-1,4,5,0,5,3,-2,7,5,0,0,1,-1,1,1,1,1,1
KR_6765976604,420,-1,-27,0,1,-5,0,5,3,4,1,-3,0,3,5,7,2,1,2,1,0,10,-8,3,3,6,1,0,0,1,-1,1,1,1,1
KR_6761962007,420,4,59,12,15,2,2,0,2,4,2,6,9,3,5,7,2,0,2,2,1,15,2,4,2,6,-4,0,1,1,1,1,1,4,1
KR_6375290629,420,2,-47,32,-6,1,2,1,4,5,1,-2,1,3,-6,0,6,-3,0,3,-2,-11,0,0,0,0,0,0,0,-1,-1,0,-1,2,1
KR_6715484323,420,1,0,16,7,8,9,1,1,1,0,-2,2,4,1,3,2,-1,1,2,0,5,103,2,2,4,-1,0,1,1,-1,1,1,5,1
KR_6704455870,420,1,79,-34,-1,-2,0,2,-2,1,3,-2,1,3,5,5,0,0,0,0,0,-5,0,2,3,5,2,0,0,-1,-1,1,1,2,1
KR_6761152301,420,1,23,3,6,1,5,4,1,1,0,1,4,3,4,5,1,-1,1,2,1,5,0,2,4,6,-1,0,0,-1,1,-1,1,3,1
KR_6716512609,420,5,83,22,11,6,8,2,0,6,6,-3,1,4,6,8,2,2,3,1,2,10,-15,-1,3,2,1,0,3,1,1,1,1,6,1
KR_6761906930,440,-3,-41,-56,-1,-1,1,2,6,10,4,-1,2,3,-3,2,5,-2,1,3,0,2,-2,0,3,3,1,0,0,-1,-1,-1,1,6,1
KR_6761592391,420,2,40,5,13,5,6,1,-2,1,3,4,6,2,8,8,0,-2,1,3,0,8,-88,4,4,8,3,0,1,1,-1,1,1,1,1
KR_6755076854,420,1,-14,8,0,1,1,0,-1,1,2,-1,1,2,1,5,4,0,0,0,0,-2,-8,-4,8,4,-2,0,2,1,1,1,1,4,1
KR_6682095339,440,2,16,24,-3,0,2,2,-3,1,4,-2,2,4,0,2,2,2,2,0,0,1,13,1,4,5,-1,0,-1,-1,-1,-1,1,1,1
KR_6604058296,420,0,-13,6,2,0,1,1,0,1,1,3,6,3,-1,2,3,0,2,2,0,-4,6,-6,8,2,3,0,0,-1,1,1,1,6,1
KR_6675893164,420,1,64,8,-1,0,1,1,-4,1,5,9,9,0,-4,1,5,-2,0,2,0,-12,-218,0,2,2,0,0,-1,-1,-1,-1,1,3,1
KR_6750142818,420,2,-50,32,2,-1,1,2,2,5,3,1,4,3,0,7,7,0,1,1,0,-1,0,5,2,7,-1,0,0,-1,-1,-1,-1,6,1
KR_6767081174,440,-1,88,-8,-5,5,5,0,-4,2,6,-3,0,3,-5,0,5,2,2,0,0,-10,-6,-1,7,6,0,0,0,-1,1,1,1,6,1
KR_6766198313,420,-4,-21,-20,-9,-2,1,3,-2,0,2,-5,2,7,4,6,2,-4,0,4,0,1,65,2,2,4,0,0,0,1,-1,-1,1,6,1
KR_6680626468,420,-2,-18,8,-8,1,2,1,-1,1,2,-4,1,5,-2,2,4,-2,0,2,0,-3,-3,-6,9,3,6,0,0,1,-1,0,1,1,1
KR_6759606454,420,3,27,-8,2,2,2,0,3,4,1,-5,0,5,2,3,1,0,1,1,0,-2,15,-4,7,3,-2,0,2,1,1,1,-1,2,1
KR_6762680666,420,4,1,29,9,2,2,0,3,3,0,4,8,4,1,4,3,-1,0,1,0,10,-2,-2,6,4,-2,0,0,1,0,-1,1,6,1
KR_6764566890,420,3,53,26,9,12,12,0,-5,2,7,-3,0,3,5,6,1,0,0,0,0,0,-6,1,0,1,-3,0,4,1,1,1,1,2,1
KR_6750912111,420,1,-12,-1,1,-2,2,4,3,3,0,-2,2,4,0,2,2,2,2,0,-1,2,-23,3,3,6,-2,0,0,1,1,1,-1,3,1
KR_6753269058,420,2,50,24,-2,-3,1,4,-3,2,5,5,5,0,-2,1,3,1,1,0,0,-8,-8,-1,6,5,0,0,0,0,-1,0,-1,0,1
KR_6762742901,420,-2,32,-12,-5,-3,2,5,-1,1,2,-2,0,2,0,1,1,1,1,0,0,3,1,-3,8,5,5,0,0,-1,-1,-1,1,6,1
KR_6635537401,420,3,12,13,5,-2,0,2,5,7,2,1,1,0,0,2,2,1,1,0,1,9,22,1,4,5,2,0,0,1,-1,1,1,1,1
KR_6658716100,420,-2,4,-3,0,-2,0,2,-2,2,4,-1,3,4,5,5,0,0,0,0,0,4,22,3,3,6,-2,0,0,1,0,0,1,1,1
KR_6752389429,420,4,49,-6,5,-4,0,4,9,11,2,-3,1,4,2,2,0,1,1,0,0,7,-8,4,1,5,0,0,1,-1,1,1,1,5,1
KR_6742027623,420,1,-4,29,-2,0,1,1,4,6,2,-5,2,7,-1,2,3,0,0,0,0,-3,-9,2,5,7,-2,0,0,1,-1,-1,-1,3,1
KR_6761724198,420,2,47,-2,6,0,1,1,2,4,2,-1,2,3,4,4,0,1,2,1,0,7,3,-1,4,3,1,0,0,0,0,0,-1,0,1
KR_6752613648,440,-2,-17,13,-2,-4,0,4,-1,3,4,0,2,2,4,4,0,-1,1,2,0,4,334,-3,5,2,2,0,0,-1,1,1,-1,1,1
KR_6765659166,420,1,8,-12,4,4,5,1,4,4,0,-1,2,3,-2,3,5,-1,2,3,0,6,46,-1,7,6,-26,0,0,-1,-1,-1,-1,5,1
KR_6752187609,420,-2,27,-5,1,-1,1,2,3,4,1,-2,1,3,2,2,0,-1,0,1,0,1,-19,2,4,6,-6,0,0,-1,-1,-1,-1,6,1
KR_6543771938,420,-2,-32,-26,-4,0,2,2,-2,1,3,3,3,0,-5,1,6,0,2,2,0,-5,-4,-1,4,3,-1,0,0,1,1,1,-1,1,1
KR_6748484843,440,-3,-35,-8,-9,0,1,1,-6,3,9,-2,0,2,4,7,3,-5,2,7,1,-6,30,-3,3,0,-1,0,1,-1,-1,-1,1,5,1
KR_6747607672,420,7,81,16,21,2,2,0,6,6,0,6,6,0,4,6,2,3,5,2,0,27,0,-2,3,1,3,0,2,1,1,1,1,3,1
KR_6709281574,440,4,-1,9,8,0,1,1,0,3,3,4,5,1,6,7,1,-2,0,2,0,8,130,-1,5,4,4,0,2,-1,1,1,-1,2,1
KR_6753025254,420,0,-63,-12,1,0,1,1,4,6,2,-2,2,4,-1,0,1,0,0,0,1,6,-2,-2,6,4,-4,0,-2,1,-1,-1,1,1,1
KR_6562090990,420,-2,22,-21,-9,-2,1,3,-2,1,3,2,2,0,-1,1,2,-6,2,8,-1,-10,35,5,3,8,-3,0,0,1,1,0,-1,5,1
KR_6730198136,440,7,68,16,13,5,5,0,0,2,2,2,5,3,6,6,0,0,5,5,0,21,7,7,3,10,2,0,1,1,1,1,1,6,1
KR_6705336334,440,2,96,5,3,3,3,0,0,4,4,-3,1,4,-1,4,5,4,4,0,-1,2,7,2,5,7,-3,0,0,-1,0,1,-1,5,1
KR_6764991915,420,0,-37,5,5,3,5,2,-1,4,5,0,2,2,0,2,2,3,3,0,-1,-6,-98,2,3,5,-2,0,-1,1,1,-1,-1,5,1
KR_6731612110,420,-3,38,5,-4,1,5,4,0,2,2,-7,1,8,1,1,0,1,1,0,0,-1,-4,-1,7,6,2,0,1,1,-1,-1,-1,6,1
KR_6729670605,420,2,-33,-20,2,6,6,0,0,0,0,-2,1,3,-3,0,3,1,1,0,0,0,-13,-2,2,0,1,0,0,-1,1,1,1,4,1
KR_6720724641,420,2,64,-32,6,6,8,2,-8,0,8,6,8,2,3,4,1,-1,0,1,1,5,6,-4,7,3,3,0,2,-1,1,1,1,1,1
KR_6728807630,420,1,44,9,6,-1,2,3,4,6,2,1,2,1,0,2,2,2,3,1,1,6,-136,0,5,5,4,0,0,0,1,1,1,0,1
KR_6753172342,420,1,26,4,7,0,3,3,3,5,2,5,6,1,-1,1,2,0,0,0,0,8,-9,-4,5,1,3,0,1,1,-1,1,1,2,1
KR_6767332934,420,-3,27,-23,-7,5,6,1,-5,0,5,-3,2,5,-3,1,4,-1,0,1,0,-11,2,2,4,6,-1,0,1,-1,0,1,-1,5,1
KR_6713757242,420,2,-67,-5,6,0,3,3,3,3,0,-2,2,4,1,2,1,4,5,1,0,5,-6,3,5,8,1,0,-1,1,1,-1,-1,1,1
KR_6761565075,420,1,45,-3,-2,-1,1,2,1,4,3,-2,1,3,-1,4,5,1,2,1,0,0,103,-2,6,4,-2,0,1,-1,-1,1,1,6,1
KR_6758030500,420,2,49,24,4,2,2,0,0,1,1,1,3,2,0,1,1,1,1,0,0,1,3,3,1,4,0,0,1,1,1,1,1,3,1
KR_6757553371,420,-2,-26,1,3,1,3,2,1,2,1,-3,1,4,4,4,0,0,0,0,1,9,2,-2,5,3,-5,0,0,1,0,0,1,6,1
KR_6760585232,420,3,60,-4,7,-3,0,3,3,4,1,4,4,0,1,3,2,2,2,0,0,9,2,1,5,6,-2,0,0,-1,1,0,-1,2,1
KR_6762803474,440,3,98,-4,7,0,1,1,1,1,0,-1,3,4,6,6,0,1,4,3,1,7,32,6,1,7,-2,0,1,1,-1,1,1,3,1
KR_6709611756,420,2,-38,7,7,3,3,0,3,3,0,0,2,2,1,4,3,0,1,1,0,6,24,3,1,4,1,0,1,1,1,1,-1,3,1
KR_6752606004,420,-4,-113,-33,-4,-4,0,4,4,7,3,-1,2,3,-2,2,4,-1,0,1,0,3,1,-7,8,1,2,0,0,-1,1,-1,-1,6,1
KR_6764714521,440,6,68,-16,4,5,5,0,-2,2,4,-2,3,5,6,10,4,-3,3,6,0,-3,-13,-7,8,1,2,0,2,1,-1,1,1,4,1
KR_6735660434,420,4,67,40,3,0,1,1,1,3,2,0,4,4,3,6,3,-1,0,1,0,-1,7,-1,3,2,-1,0,1,-1,1,1,1,3,1
KR_6725692384,420,4,110,-8,4,3,4,1,2,4,2,-2,1,3,0,1,1,1,2,1,0,-2,16,1,4,5,-3,0,0,-1,1,1,1,1,1
KR_6764921032,420,-3,-21,-36,-3,-1,2,3,-4,0,4,-2,2,4,5,5,0,-1,0,1,0,1,47,3,3,6,-20,0,1,0,1,-1,-1,0,1
KR_6643909565,420,0,45,36,2,2,3,1,-3,1,4,0,3,3,4,5,1,-1,1,2,0,0,22,-5,7,2,0,0,1,-1,-1,1,1,2,1
KR_6764342580,420,0,-13,14,-3,0,2,2,4,5,1,-4,1,5,-3,3,6,0,0,0,0,1,-1,2,4,6,-9,0,1,0,1,1,1,0,1
KR_6767208656,420,-1,8,8,5,3,5,2,-3,0,3,2,3,1,2,3,1,1,1,0,0,3,12,1,6,7,0,0,1,1,1,1,-1,3,1
KR_6738358926,420,2,19,28,3,-3,0,3,0,3,3,3,3,0,5,5,0,-2,0,2,0,4,17,2,5,7,-4,0,1,1,-1,1,-1,1,1
KR_6730136279,440,-2,39,-45,1,-1,3,4,-4,3,7,3,3,0,4,5,1,-1,0,1,0,1,4,1,5,6,3,0,1,1,1,1,-1,3,1
KR_6707063884,440,3,7,20,10,0,3,3,2,3,1,3,3,0,2,3,1,3,3,0,1,8,-1,0,6,6,4,0,1,-1,1,1,1,3,1
KR_6749610006,440,0,15,-8,2,-1,0,1,3,5,2,-2,2,4,0,0,0,2,4,2,0,6,-8,11,3,14,-4,0,0,1,1,0,-1,2,1
KR_6340496452,420,4,30,20,9,-1,1,2,2,2,0,2,3,1,6,6,0,0,1,1,0,9,8,2,3,5,2,0,2,1,-1,1,1,2,1
KR_6749540549,420,7,88,2,9,3,4,1,-1,1,2,4,4,0,2,3,1,1,2,1,0,6,7,5,0,5,2,0,3,0,1,1,1,0,1
KR_6748468316,420,1,31,-4,-2,5,6,1,-2,1,3,0,1,1,-3,1,4,-2,0,2,0,-1,45,4,1,5,-25,0,1,1,1,1,-1,2,1
KR_6730343920,440,-2,-37,-24,-1,4,4,0,-4,1,5,1,3,2,-2,2,4,0,0,0,-2,4,-45,0,3,3,16,0,-1,1,-1,-1,-1,2,1
KR_6756308556,440,2,13,-9,5,3,3,0,-3,2,5,0,2,2,5,5,0,0,0,0,0,8,9,-1,4,3,0,0,1,-1,1,1,1,2,1
KR_6722982071,420,-3,-59,-5,4,-1,2,3,1,2,1,-2,2,4,5,5,0,1,1,0,0,7,-30,4,6,10,1,0,0,1,-1,0,-1,6,1
KR_6765454462,420,-2,-12,11,-7,-2,1,3,-1,2,3,1,6,5,-5,0,5,0,1,1,0,-11,-34,2,4,6,-3,0,0,1,1,0,-1,3,1
KR_6764953597,420,5,67,40,7,3,5,2,4,5,1,4,6,2,-2,3,5,-2,1,3,0,3,9,-3,3,0,1,0,2,0,-1,1,1,0,1
KR_6673001815,420,3,22,2,8,0,1,1,2,3,1,-1,4,5,3,5,2,4,5,1,-1,6,17,-2,5,3,1,0,0,1,0,1,-1,4,1
KR_6737611578,420,3,73,36,5,-5,2,7,2,7,5,3,5,2,5,5,0,0,0,0,1,2,15,1,3,4,-2,0,2,1,0,1,1,6,1
KR_6618808041,420,-1,26,20,1,2,2,0,-1,2,3,-3,3,6,-1,3,4,4,4,0,0,8,3,-1,3,2,-2,0,0,1,0,0,1,2,1
KR_6765565641,440,0,0,24,-1,2,3,1,-2,3,5,0,2,2,2,4,2,-3,0,3,0,-2,-339,7,1,8,-4,0,-1,1,1,-1,-1,4,1
KR_6763368397,420,1,62,-4,0,0,2,2,7,11,4,-5,2,7,0,2,2,-2,0,2,0,-11,-13,3,2,5,-3,0,3,-1,1,1,1,6,1
KR_6760960019,420,1,-9,13,0,1,4,3,3,4,1,3,3,0,-6,1,7,-1,1,2,0,-4,28,-1,3,2,0,0,1,1,-1,1,-1,3,1
KR_6632197502,420,6,71,28,16,6,7,1,2,4,2,3,5,2,3,3,0,2,2,0,0,11,-13,4,1,5,2,0,1,1,1,1,-1,5,1
KR_6614796374,420,0,58,-24,14,1,1,0,5,9,4,1,3,2,8,10,2,-1,1,2,3,14,1,4,2,6,-1,0,0,1,1,1,1,1,1
KR_6694837861,420,2,-13,13,5,4,5,1,0,5,5,0,1,1,0,2,2,1,1,0,0,6,-4,-3,6,3,8,0,1,1,1,1,-1,3,1
KR_6738227461,420,-2,66,-12,-1,0,2,2,-1,0,1,-2,1,3,3,4,1,-1,0,1,0,-1,-128,0,4,4,-1,0,0,1,-1,0,1,1,1
KR_6751314188,420,-1,-27,-9,-1,0,2,2,0,3,3,-7,2,9,5,7,2,1,2,1,0,7,7,-2,4,2,-1,0,0,0,-1,0,1,0,1
KR_6759712846,440,3,80,34,5,4,5,1,-5,4,9,1,4,3,5,8,3,0,0,0,2,11,3,8,3,11,0,0,1,-1,1,1,1,2,1
KR_6675797577,420,4,55,37,6,0,1,1,0,4,4,3,4,1,2,3,1,1,1,0,0,6,-2,-2,4,2,2,0,0,1,1,0,1,2,1
KR_6728644320,420,3,-25,13,5,4,4,0,1,2,1,2,5,3,-1,2,3,-1,0,1,0,9,43,1,5,6,1,0,0,-1,-1,0,-1,4,1
KR_6706397256,420,0,74,-1,-8,0,4,4,-8,1,9,1,1,0,-1,2,3,0,1,1,0,-9,1,6,1,7,-7,0,0,1,-1,0,-1,2,1
KR_6708412144,420,5,88,8,9,3,3,0,8,9,1,1,4,3,-5,2,7,2,4,2,-1,7,-3,3,4,7,-2,0,1,0,1,1,-1,0,1
KR_6620983802,420,4,19,-9,13,-3,3,6,1,3,2,12,12,0,4,6,2,-1,3,4,2,14,-10,-2,4,2,10,0,3,0,1,1,1,0,1
KR_6757755085,420,2,25,0,2,0,3,3,-3,0,3,-1,3,4,5,6,1,1,1,0,0,-3,2,0,4,4,1,0,0,1,1,-1,-1,3,1
KR_6695517874,420,2,69,-20,6,1,1,0,-1,2,3,2,5,3,-2,0,2,6,10,4,0,4,-6,-1,3,2,2,0,2,0,0,1,1,0,1
KR_6761349091,420,0,24,0,0,-3,1,4,0,6,6,3,3,0,0,1,1,0,1,1,0,-3,5,-3,6,3,3,0,1,0,-1,1,1,0,1
KR_6571269975,440,4,53,4,2,0,1,1,-2,1,3,0,2,2,0,4,4,4,6,2,0,-3,4,1,5,6,3,0,2,-1,1,1,-1,4,1
KR_6742939264,420,1,-14,17,5,2,2,0,5,6,1,-5,1,6,2,4,2,1,2,1,-1,7,-11,4,3,7,-4,0,0,0,-1,1,-1,0,1
KR_6751958964,420,3,47,-4,7,2,6,4,3,6,3,2,3,1,1,2,1,-1,1,2,-1,5,5,2,2,4,0,0,0,1,1,1,-1,4,1
KR_6735855865,440,2,107,24,3,2,3,1,1,2,1,0,0,0,0,1,1,0,2,2,0,2,-71,-1,7,6,4,0,0,-1,1,1,-1,1,1
KR_6647444995,420,-3,-67,7,-3,1,4,3,-4,3,7,1,2,1,0,0,0,-1,0,1,0,1,-12,1,6,7,2,0,-1,-1,-1,-1,-1,1,1
KR_6759599523,420,2,41,12,4,0,0,0,6,8,2,3,4,1,-4,0,4,-1,0,1,0,-2,4,3,2,5,6,0,0,-1,0,0,1,6,1
KR_6701593761,420,-2,12,-12,-1,3,3,0,0,2,2,4,7,3,-11,2,13,3,6,3,0,-9,-6,-2,6,4,-1,0,0,-1,1,-1,-1,3,1
KR_6748676010,420,-4,-70,27,-5,-6,0,6,-1,2,3,-2,1,3,3,4,1,1,1,0,-1,-3,11,-5,6,1,5,0,0,-1,1,0,-1,4,1
KR_6758300256,420,-1,-26,-4,2,4,6,2,1,2,1,2,3,1,-5,0,5,0,0,0,-1,-2,4,-2,6,4,-4,0,0,-1,-1,1,-1,4,1
KR_6720546800,420,8,83,-3,13,2,3,1,3,3,0,2,3,1,7,7,0,-1,0,1,0,12,15,5,2,7,1,0,1,1,-1,1,1,1,1
KR_6758772987,440,8,41,8,11,4,9,5,1,3,2,5,6,1,-1,4,5,2,4,2,-2,2,5,0,2,2,0,0,1,0,0,1,-1,0,1
KR_6766580986,420,2,-22,9,2,0,3,3,4,4,0,1,1,0,-1,4,5,-2,1,3,0,-5,6,-1,3,2,1,0,-1,-1,1,-1,-1,4,1
KR_6740545879,440,1,4,8,7,-5,1,6,2,3,1,2,3,1,6,8,2,2,2,0,0,2,-1,-3,6,3,2,0,0,1,-1,1,1,3,1
KR_6751286341,420,3,-2,0,7,4,5,1,-6,1,7,4,5,1,3,4,1,2,3,1,-2,2,118,1,2,3,0,0,2,1,0,1,-1,6,1
KR_6764741879,420,-2,15,0,1,-2,0,2,0,3,3,5,7,2,-1,0,1,-1,0,1,0,3,6,6,1,7,3,0,-1,-1,1,-1,1,3,1
KR_6625002552,420,0,-25,-8,1,3,4,1,-1,1,2,-4,0,4,3,4,1,0,0,0,0,1,7,7,1,8,-6,0,0,-1,-1,0,1,6,1
KR_6665571785,420,0,3,19,-1,-5,1,6,-3,0,3,2,6,4,4,4,0,1,1,0,0,10,-2,3,3,6,-1,0,0,1,-1,0,1,5,1
KR_6739462702,420,4,43,36,9,2,2,0,0,4,4,6,8,2,-3,3,6,4,6,2,1,-1,-3,0,4,4,-3,0,1,-1,1,1,1,6,1
KR_6762272882,420,4,67,-4,6,-1,1,2,0,4,4,1,4,3,1,3,2,5,5,0,0,9,7,1,5,6,6,0,0,1,0,0,1,1,1
KR_6615336546,420,3,8,-3,5,3,4,1,0,1,1,-3,1,4,4,5,1,1,2,1,0,1,108,-2,5,3,-1,0,1,-1,-1,-1,-1,1,1
KR_6756863271,420,-1,-21,-20,0,-3,1,4,5,9,4,-1,2,3,0,1,1,-1,1,2,0,0,6,1,5,6,-2,0,0,-1,1,1,1,6,1
KR_6739577068,420,4,68,32,5,3,3,0,4,4,0,1,7,6,-2,3,5,-1,0,1,1,0,56,0,5,5,-21,0,1,1,1,1,1,6,1
KR_6555338488,420,0,85,7,3,8,9,1,-1,4,5,-5,0,5,0,2,2,1,2,1,0,-7,71,-2,7,5,-2,0,1,-1,1,1,1,2,1
KR_6723078360,420,5,9,-4,13,0,1,1,5,5,0,2,4,2,5,5,0,1,1,0,0,22,-6,2,3,5,1,0,0,1,1,1,1,4,1
KR_6653071943,420,-2,15,-12,-4,0,3,3,0,5,5,-4,1,5,-3,1,4,3,4,1,1,-6,-3,8,3,11,0,0,0,1,1,-1,1,5,1
KR_6705515807,420,2,40,1,6,-1,2,3,2,5,3,-1,1,2,3,4,1,3,3,0,1,6,5,3,5,8,-1,0,1,1,1,1,1,1,1
KR_6743440665,420,4,69,-4,6,1,4,3,3,3,0,0,5,5,1,2,1,1,1,0,1,8,3,1,2,3,4,0,3,1,-1,1,1,3,1
KR_6756378758,420,-1,-16,-36,0,-3,0,3,-2,1,3,-2,1,3,3,4,1,4,4,0,0,9,-2,1,2,3,0,0,1,0,-1,1,1,0,1
KR_6765922440,420,-2,-41,-12,-1,-2,2,4,0,3,3,2,4,2,2,6,4,-3,1,4,0,1,10,5,5,10,-4,0,0,1,1,1,-1,2,1
KR_6764956914,420,4,27,12,13,-5,2,7,3,5,2,7,7,0,7,7,0,1,2,1,1,15,280,-1,5,4,-14,0,1,-1,-1,1,1,4,1
KR_6763123051,420,0,-9,-23,0,-2,0,2,-1,3,4,-2,2,4,5,10,5,0,0,0,0,12,-3,2,5,7,-5,0,0,-1,1,-1,1,4,1
KR_6766771982,420,-1,4,-16,1,-5,1,6,0,1,1,-4,2,6,6,9,3,4,4,0,0,5,50,-1,3,2,-1,0,-1,1,1,-1,-1,4,1
KR_6637821574,420,-2,16,-18,3,-3,2,5,1,5,4,0,0,0,5,6,1,0,0,0,0,9,3,2,4,6,4,0,1,1,1,1,-1,6,1
KR_6758341010,420,-1,-54,-15,8,-1,0,1,3,5,2,7,10,3,-3,2,5,2,2,0,0,15,7,11,2,13,-4,0,0,-1,1,0,1,2,1
KR_6638451914,420,2,40,44,-2,1,2,1,0,5,5,-2,0,2,3,4,1,-4,0,4,0,-1,467,2,3,5,1,0,0,1,-1,1,-1,4,1
KR_6759392156,420,0,-29,8,-3,-3,2,5,0,3,3,-5,2,7,2,3,1,3,4,1,0,3,2,-2,5,3,-2,0,2,1,1,1,1,1,1
KR_6758021238,440,1,-26,7,1,3,4,1,-3,0,3,-2,3,5,2,5,3,1,2,1,0,0,-5,-6,6,0,1,0,2,-1,1,1,1,3,1
KR_6339894384,420,3,25,15,2,-3,0,3,-2,4,6,3,4,1,4,4,0,0,0,0,0,1,7,-2,4,2,4,0,1,1,-1,1,-1,1,1
KR_6758792734,420,0,-48,22,-3,-2,1,3,1,2,1,0,3,3,-2,2,4,0,1,1,-2,-7,33,-3,4,1,-1,0,-1,-1,-1,-1,-1,6,1
KR_6761383379,420,-1,-37,12,2,1,3,2,0,0,0,-2,5,7,5,5,0,-2,0,2,0,3,26,-3,5,2,-6,0,-1,1,1,-1,1,4,1
KR_6762995859,420,0,-21,-17,2,0,4,4,-1,0,1,-4,0,4,3,3,0,4,4,0,0,7,3,1,2,3,0,0,0,1,-1,-1,-1,6,1
KR_6740609474,440,4,-25,-12,11,0,1,1,1,2,1,6,7,1,4,6,2,0,1,1,0,15,2,2,2,4,-1,0,2,0,0,1,1,0,1
KR_6756843907,420,-2,-24,-15,4,-3,1,4,3,4,1,1,3,2,3,5,2,0,1,1,0,8,-15,1,4,5,4,0,0,1,-1,0,1,3,1
KR_6764637754,420,2,-16,21,8,0,2,2,4,4,0,7,7,0,-1,3,4,-2,0,2,0,5,14,1,5,6,1,0,0,-1,0,0,1,3,1
KR_6720411033,440,2,46,48,-2,2,4,2,-3,3,6,-1,0,1,1,3,2,-1,0,1,0,-7,2,-4,8,4,3,0,0,1,1,0,-1,4,1
KR_6762251926,420,2,-42,-14,9,0,5,5,3,3,0,3,4,1,3,3,0,0,0,0,0,12,-4,0,4,4,2,0,2,1,1,1,-1,1,1
KR_6730006035,420,0,51,18,-4,2,3,1,-2,4,6,1,4,3,-3,0,3,-2,0,2,0,-14,13,-5,7,2,2,0,1,-1,0,1,-1,6,1
KR_6732993516,420,-2,23,8,-1,2,2,0,1,4,3,-1,0,1,-2,4,6,-1,1,2,0,-4,-10,3,3,6,-2,0,0,1,1,-1,-1,1,1
KR_6750548243,420,0,31,5,-6,3,3,0,-3,5,8,-4,0,4,-2,1,3,0,0,0,0,-9,-60,2,2,4,-4,0,0,-1,-1,0,1,5,1
KR_6764959087,420,1,34,12,0,2,4,2,1,2,1,-1,3,4,-6,1,7,4,5,1,-1,-1,-3,0,4,4,2,0,0,1,-1,1,-1,2,1
KR_6763944420,420,2,22,-24,7,3,3,0,-1,3,4,1,3,2,5,7,2,-1,2,3,0,9,-7,-4,8,4,1,0,0,-1,-1,0,1,3,1
KR_6764587158,440,2,35,-4,5,2,4,2,-1,0,1,-1,0,1,6,6,0,-1,1,2,0,12,-6,3,4,7,-1,0,1,1,-1,1,1,1,1
KR_6679577336,420,3,38,-9,1,2,2,0,3,6,3,1,3,2,-7,0,7,2,5,3,0,-8,-1,0,4,4,-2,0,1,0,1,1,-1,0,1
KR_6683132600,440,2,8,35,1,3,4,1,1,4,3,-4,2,6,0,0,0,1,1,0,0,2,14,1,1,2,-3,0,0,1,0,0,-1,1,1
KR_6688023554,420,0,54,-36,-3,2,5,3,-2,1,3,-1,3,4,-1,0,1,-1,0,1,0,-2,2,1,4,5,-4,0,-1,-1,-1,-1,1,6,1
KR_6764490251,420,3,-23,4,5,0,1,1,1,2,1,-2,2,4,5,5,0,1,1,0,0,7,10,-2,4,2,1,0,1,1,1,1,1,5,1
KR_6719114878,420,3,54,48,7,4,5,1,-1,1,2,1,6,5,0,1,1,3,3,0,0,3,-29,0,3,3,0,0,2,-1,1,1,-1,4,1
KR_6765629479,420,-1,22,0,-4,-2,1,3,0,2,2,0,4,4,1,5,4,-3,0,3,0,-6,-28,2,3,5,0,0,0,-1,1,0,1,5,1
KR_6723214213,440,1,-53,15,7,1,2,1,3,5,2,3,7,4,1,1,0,-1,0,1,0,17,22,1,3,4,1,0,1,1,1,1,1,2,1
KR_6759012977,440,1,14,28,9,0,2,2,8,9,1,-2,3,5,0,4,4,3,3,0,1,18,25,-2,5,3,-2,0,0,0,0,-1,1,0,1
KR_6635118226,420,2,27,-1,5,3,3,0,3,5,2,1,3,2,-2,1,3,0,1,1,0,7,8,1,3,4,0,0,0,1,1,1,1,1,1
KR_6750978926,440,3,31,28,11,2,2,0,-2,2,4,4,5,1,5,8,3,2,2,0,2,11,-3,1,2,3,0,0,1,1,-1,1,1,2,1
KR_6693025384,420,-2,-28,-38,-11,-3,0,3,-5,1,6,-2,3,5,-4,1,5,3,5,2,-4,-13,1,-1,4,3,-1,0,-1,-1,1,-1,-1,1,1
KR_6723424232,420,2,25,1,7,-6,0,6,2,4,2,2,3,1,10,10,0,-1,0,1,0,7,151,3,4,7,3,0,1,1,-1,1,1,5,1
KR_6758156691,440,-2,-47,-42,-1,1,3,2,4,4,0,-3,1,4,-3,2,5,0,6,6,0,9,1,-4,8,4,0,0,-1,-1,0,-1,1,5,1
KR_6728204899,440,0,8,-7,5,-2,1,3,1,2,1,1,1,0,3,3,0,2,2,0,0,10,-8,-1,6,5,10,0,1,1,-1,-1,1,3,1
KR_6723003413,420,3,19,24,7,2,5,3,1,2,1,5,6,1,-2,0,2,1,1,0,1,10,-7,3,4,7,1,0,0,1,1,0,1,6,1
KR_6750501558,420,5,28,21,12,2,2,0,2,2,0,1,1,0,4,5,1,3,3,0,0,6,-2,1,2,3,-1,0,1,1,0,1,1,6,1
KR_6679922960,420,2,46,27,-6,0,1,1,1,6,5,-6,1,7,1,5,4,-2,0,2,-1,0,-3,-5,7,2,1,0,0,-1,-1,1,-1,1,1
KR_6656210673,420,5,23,-5,7,3,3,0,2,2,0,0,2,2,0,2,2,2,2,0,0,7,-7,-6,9,3,6,0,0,1,-1,0,-1,1,1
KR_6734013157,420,5,67,-4,9,3,5,2,2,4,2,-1,2,3,4,5,1,1,1,0,0,10,5,3,2,5,6,0,1,1,1,1,1,1,1
KR_6762539835,420,2,39,-7,-2,0,0,0,0,4,4,-1,0,1,1,1,0,-2,0,2,1,4,10,2,2,4,-4,0,1,1,-1,1,1,2,1
KR_6746420724,420,1,21,-16,6,0,3,3,0,3,3,6,8,2,-1,0,1,1,1,0,0,2,-8,2,2,4,3,0,0,1,-1,0,1,1,1
KR_6764891885,440,3,63,9,6,8,9,1,-4,1,5,-2,4,6,3,6,3,1,2,1,0,5,-3,-3,6,3,2,0,-1,1,-1,-1,1,3,1
KR_6651573776,420,2,24,0,1,0,1,1,-1,2,3,4,6,2,0,1,1,-2,0,2,0,4,1,3,1,4,3,0,0,0,-1,0,-1,0,1
KR_6762676538,420,1,-45,-3,-1,-1,2,3,1,3,2,-4,1,5,1,4,3,2,3,1,0,3,1,-2,6,4,-5,0,0,0,-1,0,-1,0,1
KR_6739894560,420,4,126,30,4,2,3,1,-1,2,3,3,3,0,-3,0,3,3,3,0,1,1,5,-2,3,1,-1,0,1,0,-1,1,1,0,1
KR_6691205711,420,2,-35,24,9,0,2,2,2,4,2,-2,3,5,8,8,0,1,1,0,0,12,12,3,4,7,-4,0,1,1,1,1,1,2,1
KR_6713711847,420,2,-27,47,-1,4,5,1,4,4,0,2,6,4,-2,0,2,-9,1,10,0,-5,20,0,3,3,0,0,1,-1,1,1,1,3,1
KR_6732536519,440,1,-1,-16,2,1,3,2,1,3,2,1,3,2,-1,2,3,0,0,0,0,-3,5,0,5,5,0,0,0,0,0,0,1,0,1
KR_6766928936,420,1,-27,32,-6,-3,1,4,0,2,2,2,7,5,-5,0,5,0,0,0,0,-7,-40,1,3,4,3,0,0,1,1,1,-1,4,1
KR_6762865870,420,1,9,3,2,-1,2,3,-4,1,5,2,2,0,4,5,1,1,1,0,0,0,-236,0,2,2,-1,0,1,-1,-1,1,-1,3,1
KR_6704360350,420,-3,-45,-8,-6,-3,3,6,0,1,1,-3,2,5,0,1,1,0,0,0,0,-7,14,4,3,7,-3,0,-2,-1,-1,-1,-1,3,1
KR_6765321351,440,1,-2,8,5,1,1,0,0,1,1,3,4,1,-1,0,1,2,2,0,0,3,12,1,6,7,2,0,0,-1,0,0,-1,6,1
KR_6649177287,420,6,121,0,14,2,3,1,6,6,0,-1,2,3,8,8,0,-1,0,1,0,15,-1,5,3,8,-1,0,1,1,1,1,1,2,1
KR_6643286942,420,4,39,32,7,2,3,1,0,1,1,3,3,0,-1,2,3,3,3,0,0,6,-1,1,5,6,-1,0,2,-1,1,1,1,5,1
KR_6694047262,420,0,-73,32,4,-2,2,4,5,6,1,3,4,1,-4,1,5,2,2,0,0,5,-9,-4,10,6,-2,0,-3,-1,1,-1,1,3,1
KR_6686125568,420,1,25,3,7,6,8,2,0,1,1,-5,1,6,6,7,1,0,2,2,0,7,-13,4,3,7,-3,0,1,1,1,1,1,3,1
KR_6632935299,420,4,61,22,5,5,6,1,1,4,3,1,2,1,-2,1,3,0,2,2,0,-1,-2,-4,7,3,5,0,3,1,1,1,-1,2,1
KR_6661359216,420,3,29,8,3,1,3,2,6,7,1,-1,1,2,-4,4,8,1,2,1,0,1,3,6,1,7,2,0,0,1,1,1,-1,5,1
KR_6767085668,420,0,-118,-28,4,-1,0,1,5,7,2,1,2,1,-2,1,3,1,1,0,0,4,-38,0,4,4,46,0,-1,0,0,-1,-1,0,1
KR_6653239217,420,4,28,8,6,5,5,0,2,3,1,-2,1,3,0,0,0,1,1,0,0,0,-18,1,4,5,1,0,-1,1,1,-1,1,5,1
KR_6761874219,440,-4,21,-16,-10,2,3,1,-2,2,4,2,4,2,-11,0,11,-1,0,1,0,-11,-19,-1,6,5,-1,0,0,1,-1,-1,-1,3,1
KR_6716150318,420,3,9,16,5,1,3,2,1,3,2,3,4,1,-2,3,5,2,2,0,1,-3,-5,-3,4,1,-1,0,1,1,0,1,1,6,1
KR_6762947704,420,4,107,41,12,0,0,0,2,4,2,1,2,1,6,7,1,3,3,0,0,15,1,2,1,3,4,0,2,1,0,1,1,3,1
KR_6726495462,440,-1,-52,-8,-1,-2,0,2,-2,1,3,0,2,2,2,2,0,1,2,1,0,0,-2,1,1,2,1,0,-1,1,-1,-1,1,3,1
KR_6732994218,440,0,59,-19,-1,1,2,1,1,3,2,1,2,1,-4,1,5,0,2,2,0,-2,4,0,2,2,3,0,1,1,-1,1,1,1,1
KR_6733801450,440,0,-30,-16,-1,1,2,1,-3,0,3,1,3,2,0,4,4,0,2,2,0,-3,2,2,1,3,-2,0,0,-1,1,0,1,6,1
KR_6747589125,420,4,11,20,4,1,1,0,2,2,0,4,4,0,-3,1,4,0,0,0,0,5,-15,-1,9,8,7,0,0,1,-1,0,-1,6,1
KR_6751138275,420,-4,-51,-9,-6,1,3,2,-1,1,2,-1,3,4,-3,3,6,-2,1,3,0,-3,-27,-4,7,3,-3,0,0,-1,0,1,1,6,1
KR_6733432238,420,1,54,0,5,1,2,1,0,2,2,1,5,4,2,5,3,1,1,0,1,7,0,0,3,3,4,0,1,-1,0,1,1,6,1
KR_6637179862,420,2,20,15,3,0,0,0,0,1,1,0,0,0,3,3,0,0,0,0,0,3,4,-3,9,6,1,0,1,1,1,1,-1,4,1
KR_6762345141,420,1,78,-29,11,2,3,1,5,5,0,1,4,3,1,2,1,2,2,0,0,10,-25,1,1,2,0,0,1,1,1,-1,1,3,1
KR_6725896608,440,3,75,11,2,-1,0,1,-2,2,4,7,8,1,2,2,0,-4,3,7,-1,-3,-17,-9,12,3,1,0,0,-1,1,1,-1,1,1
KR_6760075461,440,-1,55,-20,2,2,3,1,-1,4,5,-1,2,3,2,2,0,0,1,1,3,5,12,5,2,7,-2,0,1,1,1,1,1,2,1
KR_6620217343,420,3,70,-20,7,2,2,0,-3,2,5,-1,1,2,6,6,0,3,3,0,0,8,-1,1,1,2,2,0,1,-1,0,1,1,1,1
KR_6762788867,420,-1,-26,8,-3,1,1,0,1,2,1,-1,3,4,-6,1,7,2,2,0,-1,-7,-1,1,5,6,1,0,-1,1,-1,-1,-1,3,1
KR_6756472616,420,2,43,28,7,5,5,0,-1,2,3,0,2,2,2,2,0,1,2,1,0,8,-7,3,4,7,-1,0,1,-1,1,1,-1,2,1
KR_6748541423,440,0,-28,27,0,-2,1,3,-4,2,6,0,3,3,4,5,1,2,2,0,0,3,38,3,1,4,-6,0,3,1,1,1,1,3,1
KR_6748364736,420,1,-28,12,-4,-1,1,2,2,5,3,-3,0,3,-2,1,3,0,1,1,0,-2,104,4,1,5,-3,0,2,1,1,1,-1,4,1
KR_6671815096,420,4,101,13,2,1,1,0,-2,1,3,3,3,0,0,0,0,0,0,0,-1,-5,116,1,6,7,-4,0,0,-1,1,1,-1,4,1
KR_6763184933,420,-1,-35,-4,1,2,2,0,1,4,3,2,5,3,-3,0,3,-1,0,1,0,3,9,4,4,8,-6,0,-1,-1,-1,-1,-1,5,1
KR_6756478629,420,5,88,30,16,2,3,1,3,3,0,8,8,0,2,3,1,1,1,0,0,6,-1,2,3,5,4,0,2,1,1,1,1,4,1
KR_6764680316,420,8,81,76,15,4,7,3,4,5,1,4,4,0,0,3,3,3,4,1,0,11,11,1,4,5,1,0,2,0,1,1,1,0,1
KR_6575954143,420,3,8,12,8,4,5,1,6,7,1,-2,2,4,0,5,5,0,1,1,-1,12,-20,-1,4,3,0,0,1,1,-1,1,-1,1,1
KR_6752553107,420,2,-8,8,1,0,1,1,-2,4,6,2,2,0,1,3,2,0,5,5,0,7,121,3,4,7,0,0,2,1,1,1,1,5,1
KR_6765530670,420,2,73,24,4,-1,1,2,3,4,1,4,5,1,0,1,1,-2,0,2,0,1,-12,3,0,3,3,0,1,0,1,1,-1,0,1
KR_6664937430,420,0,-96,7,4,1,2,1,0,3,3,-1,5,6,4,4,0,0,1,1,0,6,15,7,1,8,-2,0,0,1,-1,-1,-1,3,1
KR_6594986431,420,3,-16,10,14,-2,0,2,2,5,3,0,2,2,5,5,0,9,9,0,0,14,33,-2,6,4,2,0,0,1,0,1,-1,6,1
KR_6742426033,420,2,2,28,10,4,4,0,2,5,3,3,3,0,2,6,4,-1,3,4,1,14,16,-4,7,3,3,0,0,-1,1,1,1,1,1
KR_6730525057,440,3,39,4,5,0,2,2,3,5,2,1,3,2,1,4,3,0,0,0,0,1,65,5,1,6,-11,0,1,-1,1,1,1,6,1
KR_6760050287,420,-2,-67,-25,-7,1,1,0,-6,2,8,-1,1,2,0,2,2,-1,0,1,-1,-4,1,1,2,3,-1,0,-1,0,0,-1,-1,0,1
KR_6757040323,420,1,-30,16,-1,-1,0,1,-1,1,2,1,3,2,1,2,1,-1,0,1,-1,-1,-10,0,6,6,1,0,0,1,1,1,-1,1,1
KR_6766986550,420,0,17,-9,0,-2,1,3,3,5,2,-2,3,5,0,1,1,1,1,0,0,13,13,-3,6,3,2,0,0,-1,1,0,-1,6,1
KR_6750569807,420,4,66,34,12,4,5,1,1,3,2,0,3,3,8,9,1,-1,0,1,0,1,-1,4,1,5,1,0,2,1,1,1,1,6,1
KR_6635399190,420,4,54,4,8,0,1,1,5,5,0,3,4,1,0,0,0,0,0,0,0,5,-12,1,5,6,1,0,1,1,1,1,1,3,1
KR_6715648429,420,-1,-39,-11,0,1,2,1,-1,1,2,2,3,1,-2,3,5,0,1,1,0,3,-156,6,2,8,-1,0,0,1,-1,0,-1,3,1
KR_6761403037,440,2,-48,-16,4,-2,1,3,0,2,2,-1,0,1,8,8,0,-1,2,3,0,11,-23,1,4,5,3,0,2,0,-1,1,-1,0,1
KR_6674222679,420,1,-30,14,0,-1,0,1,-4,0,4,7,8,1,-1,1,2,-1,1,2,0,-6,-18,-4,5,1,3,0,1,1,1,1,-1,3,1
KR_6766871677,420,1,59,24,6,2,2,0,2,4,2,2,6,4,0,2,2,0,1,1,0,4,16,-1,4,3,-2,0,0,1,1,0,1,5,1
KR_6754866821,420,3,51,0,6,3,5,2,2,2,0,0,1,1,1,2,1,0,0,0,0,5,0,0,5,5,1,0,0,1,-1,0,1,3,1
KR_6765381792,420,0,62,35,1,3,3,0,3,3,0,2,3,1,-3,1,4,-4,0,4,0,-6,-48,-3,6,3,5,0,0,0,1,1,1,0,1
KR_6749458516,420,0,0,25,4,6,6,0,2,4,2,-1,2,3,-2,3,5,-1,1,2,0,4,-5,-1,6,5,3,0,0,0,1,0,1,0,1
KR_6760640388,420,3,87,4,9,3,3,0,2,3,1,-1,0,1,5,6,1,0,0,0,0,16,-274,1,3,4,2,0,0,1,-1,0,1,6,1
KR_6764233055,420,1,-61,16,7,-1,0,1,0,2,2,1,6,5,5,9,4,2,2,0,0,4,-147,-5,7,2,2,0,-1,1,1,-1,1,1,1
KR_6759522574,440,3,36,48,8,-2,1,3,1,3,2,5,6,1,4,7,3,0,3,3,1,6,-18,2,2,4,2,0,1,1,1,1,1,3,1
KR_6760253185,420,2,33,4,0,0,1,1,-1,3,4,3,3,0,-2,0,2,0,1,1,0,-4,2,2,2,4,-4,0,1,1,0,1,1,2,1
KR_6750717423,420,-1,8,33,-8,7,9,2,2,3,1,-4,2,6,-9,2,11,-4,0,4,0,-11,13,-1,3,2,-1,0,-1,-1,1,-1,-1,3,1
KR_6723055538,420,6,71,16,4,2,2,0,-2,4,6,2,3,1,0,2,2,2,3,1,0,4,41,0,5,5,1,0,3,1,-1,1,1,1,1
KR_6752776296,420,-2,-5,0,-3,-3,1,4,-1,1,2,6,7,1,-2,0,2,-3,1,4,-1,-4,10,5,2,7,-1,0,0,1,1,0,-1,5,1
KR_6673976493,420,9,90,16,8,5,6,1,1,3,2,4,4,0,-2,1,3,0,1,1,0,7,0,2,5,7,6,0,2,1,1,1,1,2,1
KR_6763641725,420,2,27,56,1,-2,4,6,1,1,0,-2,2,4,3,4,1,1,1,0,0,4,-14,0,5,5,2,0,0,1,1,0,-1,2,1
KR_6759191739,420,1,81,11,7,1,3,2,8,13,5,3,4,1,-3,1,4,-2,0,2,0,6,7,8,2,10,-3,0,0,1,-1,-1,1,3,1
KR_6767017740,440,0,28,-6,1,3,5,2,3,3,0,-4,3,7,-2,1,3,1,2,1,0,-4,5,-3,9,6,1,0,2,-1,1,1,-1,2,1
KR_6733244133,440,2,68,-9,15,3,3,0,5,6,1,-1,0,1,2,4,2,6,6,0,0,12,-5,-3,6,3,6,0,0,-1,1,1,1,5,1
KR_6740181621,440,5,79,36,14,0,0,0,0,1,1,9,9,0,2,5,3,3,4,1,0,10,10,-4,5,1,0,0,2,1,-1,1,1,3,1
KR_6728952878,420,4,47,4,7,3,3,0,4,5,1,4,6,2,-3,0,3,-1,1,2,-1,1,-2,1,2,3,0,0,3,0,1,1,-1,0,1
KR_6759680741,420,-1,-24,-20,1,5,8,3,0,3,3,-2,2,4,-4,4,8,2,3,1,0,-11,180,2,2,4,-1,0,0,-1,1,-1,-1,1,1
KR_6673381418,420,5,81,0,8,1,3,2,0,1,1,3,3,0,1,2,1,3,3,0,0,8,7,1,4,5,1,0,0,1,-1,1,1,4,1
KR_6757579260,420,1,94,10,-2,1,1,0,-2,2,4,1,2,1,-1,2,3,-1,0,1,1,-2,-5,5,3,8,-4,0,1,0,1,1,1,0,1
KR_6620779681,420,1,12,26,6,3,3,0,4,4,0,-1,1,2,0,1,1,0,1,1,0,0,10,3,2,5,-2,0,1,1,1,1,1,1,1
KR_6622631077,420,2,35,12,7,3,6,3,3,6,3,4,4,0,-3,2,5,0,0,0,0,4,-5,-5,9,4,0,0,0,-1,-1,0,-1,2,1
KR_6485512265,420,4,90,40,7,1,2,1,0,1,1,3,4,1,-2,2,4,5,5,0,0,1,13,-1,6,5,0,0,3,1,1,1,1,2,1
KR_6728750058,420,-1,-23,-8,-3,0,1,1,-3,2,5,-1,2,3,1,1,0,0,0,0,1,-8,-2,-4,7,3,0,0,-1,-1,1,1,1,2,1
KR_6727256524,420,3,-3,-8,-4,-3,1,4,-2,4,6,1,3,2,1,3,2,-1,0,1,0,-4,-19,2,2,4,3,0,0,1,-1,-1,1,1,1
KR_6670615775,420,0,-44,-12,1,0,2,2,-1,5,6,1,3,2,0,2,2,1,1,0,0,2,-3,-1,4,3,3,0,0,-1,-1,0,-1,4,1
KR_6745494849,420,1,-18,24,4,-4,2,6,4,4,0,0,2,2,2,2,0,2,2,0,-1,3,9,3,2,5,-3,0,-2,0,-1,-1,-1,0,1
KR_6737160214,420,-1,41,-3,0,1,1,0,0,2,2,1,4,3,-2,2,4,0,1,1,-1,-7,-8,-6,7,1,2,0,0,1,-1,0,-1,4,1
KR_6699408155,420,-2,81,-1,-2,0,3,3,-3,5,8,2,2,0,-1,3,4,0,0,0,0,-5,10,4,2,6,0,0,-1,1,-1,-1,1,3,1
KR_6733983779,440,4,-9,23,7,1,2,1,1,1,0,3,5,2,2,5,3,0,2,2,0,9,45,1,2,3,-35,0,1,-1,1,1,1,3,1
KR_6745452219,420,7,82,-4,8,11,12,1,-7,1,8,1,2,1,2,7,5,1,1,0,0,-4,-10,0,2,2,1,0,4,1,1,1,1,5,1
KR_6766764239,420,2,-18,-7,10,0,2,2,2,4,2,6,6,0,-2,4,6,4,4,0,0,12,-104,0,2,2,2,0,0,-1,1,1,1,2,1
KR_6640369128,420,4,49,24,4,-1,2,3,2,2,0,1,1,0,2,7,5,0,1,1,0,-2,-6,3,2,5,2,0,1,1,1,1,-1,3,1
KR_6689650896,440,-4,-57,-9,-8,0,3,3,-2,2,4,-8,1,9,2,3,1,0,2,2,0,-2,-1,0,5,5,3,0,0,1,-1,1,-1,1,1
KR_6749234443,420,4,64,31,6,0,1,1,5,7,2,0,1,1,0,2,2,1,3,2,0,2,-31,2,5,7,8,0,1,1,1,1,1,4,1
KR_6724571152,420,1,108,-26,6,3,5,2,-6,0,6,2,6,4,3,3,0,4,4,0,1,10,17,0,3,3,0,0,0,-1,1,1,1,3,1
KR_6750772752,420,-4,-23,0,-4,-8,0,8,5,7,2,0,4,4,0,4,4,-1,0,1,0,-1,-3,0,3,3,0,0,0,-1,-1,0,-1,1,1
KR_6746725712,420,3,56,-24,6,-2,3,5,2,3,1,2,3,1,2,2,0,2,3,1,0,2,-1,-2,5,3,2,0,2,-1,0,1,-1,2,1
KR_6666337232,420,4,-9,10,10,2,2,0,-2,3,5,0,1,1,5,5,0,5,5,0,0,7,10,4,4,8,-3,0,0,-1,-1,1,1,4,1
KR_6715442532,440,-2,-54,9,-2,-1,2,3,-4,0,4,0,2,2,-2,4,6,5,6,1,-1,-10,-385,2,1,3,-3,0,0,1,0,0,-1,6,1
KR_6743059249,420,4,26,8,11,4,4,0,2,3,1,6,6,0,-1,2,3,0,2,2,0,10,-215,-2,7,5,2,0,2,1,1,1,1,5,1
KR_6763151233,420,1,19,-21,6,1,4,3,0,3,3,1,1,0,2,2,0,2,2,0,0,13,126,5,3,8,-1,0,0,1,1,1,1,1,1
KR_6723779782,440,1,2,-4,9,0,1,1,-1,1,2,4,5,1,5,5,0,1,3,2,0,11,38,1,4,5,-14,0,0,1,0,1,1,3,1
KR_6732401274,420,2,16,5,5,0,2,2,0,6,6,0,1,1,2,2,0,3,4,1,0,-2,2,-3,5,2,2,0,0,-1,1,0,-1,5,1
KR_6635590547,440,3,26,39,12,4,5,1,2,4,2,-1,0,1,1,1,0,6,7,1,0,6,-62,4,1,5,27,0,2,1,1,1,1,4,1
KR_6766642480,420,-2,2,-26,-5,0,3,3,-1,3,4,-4,1,5,0,2,2,0,0,0,0,-9,-27,0,4,4,19,0,-1,1,-1,-1,1,3,1
KR_6549491250,420,-1,-57,12,0,-9,0,9,0,2,2,2,3,1,2,4,2,5,5,0,0,7,4,-1,6,5,1,0,-1,1,-1,-1,1,3,1
KR_6736327076,420,-2,36,25,-7,1,3,2,0,2,2,4,5,1,-5,1,6,-7,0,7,-1,-14,-6,-2,6,4,5,0,0,1,0,1,-1,6,1
KR_6764270891,420,-1,0,-33,2,-3,0,3,0,3,3,-3,2,5,3,3,0,5,5,0,-1,0,-8,-1,5,4,0,0,1,-1,-1,1,-1,1,1
KR_6749062006,420,0,-30,-3,-2,1,5,4,1,3,2,0,1,1,1,2,1,-5,0,5,0,0,-20,4,4,8,-7,0,-1,1,-1,-1,1,4,1
KR_6753492681,420,3,47,19,10,0,3,3,1,2,1,1,5,4,6,9,3,2,4,2,1,14,24,-2,6,4,0,0,1,1,1,1,1,2,1
KR_6766146688,440,0,21,3,8,2,4,2,3,5,2,6,10,4,-3,1,4,0,0,0,0,14,23,2,4,6,-21,0,1,1,1,1,1,1,1
KR_6525910327,420,5,64,24,8,1,1,0,2,5,3,1,2,1,4,5,1,0,0,0,0,6,0,-2,8,6,3,0,1,1,1,1,1,5,1
KR_6749831488,420,-2,-72,24,-4,2,4,2,0,1,1,2,5,3,-6,0,6,-2,0,2,0,-4,-40,-2,5,3,21,0,-2,1,1,1,-1,5,1
KR_6717979581,420,2,-2,8,2,2,4,2,-4,2,6,2,4,2,4,5,1,-2,0,2,0,10,13,0,6,6,7,0,0,0,0,-1,1,0,1
KR_6759995841,440,-2,-2,4,-3,-1,0,1,-4,2,6,0,1,1,3,7,4,-1,2,3,-2,-13,-12,-4,9,5,-1,0,0,1,1,0,-1,4,1
KR_6677599206,420,-2,102,3,-2,2,3,1,5,7,2,-4,0,4,-2,3,5,-3,0,3,-2,-7,-3,3,4,7,1,0,1,-1,-1,1,-1,4,1
KR_6723010396,420,-3,-2,-12,-1,-2,1,3,-2,1,3,1,3,2,3,5,2,-1,0,1,0,3,-128,-2,7,5,13,0,-2,0,1,-1,1,0,1
KR_6766685035,420,-2,7,12,-7,3,4,1,0,2,2,0,2,2,-11,2,13,1,1,0,-1,-17,15,4,0,4,-2,0,-1,1,1,1,-1,4,1
KR_6728327748,420,3,-1,32,3,-1,1,2,-2,1,3,1,3,2,3,3,0,2,2,0,0,7,121,5,3,8,5,0,0,1,-1,0,-1,1,1
KR_6759891245,420,6,61,31,8,4,4,0,1,1,0,-1,2,3,3,4,1,1,1,0,1,5,14,4,0,4,-3,0,1,1,1,1,1,2,1
KR_6755276513,420,0,34,-26,-1,2,2,0,-4,1,5,2,3,1,-2,1,3,1,1,0,0,-1,9,1,3,4,-3,0,0,-1,0,0,-1,1,1
KR_6750772883,420,1,38,17,0,1,4,3,0,4,4,-1,4,5,0,1,1,0,0,0,0,-1,17,-1,2,1,0,0,1,1,1,1,-1,3,1
KR_6761340370,420,-1,51,28,5,-6,0,6,5,6,1,4,5,1,2,4,2,0,1,1,0,9,-4,-1,2,1,3,0,1,-1,1,1,-1,4,1
KR_6751358649,420,5,65,20,15,2,4,2,1,2,1,7,9,2,7,8,1,-2,0,2,0,11,37,4,5,9,0,0,1,-1,1,1,-1,1,1
KR_6635166363,420,-2,4,-8,-2,-1,0,1,0,3,3,3,4,1,-2,1,3,-2,0,2,0,4,-8,-1,4,3,-1,0,-1,-1,1,-1,-1,5,1
KR_6707597828,420,2,6,-8,9,0,0,0,3,3,0,0,0,0,8,8,0,-2,0,2,0,12,6,4,2,6,-3,0,0,-1,1,-1,1,5,1
KR_6613089522,420,1,39,28,-1,0,3,3,4,4,0,-3,1,4,0,0,0,-2,0,2,0,-1,-11,-3,6,3,1,0,-1,1,1,-1,1,4,1
KR_6725925849,420,6,111,10,17,9,9,0,-2,1,3,3,5,2,5,6,1,2,2,0,1,19,3,6,2,8,-3,0,2,-1,1,1,1,1,1
KR_6761615452,440,1,-37,24,4,3,3,0,0,5,5,-1,1,2,1,1,0,1,1,0,0,5,5,2,4,6,-6,0,1,-1,1,1,1,5,1
KR_6748960698,420,2,24,8,5,1,1,0,1,2,1,-1,1,2,0,3,3,4,4,0,0,9,2,2,4,6,-1,0,-1,-1,-1,-1,-1,5,1
KR_6748094783,420,1,14,15,-1,1,4,3,-1,2,3,0,2,2,-1,0,1,0,0,0,0,-6,0,-1,7,6,-1,0,0,-1,1,0,-1,2,1
KR_6702624219,420,5,67,23,10,4,4,0,3,4,1,0,3,3,2,5,3,1,2,1,0,16,8,6,3,9,1,0,2,0,1,1,1,0,1
KR_6192687191,420,3,46,15,14,1,2,1,0,2,2,7,10,3,6,7,1,0,0,0,0,3,7,0,3,3,3,0,1,0,1,1,1,0,1
KR_6762744409,420,-1,3,38,-4,3,4,1,-3,1,4,-3,0,3,0,1,1,-1,0,1,0,0,-53,-3,4,1,-6,0,-1,-1,1,-1,-1,1,1
KR_6760686466,440,7,65,40,9,0,2,2,3,4,1,6,8,2,-2,2,4,2,2,0,0,4,-8,2,1,3,5,0,1,1,-1,1,1,3,1
KR_6447957992,420,1,-47,-12,6,1,3,2,1,3,2,-1,0,1,5,5,0,0,4,4,0,9,2,0,5,5,3,0,0,-1,-1,0,1,4,1
KR_6606904894,420,5,35,-15,13,9,9,0,-1,2,3,1,5,4,4,7,3,0,1,1,0,5,-1,2,3,5,4,0,1,-1,1,1,1,5,1
KR_6763294154,440,5,75,8,11,1,2,1,1,5,4,4,5,1,4,8,4,1,1,0,0,14,-9,-2,3,1,1,0,3,1,1,1,1,1,1
KR_6664673500,420,2,39,5,4,2,3,1,2,2,0,1,4,3,-3,3,6,2,2,0,-1,5,8,1,5,6,-1,0,1,1,1,1,-1,1,1
KR_6695099487,420,-1,-16,-5,-3,3,3,0,-3,1,4,2,4,2,-2,2,4,-3,1,4,0,-11,-12,-1,5,4,-5,0,0,-1,1,-1,-1,6,1
KR_6748737299,420,1,-29,-8,2,2,3,1,-1,1,2,1,3,2,2,3,1,-2,2,4,0,2,6,3,1,4,0,0,0,-1,1,1,1,3,1
KR_6764135477,420,5,72,12,13,0,0,0,1,3,2,4,5,1,2,4,2,6,6,0,0,11,15,2,2,4,0,0,0,1,-1,0,1,4,1
KR_6762396162,420,1,0,-4,2,-1,2,3,3,6,3,0,5,5,0,0,0,0,1,1,0,0,0,2,2,4,-3,0,-1,-1,-1,-1,-1,1,1
KR_6715479965,420,2,54,-11,8,3,5,2,-1,0,1,0,4,4,5,7,2,1,3,2,0,5,-33,1,3,4,-1,0,-1,0,1,1,1,0,1
KR_6733557245,420,3,83,19,4,0,2,2,0,4,4,5,5,0,-2,0,2,1,2,1,0,0,5,-1,3,2,1,0,1,1,-1,1,1,3,1
KR_6710394907,420,4,1,8,7,-2,2,4,4,5,1,6,6,0,0,1,1,-1,0,1,0,17,7,1,2,3,4,0,2,1,1,1,-1,6,1
KR_6758075064,420,4,97,6,9,3,4,1,5,7,2,-2,3,5,1,3,2,2,2,0,0,14,-12,1,4,5,3,0,1,1,1,1,-1,5,1
KR_6744036229,420,0,32,-14,7,-1,1,2,-1,1,2,2,3,1,6,8,2,1,1,0,0,10,39,0,4,4,-16,0,1,1,-1,1,1,4,1
KR_6762584800,440,3,-39,-7,4,0,3,3,-3,0,3,0,2,2,1,3,2,6,6,0,0,3,25,-1,5,4,-3,0,0,1,1,0,1,2,1
KR_6575034124,420,4,50,16,9,4,4,0,2,5,3,2,4,2,3,4,1,-2,1,3,0,4,-8,-5,10,5,5,0,0,1,-1,0,1,6,1
KR_6706459173,420,4,33,8,9,4,5,1,0,2,2,-1,1,2,5,7,2,1,1,0,0,6,3,3,3,6,2,0,2,-1,1,1,1,3,1
KR_6467421620,440,2,66,5,5,5,6,1,1,4,3,0,2,2,-2,2,4,1,2,1,0,0,30,3,2,5,0,0,1,0,1,1,1,0,1
KR_6758846971,420,5,59,-5,10,1,3,2,-1,3,4,11,12,1,-1,2,3,0,0,0,0,3,2,-4,8,4,-5,0,1,0,0,1,-1,0,1
KR_6748170087,420,2,34,4,2,0,1,1,3,7,4,0,2,2,-3,3,6,2,3,1,0,1,18,1,4,5,-6,0,0,0,-1,0,1,0,1
KR_6759384358,440,0,-14,0,4,-2,2,4,0,3,3,8,8,0,-2,5,7,0,2,2,-1,9,2,1,1,2,-2,0,0,1,-1,-1,-1,2,1
KR_6734121039,420,-2,-47,-28,-7,-2,1,3,-1,3,4,-1,1,2,-1,0,1,-2,0,2,-2,-9,-9,-2,6,4,2,0,-2,-1,-1,-1,-1,3,1
KR_6724170955,420,6,159,38,6,-2,2,4,-5,3,8,2,3,1,10,10,0,1,1,0,0,3,-1,-7,10,3,-1,0,2,-1,1,1,-1,2,1
KR_6767665964,420,3,-44,8,10,-1,1,2,7,8,1,5,7,2,1,1,0,-2,1,3,0,9,10,6,2,8,0,0,0,1,1,0,1,6,1
KR_6745001955,420,-2,-15,4,-2,2,3,1,-2,3,5,2,3,1,1,2,1,-5,0,5,0,-5,-21,4,5,9,18,0,0,1,-1,0,1,1,1
KR_6526889737,420,2,2,45,0,-3,1,4,-1,2,3,2,3,1,1,1,0,1,1,0,0,-4,-259,-1,4,3,4,0,1,-1,1,1,1,2,1
KR_6765037177,420,2,100,-16,-1,2,2,0,-3,4,7,0,2,2,-1,1,2,1,1,0,0,-7,55,-7,7,0,0,0,2,1,1,1,-1,6,1
KR_6764474678,420,4,26,-12,5,1,1,0,-1,1,2,4,5,1,0,3,3,1,1,0,0,9,32,2,4,6,6,0,1,1,-1,-1,-1,2,1
KR_6765485479,420,0,62,-8,3,2,2,0,-1,2,3,1,1,0,0,1,1,1,1,0,0,1,-18,-3,3,0,7,0,0,1,-1,-1,1,3,1
KR_6636730797,420,2,-36,27,2,-1,1,2,1,4,3,-3,0,3,2,2,0,3,3,0,0,5,-1,4,3,7,3,0,0,-1,1,0,-1,1,1
KR_6762348598,440,2,11,0,3,4,4,0,2,3,1,-3,1,4,1,3,2,-1,0,1,0,5,-1,1,3,4,-2,0,-1,1,0,-1,1,5,1
KR_6764038202,420,5,39,-18,13,4,4,0,0,2,2,3,3,0,3,4,1,3,3,0,0,12,-3,6,1,7,-2,0,0,1,-1,1,1,5,1
KR_6715954909,420,1,-7,-4,7,2,3,1,-1,2,3,0,2,2,2,5,3,4,5,1,0,2,-1,-2,5,3,-1,0,0,1,1,0,1,2,1
KR_6747050793,420,1,-51,-16,4,-2,0,2,4,5,1,3,6,3,-1,1,2,0,3,3,0,7,-2,0,5,5,-3,0,1,-1,-1,1,1,6,1
KR_6506980651,420,2,3,-20,4,0,2,2,-1,2,3,-3,0,3,7,10,3,1,3,2,-1,5,17,8,4,12,-1,0,0,1,-1,-1,-1,1,1
KR_6753747467,420,6,-44,10,7,3,3,0,2,4,2,3,3,0,-3,3,6,2,3,1,1,9,25,-2,5,3,-2,0,1,-1,1,1,-1,4,1
KR_6759657090,420,2,47,12,8,-1,0,1,1,4,3,3,3,0,3,3,0,2,2,0,0,4,-10,-1,6,5,-2,0,1,-1,-1,1,1,6,1
KR_6740770194,420,-5,5,-39,-10,-1,1,2,-4,2,6,-2,3,5,-4,3,7,1,1,0,0,-3,-7,1,3,4,0,0,-1,-1,1,-1,-1,5,1
KR_6764628923,420,0,36,-6,2,-1,0,1,1,1,0,2,2,0,0,1,1,0,0,0,0,2,-6,0,2,2,2,0,0,0,1,0,1,0,1
KR_6638840078,420,3,36,-10,8,-2,1,3,2,4,2,-1,2,3,7,8,1,2,2,0,0,14,-1,-3,6,3,1,0,-1,1,-1,-1,1,4,1
KR_6710046195,420,1,14,0,-1,2,3,1,-4,2,6,0,2,2,0,4,4,1,1,0,0,-1,20,0,5,5,2,0,1,-1,-1,1,1,5,1
KR_6723856229,420,3,0,0,5,2,2,0,8,11,3,1,3,2,-6,1,7,0,1,1,0,10,-15,5,3,8,1,0,0,-1,1,1,-1,4,1
KR_6767844401,420,7,136,3,15,6,6,0,2,2,0,0,1,1,3,4,1,4,4,0,0,9,21,-1,5,4,1,0,4,0,1,1,1,0,1
KR_6764607919,440,-2,-44,13,-4,-8,0,8,4,6,2,-2,0,2,0,1,1,2,5,3,0,-4,5,2,1,3,0,0,2,1,1,1,-1,6,1
KR_6746095145,420,-3,-44,0,-9,-2,1,3,1,1,0,-5,0,5,-2,5,7,-1,2,3,0,-3,-9,-7,7,0,0,0,-2,-1,1,-1,-1,2,1
KR_6767518878,420,3,56,3,10,0,0,0,0,0,0,1,6,5,6,9,3,3,3,0,0,7,2,1,3,4,-2,0,1,1,0,1,1,4,1
KR_6754223655,420,4,1,5,11,2,2,0,2,3,1,2,2,0,4,4,0,1,4,3,1,14,-2,5,1,6,4,0,0,1,-1,-1,1,5,1
KR_6604074553,420,4,63,-8,10,7,7,0,2,2,0,-1,0,1,2,3,1,0,0,0,0,3,-3,1,5,6,0,0,1,1,1,1,1,5,1
KR_6759326133,440,-1,14,-11,4,4,6,2,0,5,5,0,1,1,1,1,0,-1,2,3,0,7,3,-2,6,4,5,0,1,1,-1,1,1,3,1
KR_6745374882,420,2,29,24,6,3,4,1,5,5,0,0,2,2,-2,2,4,0,1,1,0,8,9,1,4,5,-1,0,1,1,1,1,1,4,1
KR_6709440714,420,0,42,16,-2,6,6,0,2,3,1,-4,2,6,-5,1,6,-1,1,2,0,-5,-139,3,3,6,-2,0,1,-1,1,1,-1,2,1
KR_6741435119,420,-3,43,21,-9,2,3,1,-2,3,5,3,4,1,-1,0,1,-11,0,11,0,-15,-10,-1,5,4,-1,0,-2,-1,1,1,1,1,1
KR_6657058999,440,-1,63,4,-5,-2,1,3,-5,0,5,3,6,3,-1,1,2,0,1,1,0,-11,-4,0,4,4,2,0,1,-1,0,1,1,5,1
KR_6753183941,420,2,74,0,-2,0,1,1,-2,4,6,0,2,2,3,5,2,-3,0,3,0,-5,-2,-2,8,6,3,0,1,1,1,1,-1,6,1
KR_6715478732,420,4,47,12,8,0,0,0,5,5,0,4,5,1,0,7,7,-1,0,1,0,10,4,0,3,3,2,0,2,1,1,1,1,2,1
KR_6594808617,420,1,44,12,4,5,6,1,-2,2,4,-1,2,3,1,5,4,1,1,0,2,11,-118,-2,6,4,1,0,2,1,1,1,-1,5,1
KR_6441115397,420,1,6,3,3,3,3,0,3,3,0,1,3,2,-4,3,7,0,1,1,0,1,-48,0,6,6,10,0,0,1,1,0,1,6,1
KR_6616584548,420,0,-22,-8,-2,-1,0,1,1,2,1,-3,1,4,-1,3,4,2,2,0,-1,-8,-18,-3,7,4,3,0,0,-1,1,0,-1,3,1
KR_6705980918,420,3,38,10,13,-2,1,3,-1,2,3,2,4,2,14,15,1,0,1,1,1,12,23,2,2,4,-2,0,2,1,0,1,1,5,1
KR_6760390620,440,2,13,34,3,4,4,0,-3,1,4,2,3,1,1,4,3,-1,1,2,0,-3,-2,2,3,5,-1,0,0,-1,0,0,1,6,1
KR_6707187520,420,5,75,48,8,2,4,2,2,5,3,0,3,3,0,3,3,4,5,1,1,5,-32,1,5,6,1,0,0,1,0,0,1,1,1
KR_6764469162,420,-2,0,-24,1,-1,3,4,1,3,2,0,2,2,-1,4,5,2,2,0,0,-1,-7,-5,8,3,2,0,-2,-1,-1,-1,-1,2,1
KR_6748102714,420,3,67,28,9,5,6,1,2,2,0,0,2,2,4,6,2,-2,0,2,0,9,5,1,5,6,4,0,2,1,0,1,1,6,1
KR_6731468288,420,3,39,-24,4,-3,0,3,3,4,1,1,2,1,2,5,3,1,2,1,0,13,-41,5,2,7,15,0,1,1,-1,1,-1,3,1
KR_6731695411,420,1,56,5,-1,1,2,1,-2,3,5,-3,2,5,5,5,0,-2,0,2,1,6,-125,1,4,5,-2,0,0,1,-1,0,1,1,1
KR_6624740585,420,5,68,2,10,3,3,0,0,1,1,2,3,1,3,3,0,2,2,0,1,9,8,1,1,2,-1,0,3,1,1,1,1,5,1
KR_6528796652,420,3,58,31,11,-5,0,5,1,5,4,3,5,2,11,11,0,1,1,0,4,20,-9,-3,7,4,-3,0,2,1,1,1,1,4,1
KR_6732146057,440,1,-9,7,4,3,3,0,1,1,0,-2,1,3,1,1,0,1,2,1,1,6,2,2,3,5,-2,0,0,1,0,0,1,2,1
KR_6715605535,420,1,44,-22,8,6,7,1,-6,0,6,7,7,0,1,2,1,0,2,2,0,-3,-14,0,1,1,1,0,1,-1,1,1,1,6,1
KR_6745248799,420,4,64,40,4,5,6,1,0,1,1,4,5,1,-4,1,5,-1,2,3,0,-2,39,0,6,6,-28,0,2,1,1,1,1,1,1
KR_6636348804,420,1,-39,23,-6,-3,2,5,1,3,2,0,2,2,-4,2,6,0,2,2,0,-2,1,1,2,3,0,0,-1,1,-1,-1,-1,3,1
KR_6761453954,420,1,-7,5,10,1,2,1,3,7,4,0,4,4,4,9,5,2,2,0,0,17,-366,-4,5,1,4,0,0,-1,-1,1,1,1,1
KR_6758224129,420,5,91,-9,10,-1,1,2,4,6,2,-1,1,2,7,8,1,1,3,2,0,12,-2,-1,6,5,2,0,2,-1,-1,1,-1,6,1
KR_6759383045,420,2,42,1,3,3,4,1,-5,2,7,0,4,4,3,4,1,2,3,1,0,-3,2,-1,2,1,-2,0,1,1,-1,1,-1,4,1
KR_6753581604,420,3,38,27,8,4,5,1,3,5,2,-1,2,3,1,2,1,1,1,0,0,5,15,5,1,6,1,0,0,1,-1,1,1,6,1
KR_6762178871,420,4,57,2,9,4,4,0,6,6,0,0,0,0,1,3,2,-2,0,2,0,4,-38,3,5,8,37,0,1,1,1,1,1,6,1
KR_6724240773,420,3,122,20,6,-3,2,5,0,2,2,3,6,3,5,6,1,1,2,1,0,6,4,1,4,5,0,0,2,0,1,1,-1,0,1
KR_6743488139,420,4,36,-4,12,0,1,1,4,6,2,-1,1,2,9,12,3,0,1,1,0,10,-2,-2,2,0,2,0,1,-1,1,1,1,2,1
KR_6755022876,420,-3,81,-28,-4,0,0,0,1,7,6,-7,1,8,2,6,4,0,0,0,0,-3,-76,4,2,6,-14,0,-2,1,-1,-1,-1,4,1
KR_6659346761,420,-3,-21,10,1,-2,0,2,1,1,0,2,4,2,0,2,2,0,1,1,0,1,1,3,8,11,-2,0,0,1,-1,0,1,6,1
KR_6749937625,420,1,-19,-24,5,0,0,0,3,7,4,-2,0,2,3,4,1,1,2,1,0,7,-29,0,2,2,-4,0,1,1,1,1,1,3,1
KR_6767264727,420,0,-20,-9,7,0,2,2,2,4,2,4,4,0,0,2,2,1,2,1,1,2,0,-1,6,5,0,0,0,-1,1,0,1,3,1
KR_6733876417,420,1,21,8,-2,-2,0,2,-3,1,4,-3,3,6,6,7,1,0,1,1,0,9,15,1,3,4,-2,0,1,-1,1,1,-1,3,1
KR_6706344853,420,2,59,-40,2,2,2,0,1,5,4,1,2,1,-2,1,3,0,0,0,0,3,-10,0,5,5,-4,0,1,-1,1,1,1,4,1
KR_6661190372,420,2,41,-9,6,0,2,2,3,5,2,-1,1,2,4,4,0,0,4,4,0,10,419,2,1,3,2,0,0,1,1,0,1,5,1
KR_6748430354,420,4,19,25,4,-1,1,2,4,4,0,2,2,0,-1,1,2,0,0,0,0,4,8,4,1,5,-2,0,0,1,-1,0,1,1,1
KR_6759633186,440,3,98,-7,6,0,0,0,4,5,1,2,3,1,0,1,1,0,1,1,0,-1,0,3,3,6,0,0,1,0,1,1,1,0,1
KR_6705109690,420,3,9,24,5,2,3,1,5,5,0,-1,2,3,0,4,4,-1,0,1,1,6,-5,-1,4,3,-2,0,1,1,-1,1,1,3,1
KR_6622324376,420,2,74,23,1,0,2,2,4,5,1,-1,5,6,0,2,2,-2,0,2,-1,0,4,-1,3,2,3,0,1,1,1,1,-1,5,1
KR_6750428770,420,0,-24,-31,1,1,2,1,2,5,3,1,2,1,-3,2,5,0,0,0,0,1,233,2,2,4,2,0,0,0,-1,0,1,0,1
KR_6743221159,420,3,6,9,10,-2,2,4,6,7,1,0,1,1,6,6,0,0,0,0,2,23,10,4,1,5,-6,0,0,0,-1,1,1,0,1
KR_6762973592,420,1,66,0,5,0,2,2,1,3,2,0,2,2,6,6,0,-2,1,3,0,4,18,0,3,3,1,0,1,1,1,1,-1,2,1
KR_6765604744,420,0,77,-8,2,2,3,1,3,6,3,-4,0,4,1,3,2,0,0,0,0,-5,0,-5,9,4,2,0,0,-1,0,1,1,6,1
KR_6764654138,420,4,11,34,12,0,4,4,3,4,1,6,7,1,0,1,1,3,4,1,1,11,5,-3,4,1,4,0,1,0,-1,1,1,0,1
KR_6684194577,420,2,59,-5,1,6,7,1,-2,0,2,-2,3,5,-2,1,3,1,1,0,0,-3,1,2,3,5,0,0,1,-1,1,1,1,6,1
KR_6676681195,420,1,30,32,-1,1,1,0,1,7,6,-3,0,3,-1,3,4,1,2,1,0,-4,-8,-3,5,2,-1,0,-1,-1,-1,-1,1,6,1
KR_6759277031,420,1,4,-21,9,3,4,1,4,5,1,7,7,0,-5,0,5,0,1,1,0,1,11,2,2,4,-4,0,0,1,-1,1,1,4,1
KR_6700159835,440,3,10,20,2,2,3,1,3,6,3,-1,2,3,2,3,1,-4,0,4,0,9,-20,-3,5,2,6,0,0,0,0,1,-1,0,1
KR_6606238214,420,1,14,4,0,1,4,3,3,3,0,-1,3,4,-2,1,3,-1,0,1,0,-1,6,-1,5,4,-2,0,0,1,1,0,1,1,1
KR_6758893192,420,6,94,56,12,-1,0,1,7,7,0,-1,0,1,7,10,3,0,1,1,0,11,-2,1,4,5,2,0,1,-1,1,1,1,5,1
KR_6767098451,420,2,112,-15,3,3,4,1,2,5,3,-2,1,3,0,0,0,0,2,2,0,4,-4,-3,5,2,-1,0,2,1,-1,1,1,4,1
KR_6715813090,420,-1,-70,1,0,3,4,1,0,2,2,-3,2,5,0,2,2,0,1,1,0,2,0,-2,4,2,1,0,0,-1,1,0,-1,4,1
KR_6716798126,440,0,47,-54,3,2,3,1,-2,1,3,-1,1,2,4,5,1,0,0,0,-2,4,-1,1,4,5,2,0,1,1,-1,1,-1,1,1
KR_6767541560,420,7,131,27,11,-1,1,2,3,4,1,-2,1,3,9,9,0,2,2,0,-1,19,6,1,3,4,2,0,3,1,0,1,-1,6,1
KR_6760556776,420,2,14,-4,7,4,4,0,4,6,2,5,7,2,-3,4,7,-3,2,5,0,9,-2,3,3,6,-2,0,0,1,1,1,-1,4,1
KR_6756257180,440,2,-1,-4,-4,2,2,0,1,7,6,-3,3,6,-1,3,4,-3,0,3,0,-14,-7,5,4,9,23,0,0,0,1,0,1,0,1
KR_6762064444,420,2,75,29,1,4,4,0,2,3,1,1,2,1,-5,1,6,-1,1,2,0,-5,-3,1,2,3,-2,0,-1,-1,0,1,-1,4,1
KR_6625275696,420,4,-17,0,7,-2,1,3,1,2,1,8,8,0,0,1,1,0,0,0,0,7,13,-5,9,4,3,0,0,0,0,0,-1,0,1
KR_6744874591,420,2,-11,21,9,4,4,0,2,5,3,-1,1,2,4,6,2,0,1,1,-1,8,187,1,3,4,-4,0,3,1,1,1,-1,4,1
KR_6655972175,420,3,26,9,4,-3,2,5,4,5,1,3,6,3,-1,3,4,1,3,2,0,3,3,-4,6,2,-1,0,2,1,-1,1,1,4,1
KR_6766034303,420,1,-10,20,4,3,3,0,0,2,2,-2,1,3,3,6,3,0,0,0,2,11,10,-1,3,2,-5,0,-1,-1,1,-1,1,3,1
KR_6661237190,420,2,57,-11,5,-2,2,4,1,2,1,3,7,4,2,4,2,1,2,1,-1,8,-298,2,3,5,4,0,0,1,1,1,-1,3,1
KR_6697700739,420,1,-88,4,3,3,4,1,3,4,1,-2,3,5,0,1,1,-1,0,1,0,14,208,-2,5,3,-2,0,0,1,-1,0,1,1,1
KR_6678517720,420,4,50,20,12,2,2,0,2,2,0,1,2,1,7,7,0,0,0,0,0,14,-2,0,4,4,1,0,0,1,0,1,-1,1,1
KR_6761268659,420,4,2,7,4,0,3,3,2,5,3,1,3,2,-2,5,7,3,4,1,0,5,7,1,4,5,3,0,-2,1,-1,-1,-1,6,1
KR_6748489101,440,1,-17,0,0,0,1,1,-1,4,5,3,6,3,-2,5,7,0,4,4,0,2,12,-1,1,0,-2,0,0,-1,1,0,1,4,1
KR_6612931857,420,4,75,16,8,0,2,2,3,3,0,5,6,1,1,1,0,-1,0,1,1,7,9,2,6,8,-1,0,1,-1,1,1,1,1,1
KR_6767331592,420,-3,-82,4,-10,0,2,2,-7,1,8,2,2,0,-5,3,8,0,3,3,1,-13,9,-5,7,2,-3,0,-2,1,1,-1,1,6,1
KR_6762475148,420,5,-7,0,8,6,7,1,1,4,3,2,4,2,-3,1,4,2,4,2,0,13,6,2,3,5,-3,0,1,1,1,1,1,6,1
KR_6748937948,420,1,-15,-16,6,2,2,0,-1,1,2,0,0,0,5,7,2,0,2,2,0,6,24,0,5,5,-4,0,0,1,-1,0,-1,4,1
KR_6726747479,440,2,3,12,3,3,3,0,3,7,4,1,3,2,0,1,1,-4,0,4,0,-2,-56,1,3,4,-3,0,0,-1,1,0,1,6,1
KR_6759452666,420,2,22,4,6,-5,0,5,5,6,1,-1,6,7,3,4,1,4,4,0,0,12,16,3,2,5,1,0,1,1,-1,1,1,6,1
KR_6606126447,440,-1,-42,6,1,-1,1,2,3,5,2,3,4,1,-1,1,2,-3,2,5,1,5,-7,0,5,5,2,0,0,1,1,0,1,4,1
KR_6720575403,420,3,-8,-14,6,1,2,1,2,5,3,0,2,2,4,4,0,-1,0,1,0,6,-273,2,5,7,3,0,0,-1,1,0,-1,4,1
KR_6712464568,420,1,15,24,3,-2,0,2,1,4,3,-1,1,2,1,3,2,4,4,0,0,2,151,0,3,3,0,0,2,1,1,1,1,4,1
KR_6723177088,420,-1,15,-29,3,4,4,0,-4,1,5,1,2,1,1,3,2,1,1,0,0,-9,6,1,4,5,2,0,1,1,-1,1,-1,4,1
KR_6753765281,420,-1,17,-15,-2,1,3,2,5,6,1,0,3,3,-7,0,7,-1,2,3,0,-2,1,0,3,3,-1,0,0,1,-1,0,-1,6,1
KR_6727725550,420,3,31,24,2,-4,0,4,-1,2,3,6,6,0,0,2,2,1,1,0,0,-1,4,-2,7,5,1,0,0,1,-1,-1,1,3,1
KR_6133085437,420,2,54,20,5,-3,2,5,6,6,0,-1,4,5,2,2,0,1,1,0,2,4,-62,-5,5,0,4,0,1,1,-1,1,1,5,1
KR_6760824274,420,0,14,4,9,0,3,3,2,4,2,0,2,2,5,8,3,2,2,0,0,5,9,8,2,10,-4,0,0,-1,0,0,1,6,1
KR_6763053839,420,1,45,24,5,5,6,1,-1,2,3,-3,4,7,2,2,0,2,4,2,1,7,21,-2,6,4,2,0,1,1,0,1,1,5,1
KR_6740029094,420,0,38,-2,-2,2,3,1,-6,1,7,-3,1,4,2,2,0,3,4,1,0,-2,-11,0,7,7,0,0,0,1,-1,0,-1,5,1
KR_6525437147,420,1,54,-8,9,2,4,2,1,5,4,0,1,1,7,9,2,-1,0,1,0,9,15,4,2,6,-2,0,1,1,-1,1,-1,5,1
KR_6760483327,420,1,21,46,6,1,1,0,-2,2,4,3,4,1,2,5,3,2,3,1,0,4,9,-1,2,1,3,0,2,1,0,1,1,2,1
KR_6764993158,420,0,12,30,7,-2,2,4,3,6,3,3,3,0,1,3,2,2,2,0,0,7,120,2,3,5,3,0,0,0,0,1,1,0,1
KR_6619621005,420,2,6,1,7,2,2,0,1,3,2,3,4,1,0,1,1,1,1,0,0,10,-108,-1,7,6,5,0,0,-1,-1,-1,-1,4,1
KR_6673163138,420,3,45,-27,-2,2,2,0,2,6,4,-2,2,4,-3,1,4,-1,0,1,-2,-14,-2,1,2,3,-2,0,1,-1,1,1,-1,2,1
KR_6764969337,420,-1,3,-7,-2,0,1,1,0,1,1,0,0,0,-6,0,6,4,5,1,1,0,13,8,3,11,-2,0,0,0,1,0,1,0,1
KR_6760954537,420,-1,-64,-12,7,0,0,0,4,5,1,4,4,0,-2,3,5,1,2,1,0,8,10,2,0,2,1,0,0,-1,1,0,-1,3,1
KR_6752390539,420,2,-50,15,9,-1,0,1,3,4,1,2,4,2,2,4,2,3,3,0,0,12,13,-4,8,4,1,0,1,1,1,1,1,2,1
KR_6757649131,420,-1,61,-5,-5,0,1,1,-4,0,4,1,3,2,0,1,1,-2,0,2,0,-6,19,1,5,6,-21,0,0,0,1,0,1,0,1
KR_6751285691,420,-5,-35,-16,-9,2,2,0,-1,1,2,-6,1,7,1,5,4,-5,0,5,0,-7,0,3,2,5,-3,0,-1,-1,1,-1,1,2,1
KR_6618769449,420,-1,38,-8,-5,2,3,1,-6,2,8,-4,1,5,4,7,3,-1,0,1,0,-9,-2,-4,7,3,1,0,0,1,-1,0,-1,5,1
KR_6762388038,440,1,0,0,2,5,6,1,1,3,2,-2,1,3,1,2,1,-3,0,3,0,-8,38,-1,5,4,-11,0,2,-1,1,1,1,5,1
KR_6694271663,420,0,-46,24,-3,-1,1,2,2,3,1,-3,1,4,1,4,3,-2,1,3,-1,-5,473,-2,7,5,4,0,0,-1,1,0,-1,6,1
KR_6765539236,420,2,68,4,9,-1,2,3,4,5,1,3,5,2,2,3,1,1,2,1,1,12,34,3,2,5,1,0,0,-1,0,0,1,4,1
KR_6622382090,420,3,41,20,8,1,1,0,2,3,1,-1,5,6,3,5,2,3,3,0,0,10,-100,0,1,1,1,0,2,1,-1,1,1,2,1
KR_6617184963,420,5,90,36,10,2,3,1,2,2,0,2,5,3,2,4,2,2,2,0,0,9,6,-1,7,6,5,0,3,1,1,1,-1,2,1
KR_6660113540,420,3,10,16,9,3,4,1,5,6,1,-2,0,2,4,6,2,-1,0,1,0,13,-15,3,5,8,-2,0,1,1,-1,1,-1,5,1
KR_6743125932,420,3,47,12,7,2,2,0,1,2,1,1,2,1,3,4,1,0,1,1,0,8,19,2,1,3,4,0,2,1,1,1,1,3,1
KR_6742559590,440,1,43,4,2,0,2,2,1,6,5,-2,0,2,5,5,0,-2,0,2,0,5,-2,1,2,3,3,0,0,1,0,0,1,6,1
KR_6746402383,420,0,-13,12,3,1,2,1,6,8,2,0,1,1,-1,4,5,-3,0,3,0,8,6,1,3,4,0,0,0,1,-1,0,1,2,1
KR_6710968665,440,0,-15,-24,1,0,2,2,3,6,3,-1,1,2,4,6,2,-5,2,7,0,-6,1,-2,3,1,-2,0,-1,-1,-1,-1,-1,6,1
KR_6185071704,420,4,0,52,8,1,3,2,2,3,1,6,6,0,-1,1,2,0,0,0,1,1,0,1,4,5,-1,0,-2,1,-1,-1,1,3,1
KR_6760240529,420,0,50,-3,12,2,3,1,-1,1,2,1,2,1,8,8,0,2,3,1,1,13,20,1,5,6,0,0,2,1,1,1,1,4,1
KR_6742457430,420,3,-9,-9,5,2,3,1,4,5,1,-4,0,4,2,2,0,1,3,2,0,10,39,3,2,5,-6,0,-1,1,-1,-1,-1,2,1
KR_6172270193,420,0,-14,-12,-1,-1,4,5,-2,2,4,3,4,1,0,5,5,-1,0,1,0,-4,1,3,3,6,0,0,1,-1,1,1,1,2,1
KR_6751203997,420,6,42,21,9,-3,0,3,0,3,3,7,7,0,4,4,0,1,1,0,2,12,3,2,3,5,0,0,2,1,-1,1,1,1,1
KR_6706381928,420,-2,26,-16,-7,1,2,1,-1,2,3,-2,3,5,-4,0,4,-1,0,1,0,-6,-120,-2,4,2,-2,0,0,-1,-1,0,1,6,1
KR_6106937968,420,5,111,19,10,-4,1,5,2,3,1,6,8,2,3,4,1,3,4,1,0,10,45,1,3,4,-18,0,1,1,1,1,1,3,1
KR_6757081847,420,5,73,20,5,6,8,2,2,2,0,-3,4,7,-1,3,4,1,2,1,0,1,122,5,1,6,-3,0,1,1,1,1,-1,6,1
KR_6767114101,420,8,8,21,16,1,3,2,3,4,1,6,7,1,5,7,2,1,2,1,0,17,-98,3,1,4,1,0,1,1,1,1,-1,6,1
KR_6644583131,420,2,27,-24,2,1,2,1,0,2,2,0,4,4,-1,2,3,2,2,0,0,-3,-32,-1,5,4,5,0,0,1,1,0,1,2,1
KR_6715336547,420,3,55,32,1,-2,1,3,1,2,1,2,2,0,1,1,0,-1,0,1,0,-1,344,-4,4,0,2,0,2,-1,1,1,-1,3,1
KR_6673908679,420,-2,-4,-28,-6,-5,0,5,0,2,2,-2,6,8,1,4,3,0,2,2,0,3,0,-3,6,3,0,0,0,-1,1,0,-1,1,1
KR_6740302206,420,1,-3,12,0,1,1,0,1,1,0,-4,0,4,-2,3,5,4,5,1,0,1,129,3,2,5,6,0,1,0,1,1,-1,0,1
KR_6762488002,420,7,77,-10,18,6,7,1,1,3,2,0,1,1,8,10,2,3,3,0,1,13,7,-1,5,4,1,0,4,-1,1,1,1,1,1
KR_6713788956,440,1,2,0,8,4,5,1,2,2,0,2,3,1,0,1,1,0,0,0,0,2,32,-1,4,3,-14,0,1,1,-1,1,1,4,1
KR_6632885498,420,-1,-15,8,-3,0,1,1,-2,0,2,1,8,7,-1,2,3,-1,1,2,2,-6,149,0,4,4,0,0,1,1,-1,1,1,2,1
KR_6764465144,420,-1,51,-8,0,0,1,1,4,4,0,-3,0,3,1,4,3,-2,0,2,0,6,3,0,7,7,4,0,0,1,-1,0,1,5,1
KR_6759468880,420,2,11,-8,7,3,3,0,3,4,1,-2,0,2,4,6,2,-1,1,2,0,-1,-13,-3,7,4,0,0,1,1,1,1,1,2,1
KR_6766073918,420,-2,45,-8,-2,-6,1,7,-2,3,5,1,4,3,7,10,3,-2,0,2,1,7,-260,-3,8,5,0,0,0,1,-1,0,1,1,1
KR_6762454601,420,1,18,4,4,5,5,0,-1,1,2,1,1,0,-6,0,6,5,5,0,-1,-5,4,-2,6,4,-1,0,2,1,1,1,-1,4,1
KR_6636298299,440,7,81,-15,15,7,8,1,2,2,0,0,2,2,5,8,3,1,1,0,0,12,3,1,5,6,1,0,4,-1,1,1,1,4,1
KR_5883719500,420,1,19,-40,8,0,5,5,0,1,1,5,7,2,3,3,0,0,1,1,0,7,-1,3,4,7,-1,0,1,-1,-1,1,1,5,1
KR_6761014986,420,0,9,8,0,5,5,0,-1,1,2,-2,1,3,-2,3,5,0,1,1,0,-4,-62,0,4,4,-3,0,1,-1,1,1,-1,3,1
KR_6717728382,420,6,109,5,13,5,6,1,1,5,4,3,5,2,1,2,1,3,5,2,1,3,-11,3,5,8,2,0,1,0,1,1,1,0,1
KR_6762538038,420,0,46,0,0,0,0,0,-1,2,3,-1,2,3,-1,1,2,3,3,0,0,-2,-1,1,2,3,4,0,1,-1,-1,1,-1,5,1
KR_6589707307,420,3,17,32,16,0,1,1,1,1,0,4,7,3,10,10,0,1,1,0,0,21,2,1,4,5,0,0,-1,1,1,1,1,6,1
KR_6652161927,420,1,64,12,-5,2,4,2,-1,1,2,-1,0,1,-4,1,5,-1,2,3,0,-9,34,1,5,6,-17,0,1,1,1,1,1,4,1
KR_6575050990,420,9,139,44,15,2,4,2,8,10,2,4,5,1,4,6,2,-3,1,4,0,15,1,2,4,6,-1,0,2,1,1,1,1,3,1
KR_6745432619,420,1,18,16,6,0,2,2,-1,3,4,3,4,1,2,3,1,2,4,2,0,9,17,1,1,2,2,0,0,1,0,0,-1,4,1
KR_6705704180,420,0,9,8,-1,6,7,1,-5,0,5,4,7,3,-4,3,7,-2,0,2,0,-9,-23,-3,5,2,2,0,0,-1,1,0,-1,5,1
KR_6750878779,420,0,14,1,2,-1,1,2,-1,1,2,-1,6,7,2,3,1,3,3,0,0,11,-1,-2,6,4,1,0,0,1,-1,-1,1,2,1
KR_6764728011,420,2,7,-3,-1,-4,3,7,1,2,1,3,4,1,-2,1,3,1,2,1,-1,1,182,-1,5,4,3,0,-1,-1,-1,-1,-1,4,1
KR_6708485373,420,0,6,-24,-8,-5,0,5,-1,2,3,-3,0,3,2,3,1,-1,1,2,-1,-12,-9,-3,6,3,7,0,1,-1,-1,1,-1,1,1
KR_6674680307,420,1,4,20,1,-4,0,4,2,3,1,3,5,2,1,4,3,-1,0,1,0,-1,1,-3,9,6,-1,0,0,0,1,0,1,0,1
KR_6741337444,420,1,53,4,5,1,2,1,2,4,2,4,5,1,-3,3,6,1,1,0,0,-2,-17,1,3,4,-1,0,0,1,1,0,1,1,1
KR_6742987392,420,1,65,28,-5,-1,0,1,-2,4,6,-4,1,5,3,8,5,-1,0,1,-1,-9,-11,-1,6,5,2,0,2,-1,1,1,-1,3,1
KR_6689717006,420,-3,-42,8,-7,-4,0,4,-2,0,2,-1,3,4,3,4,1,-3,1,4,0,-4,-184,-2,6,4,1,0,0,1,0,-1,1,2,1
KR_6764943672,420,1,-22,4,4,-1,2,3,0,2,2,-1,3,4,4,4,0,2,3,1,0,5,1,2,4,6,0,0,0,1,-1,0,-1,5,1
KR_6765513505,420,3,26,-12,5,-4,0,4,0,1,1,4,6,2,3,4,1,2,3,1,0,7,-1,-1,6,5,3,0,1,1,-1,-1,-1,4,1
KR_6631026623,420,4,28,40,8,2,2,0,0,2,2,2,5,3,0,0,0,4,6,2,0,9,3,-5,8,3,4,0,1,-1,1,1,-1,1,1
KR_6642363349,420,0,21,-16,0,4,5,1,-5,2,7,-4,0,4,5,8,3,0,1,1,-1,-3,-1,4,3,7,-1,0,0,1,1,0,-1,4,1
KR_6659121114,420,-1,10,16,2,-1,0,1,-1,1,2,4,4,0,-5,2,7,5,5,0,0,-6,-5,4,3,7,1,0,0,1,1,0,1,2,1
KR_6751941938,420,2,-30,-28,2,-2,2,4,1,2,1,6,6,0,-2,1,3,-1,0,1,-1,3,-3,-1,4,3,2,0,-1,-1,-1,-1,1,2,1
KR_6761106620,420,0,-14,-12,8,5,6,1,4,5,1,-1,1,2,-3,3,6,3,4,1,-1,3,8,3,3,6,-4,0,1,-1,1,1,-1,6,1
KR_6655903639,420,4,80,24,3,-3,1,4,3,6,3,2,4,2,2,2,0,-1,1,2,0,6,180,-4,12,8,1,0,2,1,1,1,1,1,1
KR_6730953479,440,2,54,3,7,3,3,0,-1,4,5,0,1,1,3,4,1,2,2,0,0,2,-10,-1,3,2,-1,0,1,1,1,1,1,1,1
KR_6748113659,420,-1,1,-32,0,2,4,2,-1,3,4,-2,0,2,2,3,1,-1,1,2,0,-7,1,0,3,3,-4,0,1,1,-1,1,1,5,1
KR_6532450277,420,0,21,8,-3,0,2,2,1,2,1,1,4,3,-3,2,5,-2,0,2,0,-9,5,-2,5,3,6,0,-2,-1,1,-1,-1,1,1
KR_6742416090,420,-1,20,4,0,-2,1,3,-1,1,2,-1,3,4,2,4,2,2,2,0,0,7,124,3,2,5,-2,0,0,1,-1,-1,-1,6,1
KR_6763373614,420,1,-9,-21,-3,3,3,0,-1,2,3,-2,1,3,-3,4,7,0,2,2,0,-5,-7,-5,8,3,7,0,1,1,1,1,-1,5,1
KR_6741552541,420,0,16,8,5,3,3,0,-5,1,6,4,6,2,3,3,0,0,0,0,0,-1,-4,4,5,9,5,0,0,1,1,0,-1,2,1
KR_6684913313,420,4,-21,16,10,3,4,1,1,3,2,1,1,0,2,3,1,3,5,2,0,9,-3,-3,8,5,6,0,0,0,1,-1,-1,0,1
KR_6723138797,420,0,-2,8,-5,-5,0,5,-4,4,8,0,2,2,4,8,4,0,1,1,-2,2,-4,0,4,4,1,0,1,1,-1,-1,-1,6,1
KR_6762547927,440,3,-2,18,7,-1,0,1,4,7,3,1,2,1,0,0,0,3,6,3,1,16,3,-8,11,3,-3,0,1,1,1,1,1,6,1
KR_6761782212,420,5,94,-2,4,0,1,1,0,2,2,0,0,0,4,6,2,0,1,1,0,2,-118,7,1,8,0,0,1,-1,1,1,-1,4,1
KR_6764284940,420,4,75,4,12,0,1,1,7,7,0,-5,2,7,11,11,0,-1,0,1,1,10,-42,-1,3,2,1,0,2,1,-1,1,1,4,1
KR_6767566785,420,2,88,20,7,-1,4,5,3,4,1,3,3,0,-1,1,2,3,4,1,0,9,-10,7,2,9,-2,0,2,1,1,1,-1,4,1
KR_6748672785,420,-1,-12,-28,1,3,3,0,-3,2,5,-3,2,5,4,6,2,0,1,1,0,-1,1,3,1,4,-1,0,0,-1,-1,0,1,3,1
KR_6692737928,440,-1,15,-24,-2,0,2,2,5,6,1,-3,4,7,0,4,4,-4,1,5,0,-5,1,3,2,5,-1,0,-1,0,1,-1,1,0,1
KR_6608041686,420,6,94,4,14,2,3,1,-5,2,7,11,11,0,3,6,3,3,3,0,0,4,1,1,4,5,5,0,3,1,1,1,-1,3,1
KR_6724910245,440,3,97,8,6,1,1,0,4,4,0,0,3,3,1,1,0,0,0,0,0,0,0,-1,5,4,-1,0,2,0,1,1,1,0,1
KR_6754800891,420,3,7,28,5,0,1,1,3,4,1,1,3,2,2,4,2,-1,0,1,0,5,-71,3,2,5,-1,0,-1,1,1,-1,-1,2,1
KR_6763543798,420,5,77,3,12,2,3,1,2,4,2,6,8,2,0,5,5,2,3,1,-1,6,3,-1,4,3,1,0,4,1,1,1,-1,3,1
KR_6724219195,440,3,38,10,4,4,6,2,8,8,0,2,2,0,-9,3,12,-1,1,2,0,-7,-3,-4,7,3,1,0,0,0,1,1,-1,0,1
KR_6693942766,420,3,-29,-23,1,2,3,1,6,9,3,0,2,2,-9,2,11,2,3,1,0,-1,2,0,4,4,0,0,0,-1,1,0,-1,5,1
KR_6673716209,420,4,19,8,9,4,7,3,-1,4,5,3,3,0,3,3,0,0,2,2,0,9,-4,-3,8,5,5,0,1,1,0,1,1,3,1
KR_6751049100,440,1,29,-16,5,1,1,0,-2,2,4,3,3,0,2,2,0,1,1,0,0,4,-91,3,1,4,-2,0,0,1,1,0,1,1,1
KR_6428848048,420,-1,-39,-5,9,1,3,2,0,2,2,5,7,2,1,3,2,2,3,1,0,9,-14,6,3,9,1,0,1,1,1,1,1,4,1
KR_6741258570,420,0,-1,3,0,1,3,2,1,3,2,2,6,4,-3,3,6,-1,0,1,0,-7,-7,-5,7,2,3,0,-1,1,-1,-1,-1,6,1
KR_6747050817,420,3,-21,-14,-3,2,3,1,-4,1,5,-1,3,4,0,2,2,0,1,1,-1,1,6,1,4,5,-1,0,0,1,-1,0,-1,4,1
KR_6759848461,420,4,18,-8,17,0,1,1,7,8,1,4,4,0,2,6,4,4,4,0,2,22,-28,-1,2,1,16,0,0,-1,-1,1,1,4,1
KR_6763649049,420,4,53,2,5,-3,2,5,-3,2,5,5,7,2,5,5,0,1,1,0,-1,0,6,5,5,10,-1,0,-1,1,-1,-1,-1,1,1
KR_6717920018,420,4,7,13,7,1,1,0,-1,5,6,0,0,0,5,6,1,2,2,0,0,8,-4,-1,7,6,1,0,1,-1,1,1,-1,5,1
KR_6736490305,420,2,43,20,7,1,1,0,5,5,0,3,4,1,-1,1,2,-1,0,1,0,7,4,4,4,8,0,0,-1,-1,1,-1,-1,6,1
KR_6745107862,420,-2,-49,8,-3,-2,1,3,-4,0,4,5,5,0,-3,3,6,1,1,0,-1,-1,-112,0,4,4,-2,0,0,1,1,0,-1,1,1
KR_6338768705,420,-3,-59,-30,1,-1,1,2,1,1,0,2,2,0,-1,1,2,0,0,0,0,2,-3,3,3,6,1,0,0,1,1,0,1,2,1
KR_6745454765,420,4,14,16,1,2,4,2,1,5,4,-2,2,4,1,1,0,-1,0,1,0,2,-1,3,3,6,2,0,1,1,-1,1,1,4,1
KR_6745083843,420,2,68,0,3,1,4,3,0,2,2,1,3,2,2,4,2,-1,2,3,0,-2,-2,-1,5,4,0,0,1,-1,1,1,1,6,1
KR_6764756097,420,3,7,0,-3,-4,2,6,2,3,1,1,1,0,-2,0,2,0,0,0,-1,-4,2,-7,9,2,-3,0,0,1,-1,0,-1,5,1
KR_6743331590,440,2,-22,16,1,0,3,3,2,2,0,-2,2,4,1,2,1,0,0,0,0,6,-24,-1,6,5,3,0,0,1,-1,0,1,4,1
KR_6607724448,420,2,58,-2,13,-1,1,2,7,7,0,1,2,1,7,7,0,-1,0,1,0,14,7,-3,9,6,-1,0,1,-1,-1,1,1,5,1
KR_6643755332,420,3,-3,-4,8,-1,1,2,0,2,2,2,4,2,5,5,0,2,3,1,0,8,4,2,2,4,7,0,1,1,1,1,1,1,1
KR_6647419432,420,-6,-120,-20,-6,-4,0,4,1,5,4,2,2,0,-1,4,5,-4,1,5,0,5,4,1,4,5,1,0,0,1,-1,-1,-1,4,1
KR_6752162877,440,3,21,-8,6,4,5,1,0,1,1,2,5,3,0,2,2,0,0,0,0,5,-3,-1,5,4,4,0,0,1,1,0,-1,6,1
KR_6532273457,420,5,-4,33,16,1,2,1,-1,2,3,1,1,0,13,13,0,2,3,1,0,11,183,-3,8,5,2,0,2,1,1,1,1,1,1
KR_6694518822,420,2,1,2,9,0,2,2,6,6,0,5,6,1,-1,1,2,-1,0,1,0,12,0,2,5,7,3,0,1,1,1,1,1,1,1
KR_6753179311,420,1,68,16,3,-2,1,3,0,1,1,1,3,2,5,8,3,-1,1,2,1,0,60,0,7,7,0,0,0,0,1,1,1,0,1
KR_6731871982,420,4,29,43,6,-2,0,2,0,1,1,4,4,0,4,6,2,0,1,1,0,4,-34,1,4,5,29,0,1,-1,1,1,1,5,1
KR_6626328290,420,0,-25,-4,4,0,0,0,2,5,3,0,0,0,-1,3,4,3,4,1,0,8,-35,2,3,5,19,0,0,-1,0,0,-1,2,1
KR_6658617198,420,3,90,24,6,0,1,1,3,4,1,5,6,1,1,2,1,-3,0,3,0,6,1,2,2,4,3,0,0,-1,1,0,1,3,1
KR_6747490003,420,0,-62,-4,1,0,2,2,-1,1,2,2,3,1,1,2,1,-1,1,2,0,8,-3,-3,5,2,0,0,0,1,1,-1,-1,5,1
KR_6742264417,420,1,-21,12,3,1,1,0,2,3,1,1,3,2,-2,4,6,1,2,1,0,-4,-8,5,0,5,-1,0,0,1,1,0,-1,5,1
KR_6762546943,420,3,8,15,5,3,4,1,5,7,2,-1,1,2,0,4,4,-2,0,2,0,1,1,-1,4,3,-5,0,0,1,1,0,-1,2,1
KR_6718304553,420,2,-35,15,-1,-4,1,5,1,3,2,1,2,1,0,0,0,1,1,0,0,3,-4,3,5,8,1,0,0,0,-1,0,-1,0,1
KR_6760516371,440,5,49,25,13,4,4,0,2,3,1,1,2,1,5,7,2,1,1,0,0,12,-1,5,1,6,1,0,0,-1,-1,0,1,2,1
KR_6733573911,420,1,-18,20,2,-3,1,4,-2,2,4,6,6,0,0,1,1,1,1,0,0,3,-9,-1,5,4,9,0,1,1,-1,1,-1,5,1
KR_6616503980,420,5,-4,4,10,-1,0,1,3,5,2,4,5,1,3,5,2,1,3,2,0,15,9,1,6,7,3,0,0,-1,-1,0,1,2,1
KR_6753789194,420,4,8,40,10,3,4,1,8,9,1,-1,0,1,1,2,1,-1,0,1,1,6,5,3,2,5,-3,0,1,1,1,1,1,2,1
KR_6760760083,420,2,-23,16,-2,-3,0,3,-1,3,4,3,3,0,-2,1,3,1,1,0,0,1,-9,-3,7,4,-1,0,-1,-1,1,-1,-1,6,1
KR_6761387173,420,3,10,8,7,0,1,1,1,2,1,1,2,1,4,6,2,1,2,1,1,4,-90,-2,5,3,0,0,-1,1,-1,-1,1,4,1
KR_6661413197,420,3,-24,0,5,4,6,2,2,3,1,-4,0,4,4,6,2,-1,2,3,1,0,-12,0,5,5,2,0,2,1,1,1,1,1,1
KR_6763559873,440,-2,26,-48,-5,4,5,1,-2,0,2,-7,0,7,3,5,2,-3,1,4,0,-11,5,6,3,9,1,0,1,1,1,1,1,6,1
KR_6751156865,420,4,16,4,9,2,3,1,5,5,0,3,3,0,2,3,1,-3,0,3,0,7,1,2,3,5,2,0,1,-1,-1,1,1,3,1
KR_6726069595,420,4,81,-3,11,3,3,0,1,2,1,2,3,1,6,6,0,-1,0,1,0,8,3,5,1,6,2,0,2,1,1,1,1,2,1
KR_6726330713,420,2,36,24,1,2,4,2,0,1,1,1,1,0,-1,2,3,-1,0,1,0,-6,-16,0,4,4,-6,0,0,1,1,1,1,5,1
KR_6620677665,420,1,14,-22,3,3,6,3,-2,1,3,0,2,2,1,3,2,1,1,0,0,5,-7,-3,6,3,4,0,1,-1,1,1,1,2,1
KR_6764004050,420,2,1,16,7,2,2,0,3,4,1,2,4,2,0,2,2,0,1,1,2,11,19,0,4,4,0,0,0,0,0,0,1,0,1
KR_6677208671,420,2,75,-5,7,5,8,3,0,2,2,5,6,1,0,3,3,-3,0,3,0,1,-14,1,3,4,3,0,4,0,1,1,1,0,1
KR_6705442479,420,-1,24,-24,3,3,3,0,-6,2,8,1,2,1,4,8,4,1,1,0,0,2,-5,-5,7,2,7,0,0,0,-1,1,1,0,1
KR_6753527538,420,1,93,-24,-2,0,3,3,1,2,1,0,3,3,-3,4,7,0,1,1,0,-7,-13,-1,3,2,-1,0,1,-1,1,1,1,1,1
KR_6606359170,420,1,-35,-51,2,1,1,0,-3,2,5,-3,0,3,6,6,0,1,1,0,0,1,-19,-1,5,4,-5,0,1,1,1,1,1,6,1
KR_6759667454,420,1,-15,-8,6,0,1,1,1,3,2,3,5,2,2,4,2,0,0,0,0,6,-4,-1,5,4,-4,0,1,-1,1,1,1,1,1
KR_6610035031,420,0,-2,0,4,4,4,0,-3,0,3,0,1,1,4,5,1,-1,0,1,0,-1,-1,-2,7,5,-3,0,0,1,-1,0,-1,6,1
KR_6706818271,420,0,11,-15,5,-1,0,1,-2,3,5,2,2,0,2,3,1,4,5,1,0,4,6,6,1,7,0,0,0,1,-1,0,1,3,1
KR_6484756990,420,-1,6,-12,-6,2,5,3,1,6,5,-3,0,3,-4,0,4,-2,0,2,-1,-8,4,-7,9,2,2,0,0,0,1,1,-1,0,1
KR_6766864269,420,1,14,26,2,1,2,1,4,6,2,5,6,1,-7,0,7,-1,1,2,0,1,23,0,3,3,-3,0,-1,1,1,-1,1,6,1
KR_6626272513,420,0,-21,24,1,1,1,0,3,6,3,-5,1,6,3,4,1,-1,1,2,0,2,1,2,3,5,1,0,0,1,1,0,1,1,1
KR_6689423874,420,6,80,16,11,3,3,0,-1,1,2,7,7,0,3,3,0,-1,0,1,0,4,0,2,3,5,-1,0,0,1,1,1,1,2,1
KR_6655822171,440,1,11,20,-1,-1,0,1,-2,1,3,0,3,3,1,3,2,1,1,0,0,5,-2,0,3,3,1,0,-1,1,-1,-1,1,6,1
KR_6631261667,420,0,-52,-5,3,-4,1,5,1,1,0,4,6,2,1,2,1,1,2,1,0,4,8,-3,6,3,3,0,0,1,-1,-1,1,4,1
KR_6767162188,420,1,23,-19,-4,-6,1,7,0,2,2,7,8,1,-4,1,5,-1,1,2,0,-6,31,-7,9,2,-9,0,-1,-1,-1,-1,-1,3,1
KR_6716368455,440,-4,-9,-17,-1,1,2,1,1,7,6,1,2,1,-1,1,2,-3,1,4,-1,-5,-8,-2,4,2,1,0,-1,0,-1,-1,-1,0,1
KR_6745827110,440,3,37,-17,9,3,5,2,2,2,0,6,6,0,4,4,0,-6,0,6,0,16,8,4,0,4,-1,0,2,1,-1,1,1,5,1
KR_6709062829,420,0,-28,-12,0,-1,3,4,2,3,1,-3,0,3,2,3,1,0,0,0,0,9,-4,-3,6,3,2,0,0,1,-1,-1,-1,3,1
KR_6744937027,420,1,47,-4,4,-2,1,3,0,2,2,3,6,3,2,4,2,1,2,1,0,5,2,3,2,5,3,0,1,1,1,1,1,2,1
KR_6727146000,420,1,5,12,6,0,1,1,3,6,3,2,3,1,1,3,2,0,1,1,0,10,-3,5,8,13,4,0,-1,1,1,1,1,6,1
KR_6757500010,440,5,58,35,11,0,1,1,11,12,1,1,1,0,-4,2,6,3,5,2,0,4,19,5,4,9,0,0,1,-1,1,1,1,6,1
KR_6762270717,420,2,0,8,1,-2,1,3,-3,1,4,2,3,1,3,3,0,1,1,0,0,7,-1,-1,7,6,0,0,1,1,-1,1,-1,4,1
KR_6693713360,420,3,38,12,7,3,5,2,2,3,1,3,5,2,-1,0,1,0,1,1,0,6,-62,1,5,6,-1,0,1,-1,1,1,-1,4,1
KR_6759540936,420,0,31,26,0,-3,2,5,0,2,2,-3,0,3,6,7,1,0,0,0,0,-5,-2,1,5,6,0,0,1,0,1,1,1,0,1
KR_6762892860,420,-2,-31,-16,-7,1,3,2,-6,0,6,0,2,2,-2,0,2,0,0,0,-1,-13,3,0,3,3,-1,0,0,-1,-1,0,-1,1,1
KR_6635436483,440,3,5,-25,8,3,3,0,0,2,2,0,1,1,3,6,3,2,2,0,0,10,8,-2,7,5,-2,0,0,-1,1,0,1,2,1
KR_6756558023,420,1,28,3,0,-5,1,6,3,5,2,-3,1,4,1,5,4,4,5,1,-1,0,127,3,4,7,1,0,1,-1,-1,-1,-1,6,1
KR_6767314329,420,0,-34,-24,5,2,3,1,0,2,2,2,2,0,2,3,1,-1,0,1,0,3,-1,4,3,7,3,0,0,-1,0,0,-1,6,1
KR_6393783882,440,1,-24,-16,3,1,1,0,-2,2,4,2,2,0,4,5,1,-2,1,3,0,4,176,-2,5,3,0,0,2,-1,1,1,-1,2,1
KR_6708842830,440,-3,0,10,-5,1,2,1,-3,1,4,-4,2,6,2,6,4,-1,3,4,0,-7,-2,2,4,6,-2,0,1,1,1,1,-1,4,1
KR_6754840094,420,2,-35,-4,5,6,6,0,0,1,1,4,4,0,-5,1,6,0,2,2,0,-2,-26,2,3,5,11,0,1,1,1,1,-1,5,1
KR_6767219549,440,-2,-35,-24,-4,-1,0,1,-3,0,3,3,3,0,-2,1,3,-1,0,1,0,-1,-5,-5,8,3,0,0,0,-1,-1,-1,-1,6,1
KR_6732972211,420,1,-70,12,6,-2,0,2,2,4,2,2,4,2,3,4,1,1,1,0,2,14,9,4,3,7,-4,0,0,-1,-1,0,1,5,1
KR_6754307555,440,1,17,-4,8,-2,0,2,3,5,2,0,2,2,3,4,1,4,5,1,1,11,3,-3,6,3,4,0,1,1,-1,1,1,2,1
KR_6724379109,420,6,107,16,17,4,4,0,1,2,1,7,8,1,5,7,2,0,0,0,0,15,-107,3,1,4,5,0,1,1,1,1,1,4,1
KR_6762450938,420,2,71,-11,2,-1,0,1,0,3,3,-3,2,5,5,7,2,1,1,0,0,5,-1,-1,4,3,3,0,1,1,-1,1,-1,4,1
KR_6738943181,420,0,0,6,-1,3,3,0,-1,3,4,-5,0,5,2,2,0,0,0,0,0,-3,12,1,3,4,1,0,0,1,1,0,1,6,1
KR_6630044416,420,3,38,4,7,3,3,0,6,8,2,-2,1,3,2,6,4,-2,1,3,0,5,-21,0,6,6,1,0,2,1,-1,1,1,4,1
KR_6550129689,420,1,7,-36,5,0,0,0,3,6,3,3,3,0,-1,1,2,0,2,2,0,13,2,-6,6,0,2,0,-2,-1,-1,-1,-1,5,1
KR_6606583526,420,2,-1,3,-2,4,4,0,1,2,1,-1,2,3,-1,2,3,-5,0,5,0,-3,0,-1,2,1,-2,0,-1,0,0,-1,-1,0,1
KR_6635088790,420,3,99,8,4,-2,0,2,0,1,1,2,2,0,4,7,3,0,2,2,0,14,1,1,3,4,-3,0,0,-1,-1,1,-1,3,1
KR_6735985446,420,4,0,36,12,-2,2,4,5,8,3,3,6,3,3,4,1,3,3,0,2,16,-43,-3,6,3,18,0,1,1,1,-1,1,3,1
KR_6642096449,420,6,47,38,13,-1,2,3,5,7,2,-3,2,5,7,9,2,5,5,0,0,8,10,-1,6,5,-1,0,1,1,1,1,1,1,1
KR_6742266163,440,6,83,20,12,0,1,1,5,6,1,3,3,0,3,4,1,1,2,1,0,17,-38,-1,7,6,25,0,1,0,1,1,1,0,1
KR_6765346888,420,1,-59,0,2,1,3,2,3,6,3,0,4,4,-2,2,4,0,2,2,0,4,-7,-2,6,4,-2,0,-1,-1,1,-1,1,1,1
KR_6756843773,420,1,45,-1,-4,2,3,1,5,6,1,-6,0,6,-3,0,3,-2,0,2,0,-4,-4,0,4,4,3,0,0,-1,-1,-1,-1,2,1
KR_6747358079,420,2,43,0,2,3,6,3,-1,1,2,-4,1,5,2,5,3,2,2,0,0,-2,14,-2,3,1,1,0,1,-1,-1,1,1,5,1
KR_6634123032,420,-3,-26,16,-10,4,4,0,1,1,0,-3,3,6,-11,0,11,-1,1,2,0,-10,1,3,3,6,-2,0,1,-1,1,1,-1,2,1
KR_6745321143,420,2,-40,23,5,2,6,4,0,2,2,4,7,3,3,6,3,-4,0,4,0,-2,-5,0,4,4,-3,0,-1,1,0,-1,-1,6,1
KR_6767048007,420,3,32,2,6,-2,3,5,1,4,3,5,6,1,0,4,4,2,3,1,0,3,89,-1,6,5,1,0,0,1,0,1,-1,3,1
KR_6733079375,420,-2,-51,-1,-3,-8,0,8,0,3,3,0,0,0,0,1,1,5,5,0,1,7,-238,0,4,4,-1,0,0,-1,-1,-1,1,5,1
KR_6758095050,420,4,82,20,0,2,2,0,-3,1,4,2,5,3,-1,1,2,0,2,2,0,-8,4,2,2,4,-3,0,3,1,1,1,-1,5,1
KR_6729574706,420,4,47,4,9,6,6,0,1,1,0,4,6,2,-1,2,3,-1,0,1,1,5,2,1,1,2,-1,0,-1,1,1,-1,1,2,1
KR_6629022879,420,0,38,-2,3,0,1,1,0,2,2,1,1,0,1,2,1,1,1,0,0,0,-1,-6,11,5,3,0,0,1,-1,0,1,1,1
KR_6752589753,420,4,-1,27,8,4,4,0,-2,1,3,-4,1,5,7,8,1,3,4,1,0,6,19,-3,6,3,-30,0,0,1,-1,-1,-1,6,1
KR_6766375109,420,-1,-50,0,-1,0,2,2,-1,1,2,-1,3,4,1,2,1,0,0,0,1,-3,5,0,5,5,-3,0,0,-1,1,0,1,2,1
KR_6759242053,420,8,91,4,13,5,5,0,4,5,1,4,4,0,0,1,1,0,0,0,0,5,129,-7,12,5,2,0,3,1,1,1,1,1,1
KR_6764144258,420,0,54,13,1,3,4,1,-6,0,6,3,3,0,1,2,1,0,1,1,0,-9,-101,0,4,4,3,0,2,1,1,1,1,1,1
KR_6762985410,420,1,18,20,0,-1,3,4,-1,1,2,1,2,1,2,3,1,-1,0,1,0,2,-41,0,5,5,6,0,0,0,0,0,-1,0,1
KR_6615973446,420,8,140,16,22,3,5,2,4,5,1,5,5,0,11,11,0,-1,0,1,0,15,4,-2,3,1,2,0,2,-1,-1,1,1,6,1
KR_6606742315,420,-2,0,0,-3,3,3,0,1,5,4,-1,3,4,-6,0,6,0,1,1,0,-3,-6,-1,3,2,-1,0,0,-1,0,-1,-1,5,1
KR_6750905719,420,1,-50,-9,4,5,6,1,-1,2,3,3,4,1,-3,0,3,0,0,0,0,5,36,1,6,7,-1,0,0,-1,1,1,-1,5,1
KR_6752290775,420,-1,-12,28,1,1,2,1,1,4,3,-2,1,3,1,3,2,0,0,0,0,0,-6,-4,5,1,1,0,-1,1,-1,-1,1,2,1
KR_6756801753,420,4,30,0,9,3,3,0,1,4,3,-2,0,2,3,4,1,4,4,0,1,12,14,-3,8,5,2,0,1,0,0,1,-1,0,1
KR_6755775445,420,-2,-39,-19,0,2,3,1,1,3,2,1,5,4,0,1,1,-4,0,4,0,3,-5,-5,5,0,3,0,0,-1,-1,-1,-1,1,1
KR_6685128324,440,7,103,11,13,3,3,0,6,6,0,0,5,5,2,3,1,2,2,0,0,8,4,-4,7,3,6,0,3,0,1,1,1,0,1
KR_6766951580,420,4,44,24,12,5,5,0,4,5,1,5,5,0,0,1,1,-2,0,2,0,14,4,3,1,4,4,0,0,-1,1,1,1,4,1
KR_6753123399,420,2,66,4,2,6,6,0,-6,0,6,3,6,3,0,1,1,-1,3,4,0,2,4,-1,5,4,3,0,0,-1,1,1,1,3,1
KR_6732971263,440,-1,-12,-11,-6,0,0,0,0,2,2,2,2,0,-6,0,6,-2,1,3,0,-7,-1,-3,4,1,2,0,0,-1,-1,0,-1,4,1
KR_6708388097,420,1,39,4,8,6,6,0,-1,0,1,1,1,0,2,3,1,0,0,0,0,4,1,-1,3,2,1,0,0,1,-1,1,1,5,1
KR_6755578150,420,1,18,-10,-3,0,1,1,-6,2,8,1,3,2,0,4,4,2,5,3,0,-1,-15,6,1,7,2,0,0,0,-1,0,-1,0,1
KR_6628271341,420,1,29,-16,1,1,3,2,1,2,1,-2,1,3,1,8,7,0,0,0,-2,1,17,2,4,6,2,0,-1,1,-1,-1,-1,5,1
KR_6752732682,440,2,89,-6,-3,2,2,0,-8,2,10,0,1,1,1,3,2,2,3,1,1,-2,286,-7,8,1,-2,0,1,1,0,1,1,4,1
KR_6755355666,420,-3,50,0,-11,-1,3,4,-1,2,3,0,1,1,-5,0,5,-4,1,5,1,-11,-2,-3,4,1,0,0,0,-1,-1,0,1,5,1
KR_6097064870,420,2,73,0,3,-1,2,3,3,5,2,2,3,1,1,1,0,-2,0,2,0,2,-10,-6,9,3,9,0,0,1,-1,0,1,2,1
KR_6760689059,420,1,30,-8,1,0,3,3,-5,2,7,1,1,0,5,5,0,0,1,1,-1,4,12,4,3,7,-4,0,1,1,-1,-1,-1,1,1
KR_6750788361,420,2,88,-18,6,2,3,1,-2,1,3,-1,2,3,1,4,3,6,6,0,0,9,-15,-4,6,2,-1,0,0,1,1,0,-1,3,1
KR_6765050141,420,5,-13,10,11,2,4,2,2,6,4,1,1,0,3,4,1,3,3,0,0,11,-3,2,5,7,4,0,1,1,1,1,-1,5,1
KR_6765622520,420,2,-8,26,2,3,4,1,4,5,1,2,2,0,-4,2,6,-3,1,4,1,-2,9,1,5,6,-3,0,0,-1,0,0,1,5,1
KR_6762363530,420,3,52,36,2,3,6,3,0,3,3,-1,2,3,1,3,2,-1,1,2,3,4,-7,-2,7,5,-2,0,0,0,0,1,1,0,1
KR_6760956379,420,-3,-35,12,-4,-4,0,4,-1,0,1,0,1,1,2,3,1,-1,0,1,0,-3,-24,4,3,7,20,0,-1,1,-1,-1,-1,5,1
KR_6761853090,440,0,16,-2,2,1,1,0,-3,1,4,7,8,1,0,4,4,-3,0,3,0,-8,-11,-3,6,3,1,0,0,1,-1,1,-1,1,1
KR_6749376671,420,-1,18,1,0,-1,0,1,-1,2,3,-3,0,3,5,5,0,0,3,3,0,2,0,-2,4,2,0,0,0,1,1,0,1,1,1
KR_6733605318,420,3,-45,0,4,0,2,2,-1,2,3,3,4,1,0,5,5,2,3,1,0,2,-48,-2,4,2,25,0,0,1,-1,-1,-1,3,1
KR_6646272703,420,-2,21,-32,-5,-4,0,4,0,5,5,0,0,0,0,2,2,-1,1,2,0,0,3,0,4,4,-2,0,0,-1,-1,-1,-1,4,1
KR_6765811372,420,-1,-49,-20,2,-1,0,1,3,3,0,0,2,2,0,2,2,0,1,1,0,-2,-8,2,2,4,3,0,-1,1,0,-1,1,2,1
KR_6755004858,420,5,125,30,7,1,2,1,1,1,0,0,0,0,1,7,6,4,4,0,1,5,0,1,3,4,-2,0,3,0,1,1,1,0,1
KR_6525558220,420,0,29,-36,9,2,3,1,1,4,3,4,4,0,3,4,1,-1,0,1,0,12,4,2,4,6,-6,0,2,-1,1,1,1,2,1
KR_6753276566,420,5,39,16,11,4,4,0,4,6,2,-1,2,3,3,8,5,1,2,1,-1,11,-5,-4,11,7,1,0,1,-1,1,1,-1,5,1
KR_6646202962,420,-1,25,-20,-1,-5,0,5,3,5,2,5,6,1,-6,1,7,2,3,1,0,4,-1,-2,7,5,2,0,0,0,0,0,-1,0,1
KR_6764789794,420,-1,67,-24,-3,-1,0,1,-1,3,4,0,1,1,-1,2,3,0,1,1,1,-5,-4,5,2,7,1,0,1,-1,1,1,1,6,1
KR_6761625261,420,-2,50,9,-2,1,1,0,1,6,5,-2,1,3,3,5,2,-5,1,6,1,-2,-33,1,5,6,3,0,-1,1,-1,-1,1,6,1
KR_6649615412,440,7,94,-5,12,3,5,2,-3,1,4,-4,0,4,15,16,1,1,1,0,2,11,-6,-4,6,2,4,0,3,1,-1,1,1,1,1
KR_6673976075,420,0,-1,12,7,-3,2,5,2,6,4,5,5,0,2,3,1,1,1,0,0,16,42,4,2,6,-14,0,-1,1,-1,-1,-1,6,1
KR_6747438714,420,-1,0,-4,-1,-3,0,3,1,3,2,-1,1,2,4,4,0,-2,0,2,0,5,0,-1,4,3,0,0,0,1,-1,0,-1,4,1
KR_6650178829,420,-1,9,0,-3,-1,0,1,-4,1,5,-1,1,2,2,3,1,1,2,1,0,-3,-173,2,3,5,-2,0,1,1,1,1,1,2,1
KR_6646579410,420,4,78,18,7,2,2,0,0,5,5,6,7,1,0,1,1,-1,0,1,0,6,-1,-3,7,4,5,0,1,1,1,1,1,2,1
KR_6765984010,420,-3,-23,-10,-7,-1,1,2,-2,0,2,0,3,3,-2,1,3,-2,1,3,0,-6,32,1,3,4,-1,0,-3,-1,-1,-1,-1,2,1
KR_6569545973,440,2,56,-9,3,2,3,1,5,7,2,-4,1,5,0,2,2,0,0,0,0,6,0,-2,7,5,1,0,2,-1,-1,1,-1,2,1
KR_6757617469,420,2,74,8,8,5,5,0,5,8,3,1,2,1,-3,2,5,0,0,0,0,4,-113,-3,5,2,3,0,1,1,1,1,1,6,1
KR_6765499814,420,4,77,-40,9,3,4,1,0,2,2,3,5,2,3,3,0,0,1,1,-1,9,10,5,2,7,1,0,2,1,-1,1,-1,4,1
KR_6722918086,420,1,43,-19,3,1,2,1,-5,2,7,-1,2,3,6,7,1,2,3,1,1,8,-15,5,3,8,-1,0,1,0,1,1,1,0,1
KR_6715107235,420,0,31,-34,-1,-1,1,2,-3,0,3,-1,1,2,2,4,2,2,2,0,0,-1,8,-1,3,2,3,0,0,0,0,1,-1,0,1
KR_6714922992,420,3,45,4,3,3,4,1,-1,1,2,1,3,2,0,1,1,0,0,0,0,1,1,-2,5,3,4,0,1,-1,1,1,-1,6,1
KR_6602957756,420,2,36,4,1,0,1,1,-2,4,6,-1,0,1,7,9,2,-3,1,4,0,2,7,1,6,7,-4,0,0,1,-1,0,1,5,1
KR_6763418039,420,2,6,-16,0,1,2,1,1,2,1,-1,0,1,-1,3,4,0,0,0,0,-1,31,-2,6,4,5,0,0,-1,-1,0,1,4,1
KR_6732915196,420,3,37,36,4,-3,0,3,1,2,1,4,5,1,0,0,0,2,2,0,0,4,9,1,2,3,-1,0,0,0,0,0,1,0,1
KR_6741288379,420,0,32,-8,3,1,1,0,-4,3,7,3,5,2,3,4,1,0,3,3,0,2,-29,-4,10,6,23,0,1,0,0,1,1,0,1
KR_6604040094,420,7,110,0,6,0,4,4,-3,2,5,7,7,0,1,7,6,1,2,1,1,0,-5,-1,6,5,5,0,0,1,-1,1,-1,5,1
KR_6734048025,440,3,-20,-2,0,-1,1,2,4,5,1,2,3,1,-4,2,6,-1,1,2,-1,6,209,3,4,7,1,0,0,1,1,0,-1,6,1
KR_6670262276,420,-2,-45,-1,0,-1,0,1,2,3,1,0,1,1,-1,1,2,0,1,1,0,4,116,0,6,6,-2,0,0,1,-1,0,-1,1,1
KR_6750340751,440,-4,-43,-14,-9,-6,1,7,-1,4,5,-3,0,3,1,3,2,0,1,1,0,-7,5,1,1,2,-3,0,-1,1,-1,-1,-1,3,1
KR_6681637477,420,4,29,14,9,1,1,0,1,3,2,0,2,2,6,9,3,1,3,2,0,16,7,3,2,5,-2,0,0,1,0,1,1,4,1
KR_6626196028,420,0,25,-12,4,5,6,1,1,3,2,-2,2,4,-1,4,5,1,2,1,0,3,-487,-13,14,1,17,0,0,-1,1,1,-1,6,1
KR_6761609840,440,3,55,21,1,-5,0,5,1,1,0,0,0,0,5,7,2,0,1,1,0,7,4,2,1,3,0,0,1,-1,-1,1,1,2,1
KR_6759589748,440,-2,55,-48,0,-6,1,7,0,2,2,0,3,3,6,7,1,0,1,1,1,1,-28,4,1,5,-3,0,1,1,0,1,1,4,1
KR_6653332683,420,1,7,16,6,1,1,0,2,3,1,1,3,2,1,2,1,1,1,0,0,2,6,1,4,5,-2,0,0,1,-1,0,1,6,1
KR_6702471880,420,-6,-77,-9,-12,-9,0,9,1,5,4,-2,0,2,6,8,2,-8,0,8,-2,-9,-394,-3,6,3,-5,0,-2,-1,-1,-1,-1,6,1
KR_6736436602,420,2,-7,0,4,0,2,2,-1,1,2,4,5,1,0,4,4,1,2,1,0,9,1,-1,4,3,-5,0,0,1,1,0,1,3,1
KR_6698297092,420,1,64,-22,3,10,10,0,-3,2,5,-3,3,6,0,1,1,-1,1,2,0,-3,22,1,4,5,-1,0,2,1,1,1,1,4,1
KR_6766115726,420,-1,12,-1,-4,-5,0,5,6,7,1,4,7,3,-7,1,8,-2,0,2,0,2,101,-5,6,1,0,0,1,0,-1,-1,-1,0,1
KR_6607947554,420,4,118,-22,7,3,3,0,-1,3,4,3,4,1,1,7,6,1,1,0,0,7,-7,3,2,5,0,0,1,-1,1,1,-1,1,1
KR_6739949308,420,3,96,16,7,1,4,3,3,4,1,0,1,1,4,4,0,-1,2,3,1,4,-101,3,3,6,-2,0,1,0,1,1,1,0,1
KR_6763613860,420,1,0,-3,2,-1,3,4,-4,2,6,7,7,0,-3,2,5,3,3,0,0,1,3,1,5,6,-1,0,0,1,1,0,1,4,1
KR_6762856228,420,1,-2,15,4,0,2,2,0,1,1,4,6,2,-1,7,8,1,3,2,0,-2,-2,-3,5,2,5,0,-1,1,-1,-1,-1,3,1
KR_6763300397,440,0,-39,20,5,1,3,2,-1,1,2,1,3,2,2,5,3,2,2,0,0,6,-188,2,4,6,-3,0,0,1,1,1,1,5,1
KR_6685966157,420,1,66,20,6,-2,1,3,3,5,2,-1,2,3,2,3,1,4,6,2,0,9,-61,1,3,4,2,0,0,1,0,1,1,5,1
KR_6766112085,420,6,67,7,18,1,2,1,6,6,0,0,2,2,7,7,0,4,4,0,0,17,12,3,2,5,2,0,1,-1,1,1,1,6,1
KR_6707519379,420,0,4,-5,-5,-2,0,2,-2,1,3,-3,2,5,2,2,0,0,0,0,0,-3,-7,2,6,8,1,0,-1,1,-1,-1,1,6,1
KR_6731483155,420,5,-21,44,5,0,2,2,-5,1,6,7,7,0,4,4,0,-1,0,1,0,0,-30,4,4,8,0,0,-1,-1,1,-1,1,4,1
KR_6758128446,420,3,11,-5,0,1,2,1,1,2,1,0,2,2,-1,0,1,-1,0,1,0,5,6,-2,4,2,-1,0,-1,1,-1,-1,-1,1,1
KR_6752362382,420,-3,18,-36,-1,3,5,2,1,2,1,1,2,1,-3,3,6,-3,1,4,1,2,-5,0,4,4,7,0,0,-1,-1,0,1,6,1
KR_6551690760,420,3,81,-1,5,3,5,2,5,10,5,-1,1,2,-1,0,1,-1,1,2,1,3,7,8,6,14,-6,0,1,1,0,1,1,3,1
KR_6755133297,420,6,25,20,12,-3,0,3,2,4,2,2,2,0,9,10,1,2,2,0,0,13,6,2,7,9,4,0,2,1,1,1,-1,1,1
KR_6749100911,420,2,54,-4,1,3,4,1,-1,1,2,0,3,3,0,1,1,-1,0,1,0,4,2,4,2,6,-2,0,1,1,1,1,-1,4,1
KR_6760456249,440,1,-5,-52,8,-3,1,4,0,0,0,2,3,1,4,4,0,5,7,2,0,7,6,2,1,3,-3,0,0,-1,0,0,1,4,1
KR_6633018112,420,1,42,33,7,3,4,1,4,5,1,0,3,3,0,4,4,0,2,2,1,8,7,4,2,6,-1,0,1,1,0,1,1,6,1
KR_6765429469,420,3,70,-19,16,-1,2,3,1,2,1,4,7,3,5,8,3,7,7,0,1,12,-17,-2,6,4,1,0,2,1,1,1,1,1,1
KR_6767425434,420,0,49,-5,5,1,1,0,1,3,2,6,7,1,-3,1,4,0,0,0,0,2,-1,5,1,6,1,0,1,-1,1,1,1,1,1
KR_6759073359,420,-1,-85,41,0,-2,0,2,1,3,2,-1,3,4,0,1,1,2,4,2,1,2,-38,3,1,4,3,0,0,1,1,-1,1,5,1
KR_6538710732,420,-1,-52,-12,-4,-4,0,4,3,3,0,-2,4,6,0,4,4,-1,0,1,0,1,-2,1,3,4,3,0,0,-1,1,0,1,2,1
KR_6748362165,420,2,3,16,7,1,2,1,2,2,0,0,1,1,4,7,3,0,0,0,0,5,-3,2,2,4,-2,0,0,1,-1,0,1,3,1
KR_6758942093,420,3,30,4,0,1,1,0,-1,3,4,0,2,2,1,2,1,-1,1,2,0,3,-7,-1,5,4,4,0,0,1,-1,0,1,3,1
KR_6765645555,420,-1,22,16,-2,-2,0,2,-1,0,1,3,7,4,-2,2,4,0,0,0,0,-15,-4,4,3,7,-1,0,0,1,1,1,1,5,1
KR_6618711695,440,1,-47,-20,9,-1,4,5,1,1,0,4,6,2,2,2,0,3,5,2,2,18,2,4,4,8,-1,0,-3,-1,-1,-1,1,1,1
KR_6724454581,420,4,79,12,7,-2,0,2,4,5,1,2,3,1,3,5,2,0,0,0,0,10,20,1,3,4,4,0,1,1,0,1,1,1,1
KR_6723354728,420,1,-10,-29,5,1,1,0,0,3,3,-1,1,2,4,5,1,1,1,0,1,8,10,2,3,5,0,0,1,0,0,1,1,0,1
KR_6719564839,420,0,-11,-10,3,1,1,0,0,4,4,2,2,0,-2,3,5,2,3,1,1,4,2,-4,7,3,1,0,1,1,-1,1,1,5,1
KR_6627272785,420,-2,36,0,-9,-4,1,5,-4,3,7,-1,1,2,0,1,1,0,1,1,0,-9,-4,-3,6,3,2,0,1,-1,1,1,-1,3,1
KR_6610733314,420,2,5,16,3,1,3,2,0,2,2,3,5,2,-1,3,4,0,2,2,0,3,-1,1,6,7,2,0,0,-1,1,0,1,6,1
KR_6733082089,420,0,-2,21,-4,-1,0,1,-1,4,5,2,4,2,-2,0,2,-2,0,2,0,-11,-4,-1,3,2,2,0,-1,1,1,-1,1,1,1
KR_6727105643,420,9,37,60,24,7,7,0,9,10,1,9,9,0,-1,3,4,0,2,2,1,14,16,3,5,8,0,0,3,1,1,1,1,4,1
KR_6767180028,420,3,-1,30,11,2,3,1,4,4,0,5,5,0,0,1,1,0,0,0,0,11,197,1,3,4,-3,0,1,1,1,1,1,6,1
KR_6750762103,440,-3,-135,12,-10,-2,1,3,-1,0,1,-8,1,9,1,3,2,0,0,0,0,-4,-8,-2,4,2,0,0,-3,1,-1,-1,-1,2,1
KR_6615622225,420,-2,39,12,-4,-2,1,3,-4,3,7,-3,0,3,4,4,0,1,1,0,0,-2,-2,-3,5,2,3,0,1,1,-1,1,-1,6,1
KR_6744879645,420,-2,-32,-58,-1,-2,3,5,1,2,1,0,2,2,-1,3,4,1,2,1,-1,4,-401,0,6,6,-2,0,-1,-1,-1,-1,-1,5,1
KR_6725646674,420,6,39,5,14,1,3,2,6,8,2,3,3,0,2,2,0,2,2,0,0,11,16,2,0,2,0,0,1,1,-1,1,1,6,1
KR_6749991860,420,-1,-28,5,-3,-2,0,2,2,4,2,-1,1,2,1,2,1,-3,1,4,0,-3,-15,3,0,3,-3,0,-1,-1,-1,-1,-1,3,1
KR_6737722656,420,2,14,8,0,2,5,3,0,3,3,-4,0,4,1,1,0,1,2,1,0,-1,5,2,2,4,0,0,1,1,1,1,-1,1,1
KR_6750992656,420,0,3,-4,2,0,1,1,1,5,4,2,3,1,-1,1,2,0,0,0,0,3,-19,-2,6,4,0,0,0,0,1,-1,1,0,1
KR_6658617924,440,-1,-79,8,-4,-1,1,2,-1,5,6,1,2,1,-2,0,2,-1,0,1,-1,-7,-13,-2,4,2,4,0,0,1,1,0,-1,5,1
KR_6727117989,420,2,18,4,7,3,4,1,3,6,3,-2,1,3,3,4,1,0,0,0,0,6,13,1,2,3,2,0,0,-1,-1,-1,1,6,1
KR_6766135785,420,3,0,18,3,2,2,0,3,5,2,-2,3,5,0,3,3,0,0,0,-2,12,19,0,4,4,1,0,2,1,1,1,-1,5,1
KR_6737551975,440,-1,8,28,3,0,3,3,3,7,4,-3,2,5,1,6,5,2,3,1,0,-2,46,6,1,7,-13,0,1,1,1,1,-1,6,1
KR_6705538972,420,-2,-66,-4,1,2,4,2,1,1,0,1,1,0,-1,4,5,-2,1,3,0,2,5,-2,3,1,4,0,-1,-1,-1,-1,1,1,1
KR_5871429513,420,2,45,-14,8,-1,1,2,7,10,3,5,8,3,2,3,1,-5,3,8,-1,3,-5,4,4,8,1,0,1,1,1,1,-1,3,1
KR_6737677130,440,0,-24,-1,-3,0,2,2,-4,2,6,-1,0,1,3,11,8,-1,0,1,0,-3,-54,-4,5,1,23,0,1,-1,1,1,1,3,1
KR_6652025898,420,5,4,17,11,5,7,2,1,3,2,0,0,0,1,1,0,4,4,0,0,4,2,3,4,7,2,0,2,1,-1,1,1,5,1
KR_6760736001,420,2,-16,16,7,4,4,0,-1,1,2,2,3,1,2,4,2,0,1,1,0,2,-6,-2,5,3,2,0,0,1,-1,0,1,6,1
KR_6629346673,420,2,46,4,3,4,5,1,0,1,1,2,4,2,-2,0,2,-1,0,1,0,-5,4,3,3,6,-1,0,1,1,1,1,1,4,1
KR_6558468097,420,2,31,-13,8,3,4,1,-1,1,2,2,2,0,3,3,0,1,1,0,0,5,-5,2,4,6,-2,0,1,1,1,1,1,4,1
KR_6737164459,420,-3,-9,12,-9,-2,2,4,1,5,4,0,3,3,-6,0,6,-2,0,2,0,-5,-16,3,1,4,-2,0,0,1,-1,0,-1,3,1
KR_6742135403,420,-1,11,32,4,3,3,0,-1,0,1,-5,1,6,8,8,0,-1,0,1,0,5,3,2,4,6,2,0,-1,-1,-1,-1,1,3,1
KR_6732250969,420,4,-28,53,3,6,6,0,-2,2,4,-2,0,2,0,3,3,1,1,0,0,-2,-5,-1,5,4,2,0,1,-1,1,1,1,2,1
KR_6728539978,420,4,49,53,7,7,7,0,5,7,2,0,2,2,-6,4,10,1,1,0,1,8,-11,0,2,2,0,0,0,-1,1,1,1,2,1
KR_6762276453,420,0,12,-1,-2,4,4,0,-3,0,3,-2,0,2,0,1,1,-1,0,1,0,-8,15,2,2,4,-3,0,1,1,1,1,1,1,1
KR_6766787501,420,7,81,23,14,4,4,0,5,5,0,7,8,1,-1,3,4,-1,1,2,0,4,18,0,3,3,-1,0,3,1,-1,1,1,4,1
KR_6649005774,420,0,-4,5,2,2,5,3,2,8,6,-1,2,3,0,4,4,-1,1,2,0,8,0,-3,6,3,0,0,1,1,1,1,-1,2,1
KR_6441614886,420,-2,-20,-28,-3,-2,0,2,5,5,0,-4,4,8,-1,4,5,-1,0,1,0,0,191,6,2,8,1,0,1,1,1,1,1,3,1
KR_6748824241,420,1,86,-12,3,3,4,1,1,2,1,1,3,2,-3,2,5,1,3,2,1,-2,-147,-3,3,0,1,0,-1,-1,-1,-1,1,1,1
KR_6185916523,440,0,40,-1,0,-3,2,5,1,1,0,2,2,0,1,1,0,-1,0,1,0,-1,-2,1,6,7,6,0,1,1,1,1,1,2,1
KR_6765984809,420,3,95,6,3,0,1,1,0,2,2,1,2,1,-1,0,1,3,3,0,0,1,4,0,7,7,-4,0,0,-1,1,0,1,6,1
KR_6762671385,420,4,43,-8,14,4,5,1,2,2,0,-3,2,5,7,13,6,4,5,1,-3,3,1,4,2,6,3,0,1,1,1,1,1,2,1
KR_6488060771,420,0,-23,-8,1,4,5,1,-3,1,4,1,4,3,-2,0,2,1,1,0,1,3,-2,-2,6,4,-6,0,0,1,-1,0,1,4,1
KR_6749323069,420,-1,13,4,-4,-1,0,1,1,5,4,-1,1,2,-1,6,7,-2,0,2,0,3,-1,2,2,4,0,0,1,1,-1,1,1,4,1
KR_6764626850,420,-1,54,-30,3,2,5,3,-3,2,5,0,1,1,5,5,0,-1,1,2,0,8,259,-7,7,0,12,0,1,-1,1,1,1,6,1
KR_6740793482,420,2,-24,17,3,-2,1,3,1,5,4,-1,2,3,6,7,1,-1,0,1,0,5,12,3,3,6,-3,0,0,1,1,1,-1,6,1
KR_6647478536,420,0,22,8,3,-4,2,6,0,1,1,3,4,1,4,4,0,0,1,1,0,5,3,5,2,7,3,0,0,1,1,0,-1,2,1
KR_6623159395,420,1,42,-5,1,3,4,1,0,3,3,-2,0,2,4,6,2,-4,0,4,-1,-6,-2,2,3,5,-1,0,1,1,1,1,-1,6,1
KR_6706931267,420,4,47,20,11,2,3,1,2,4,2,3,3,0,4,5,1,0,2,2,0,4,214,-3,5,2,2,0,1,1,1,1,1,1,1
KR_6757040805,420,1,27,8,-3,3,4,1,-4,0,4,-1,2,3,-1,3,4,0,1,1,0,-2,-8,-2,4,2,2,0,1,0,0,1,-1,0,1
KR_6649257435,420,4,72,20,4,-3,2,5,2,4,2,2,2,0,1,2,1,2,3,1,0,7,45,-1,5,4,-17,0,0,1,-1,0,-1,5,1
KR_6754944784,420,2,-18,1,12,1,2,1,3,5,2,1,2,1,6,6,0,1,1,0,0,21,13,3,2,5,-5,0,2,1,1,1,-1,5,1
KR_6741117815,420,5,118,28,8,1,3,2,3,3,0,2,3,1,2,2,0,0,0,0,0,8,-29,1,3,4,0,0,2,1,1,1,1,3,1
KR_6719779455,420,-1,-95,-36,-1,-3,0,3,2,3,1,-5,1,6,5,5,0,0,1,1,0,1,5,4,3,7,-3,0,0,1,1,-1,1,4,1
KR_6752490298,420,-1,-28,-11,1,-2,1,3,10,11,1,-2,1,3,-6,1,7,1,1,0,0,3,11,0,5,5,-5,0,0,1,1,1,-1,6,1
KR_6751283327,420,6,54,20,14,-2,1,3,5,5,0,5,5,0,5,6,1,1,1,0,0,15,6,4,2,6,-1,0,1,1,1,1,1,1,1
KR_6654954023,420,2,-14,-4,1,2,5,3,4,4,0,1,3,2,-4,1,5,-2,2,4,0,8,-2,-3,10,7,4,0,0,-1,-1,0,-1,2,1
KR_6698653848,420,2,42,15,2,2,4,2,-1,1,2,1,5,4,-1,1,2,1,2,1,0,-3,102,0,3,3,2,0,0,-1,-1,0,1,5,1
KR_6766188184,420,1,21,24,0,8,8,0,-4,1,5,2,4,2,-6,1,7,0,1,1,-3,-11,-12,1,4,5,2,0,1,-1,1,1,-1,1,1
KR_6669504186,420,2,1,33,3,1,4,3,4,5,1,0,2,2,-1,4,5,-1,3,4,0,4,11,2,3,5,-24,0,2,0,1,1,-1,0,1
KR_6736229008,420,3,76,16,5,6,7,1,-1,1,2,1,3,2,0,2,2,-1,0,1,0,3,9,-3,9,6,-5,0,1,1,1,1,-1,3,1
KR_6744592210,420,2,42,16,-3,-3,0,3,-2,4,6,-1,0,1,2,4,2,1,2,1,0,1,-7,-3,9,6,-4,0,1,1,-1,1,-1,1,1
KR_6592450660,420,0,0,-21,5,1,2,1,2,2,0,2,4,2,-1,1,2,1,1,0,0,9,1,3,5,8,-2,0,0,1,1,1,-1,3,1
KR_6759159256,420,1,29,8,3,-2,0,2,6,7,1,3,5,2,-1,0,1,-3,0,3,0,-1,41,4,2,6,-24,0,0,1,1,0,1,1,1
KR_6764145237,420,-2,-10,25,4,0,2,2,6,6,0,2,4,2,-2,3,5,-2,0,2,0,2,6,-1,4,3,0,0,0,-1,1,1,1,6,1
KR_6688391098,420,1,66,4,-1,2,2,0,-2,0,2,4,6,2,-3,1,4,-2,1,3,0,-4,-2,2,4,6,6,0,3,-1,1,1,1,1,1
KR_6758506184,420,2,34,-4,5,-1,2,3,-1,1,2,-4,2,6,7,8,1,4,5,1,-1,4,5,0,8,8,0,0,0,0,-1,1,-1,0,1
KR_6750886761,420,3,17,24,4,4,6,2,-1,1,2,4,4,0,-3,2,5,0,1,1,0,4,-14,1,2,3,-4,0,0,-1,1,-1,-1,6,1
KR_6758166343,420,-2,-26,-19,0,-6,0,6,1,3,2,-1,1,2,7,8,1,-1,0,1,0,2,-6,-2,5,3,2,0,-1,-1,-1,-1,1,3,1
KR_6760322985,420,1,13,-28,1,5,5,0,1,2,1,1,2,1,-4,1,5,-2,0,2,-1,-5,5,-1,5,4,-6,0,-1,-1,-1,-1,-1,3,1
KR_6761134049,420,2,15,-4,1,1,1,0,-2,1,3,3,4,1,0,2,2,-1,0,1,0,3,-5,3,4,7,6,0,0,-1,1,1,1,6,1
KR_6748472842,420,-3,-36,-20,-3,-2,2,4,-1,3,4,-3,0,3,4,5,1,-1,0,1,0,0,-5,1,4,5,0,0,1,-1,1,1,-1,6,1
KR_6635545268,440,3,65,4,4,1,1,0,4,6,2,-2,3,5,1,2,1,0,0,0,0,10,186,0,3,3,-32,0,0,1,1,0,-1,5,1
KR_6764831770,420,0,-38,14,-1,-5,0,5,2,3,1,1,3,2,0,1,1,1,2,1,0,0,2,2,3,5,-1,0,-1,1,-1,-1,1,4,1
KR_6508246148,440,-5,-79,-20,-7,-2,1,3,-3,4,7,-3,0,3,0,1,1,1,3,2,0,-8,-5,-1,1,0,-2,0,0,0,-1,-1,-1,0,1
KR_6704421144,420,0,48,20,-1,0,0,0,2,3,1,-2,5,7,-1,6,7,0,2,2,-1,-1,9,-4,4,0,0,0,0,1,0,0,-1,5,1
KR_6766412416,420,1,28,-4,1,2,3,1,1,2,1,1,2,1,-3,0,3,0,1,1,0,-2,-81,-5,9,4,3,0,0,-1,-1,0,1,3,1
KR_6671873214,420,-1,-20,-12,-1,0,1,1,0,1,1,1,3,2,1,4,3,-3,0,3,0,-5,1,1,5,6,-4,0,2,-1,-1,1,1,4,1
KR_6685810834,420,1,3,9,5,0,0,0,1,5,4,-2,1,3,5,5,0,1,1,0,1,8,-10,1,8,9,4,0,0,1,-1,-1,1,1,1
KR_6675883938,420,1,-24,30,10,0,3,3,-1,2,3,3,5,2,8,8,0,0,0,0,0,6,100,-4,7,3,4,0,-1,-1,1,-1,1,2,1
KR_6766044771,420,5,72,12,12,1,3,2,3,3,0,5,7,2,5,5,0,-2,0,2,1,13,-35,2,4,6,8,0,1,1,-1,1,1,5,1
KR_6751223061,440,-2,-48,-8,-3,0,0,0,-3,0,3,0,2,2,0,1,1,0,0,0,0,-3,-6,-2,7,5,-8,0,0,-1,-1,0,-1,5,1
KR_6765906503,420,0,40,4,-2,-2,2,4,1,3,2,-3,1,4,2,4,2,0,3,3,0,-2,21,-1,5,4,-2,0,2,0,1,1,1,0,1
KR_6688178717,440,-1,-18,-4,0,-5,4,9,0,0,0,5,7,2,-2,2,4,2,2,0,0,-1,104,0,5,5,-1,0,1,-1,1,1,1,5,1
KR_6444222035,420,4,40,37,12,0,1,1,3,3,0,7,8,1,1,2,1,1,1,0,0,13,23,2,2,4,0,0,3,1,1,1,1,6,1
KR_6756595902,420,6,23,32,6,-1,2,3,2,5,3,4,4,0,-2,3,5,3,3,0,0,-1,2,-2,4,2,-2,0,1,0,1,1,-1,0,1
KR_6762736234,420,5,105,20,9,2,4,2,2,4,2,-1,2,3,3,5,2,3,4,1,1,12,4,8,1,9,1,0,1,1,-1,1,1,4,1
KR_6767217476,420,0,-46,-28,-1,-1,2,3,-1,2,3,0,0,0,-1,1,2,2,2,0,0,0,-416,1,4,5,-1,0,0,-1,0,0,-1,1,1
KR_6694356608,420,3,51,-4,6,-4,0,4,1,3,2,0,2,2,5,5,0,4,4,0,1,4,-3,0,1,1,5,0,0,1,-1,1,1,2,1
KR_6606798995,420,0,47,-28,9,4,4,0,-4,2,6,-1,0,1,7,8,1,3,5,2,0,8,-6,1,4,5,0,0,1,-1,0,1,1,3,1
KR_6548571140,420,0,33,5,-5,-3,3,6,-2,2,4,3,3,0,-3,0,3,0,1,1,0,-8,0,1,7,8,2,0,0,1,1,0,1,1,1
KR_6733300631,440,2,81,-3,3,1,2,1,-5,4,9,7,7,0,-1,1,2,1,1,0,0,5,6,5,0,5,-3,0,0,0,1,0,1,0,1
KR_6748542143,440,8,156,23,21,5,5,0,0,3,3,7,7,0,3,7,4,6,7,1,2,21,3,3,1,4,2,0,1,1,1,1,1,1,1
KR_6695735050,420,0,8,16,-1,-2,1,3,0,1,1,-1,3,4,2,4,2,0,0,0,0,3,-11,-1,5,4,-4,0,0,-1,1,1,-1,6,1
KR_6690970496,420,4,41,20,10,4,4,0,3,5,2,4,4,0,1,4,3,-2,0,2,0,1,-2,4,4,8,3,0,1,1,1,1,-1,3,1
KR_6610367062,420,-2,-5,4,-2,1,1,0,-1,3,4,-7,0,7,2,4,2,3,4,1,0,0,178,-3,5,2,1,0,0,0,-1,-1,1,0,1
KR_6749216716,420,2,74,13,3,8,9,1,0,1,1,-6,0,6,1,2,1,0,0,0,0,-5,30,2,4,6,3,0,1,1,1,1,1,4,1
KR_6743312903,420,-2,-56,11,1,-2,2,4,-2,0,2,1,4,3,1,2,1,3,3,0,0,4,27,4,0,4,-4,0,0,1,-1,0,-1,3,1
KR_6653277231,420,0,-39,-1,0,1,2,1,1,2,1,0,5,5,-2,3,5,0,1,1,0,-5,164,1,4,5,2,0,0,-1,1,1,-1,2,1
KR_6751194225,420,0,-22,9,2,6,6,0,-4,2,6,0,2,2,-1,2,3,1,1,0,0,-2,11,-1,5,4,4,0,0,0,0,0,-1,0,1
KR_6744919252,420,1,85,-12,10,5,7,2,0,3,3,1,2,1,5,7,2,-1,1,2,0,3,3,6,2,8,2,0,1,1,1,1,1,6,1
KR_6726166061,420,-1,13,20,-4,1,1,0,1,3,2,-2,5,7,-4,3,7,0,0,0,0,-3,-16,-1,4,3,2,0,1,1,1,1,1,5,1
KR_6691212208,420,2,6,24,-1,-2,1,3,-2,3,5,3,5,2,0,3,3,0,1,1,0,-2,-2,-2,6,4,0,0,0,-1,1,1,1,3,1
KR_6767227916,420,2,66,13,4,0,2,2,1,3,2,3,3,0,-1,1,2,1,2,1,1,11,4,0,5,5,-1,0,1,1,-1,1,1,5,1
KR_6765228554,440,3,-34,16,-2,-6,1,7,0,2,2,-1,0,1,5,6,1,0,0,0,0,1,-3,5,2,7,0,0,-1,1,-1,-1,-1,5,1
KR_6751705245,420,2,37,-8,8,3,4,1,2,3,1,2,2,0,0,1,1,1,1,0,0,2,61,5,1,6,-24,0,1,1,1,1,1,1,1
KR_6728744201,420,0,29,8,-7,-3,1,4,-4,3,7,0,2,2,-1,1,2,1,2,1,0,-3,3,0,9,9,-2,0,0,1,1,1,-1,5,1
KR_6766592012,420,-1,-54,-8,-1,1,2,1,-4,0,4,0,2,2,2,5,3,0,2,2,-1,0,2,4,4,8,7,0,0,1,1,0,-1,1,1
KR_6761109151,440,-3,-4,7,-2,-1,5,6,1,2,1,-5,3,8,3,4,1,0,0,0,0,-2,-4,0,4,4,2,0,0,1,-1,-1,1,6,1
KR_6692827600,420,5,106,16,10,1,4,3,3,3,0,2,4,2,5,9,4,-1,3,4,0,7,-1,-2,4,2,2,0,2,0,1,1,-1,0,1
KR_6384820442,420,2,2,6,8,-1,0,1,1,3,2,3,4,1,7,10,3,-2,0,2,0,5,96,1,6,7,-4,0,0,1,1,0,-1,1,1
KR_6764788643,420,4,54,33,10,1,1,0,4,4,0,-2,0,2,5,5,0,2,2,0,0,9,-3,2,3,5,3,0,-1,1,-1,-1,1,1,1
KR_6760106968,420,7,80,4,13,1,1,0,1,3,2,1,1,0,9,11,2,1,2,1,0,11,-23,2,2,4,3,0,1,-1,1,1,1,5,1
KR_6756722762,420,1,59,-12,1,5,6,1,-3,2,5,4,6,2,-1,1,2,-4,0,4,1,-5,16,5,1,6,-5,0,1,1,1,1,1,4,1
KR_6767527931,420,-1,-15,8,2,2,3,1,4,5,1,-7,0,7,3,8,5,0,1,1,0,-4,4,3,2,5,-1,0,1,1,-1,1,1,3,1
KR_6723146259,420,1,5,3,5,1,3,2,-3,0,3,3,4,1,3,4,1,1,1,0,1,5,-17,6,2,8,3,0,0,1,1,-1,1,2,1
KR_6732340562,420,1,40,-47,1,-2,1,3,-4,1,5,0,0,0,2,4,2,5,5,0,0,6,-7,-1,3,2,4,0,0,-1,1,1,1,4,1
KR_6761398210,420,2,18,30,1,-5,1,6,5,6,1,1,3,2,0,0,0,0,0,0,0,6,3,2,2,4,0,0,0,1,-1,-1,-1,2,1
KR_6761325689,420,2,114,-25,1,1,4,3,1,2,1,1,3,2,-1,2,3,-1,2,3,1,8,1,-6,10,4,10,0,-1,1,1,-1,1,3,1
KR_6723553168,420,2,-38,5,7,5,5,0,0,0,0,0,2,2,2,8,6,0,0,0,0,6,4,-1,6,5,-1,0,2,-1,1,1,1,5,1
KR_6606557198,420,-1,2,16,2,0,3,3,2,5,3,4,4,0,-2,1,3,-2,1,3,0,2,-219,3,4,7,1,0,0,-1,-1,0,1,1,1
KR_6748471776,420,-1,7,-4,-5,-3,2,5,-1,1,2,-2,2,4,1,3,2,0,1,1,1,-3,-1,1,3,4,-1,0,0,1,-1,-1,1,2,1
KR_6691909628,440,1,0,8,2,1,1,0,-2,1,3,-1,3,4,3,4,1,1,1,0,0,5,-8,-1,4,3,0,0,-1,1,-1,-1,1,1,1
KR_6759658150,420,5,91,16,15,6,6,0,2,3,1,1,3,2,3,4,1,3,4,1,1,20,11,8,0,8,0,0,3,1,0,1,-1,2,1
KR_6762282921,440,-4,48,-46,-2,1,2,1,-2,0,2,-5,1,6,5,5,0,-1,1,2,1,-2,-38,2,3,5,3,0,0,0,0,0,1,0,1
KR_6756907560,420,-1,-3,16,-6,-6,2,8,0,2,2,4,5,1,-3,1,4,-1,1,2,0,-1,1,6,2,8,6,0,-1,1,-1,-1,1,4,1
KR_6735555038,440,1,-33,-16,11,2,2,0,1,2,1,-1,3,4,5,5,0,4,4,0,0,16,-11,4,0,4,0,0,0,-1,1,1,1,5,1
KR_6762159231,420,-6,-76,-28,-14,-2,0,2,-3,0,3,1,1,0,-8,0,8,-2,0,2,0,-10,-9,-2,5,3,-5,0,-1,1,1,-1,-1,4,1
KR_6761491952,440,0,-1,-4,1,0,2,2,-7,0,7,9,9,0,-2,3,5,1,2,1,0,-1,-15,-3,6,3,-1,0,1,-1,-1,1,1,6,1
KR_6653193549,420,2,39,0,3,-1,1,2,0,1,1,-2,1,3,5,5,0,1,1,0,0,8,-166,0,4,4,4,0,0,-1,0,-1,1,6,1
KR_6688573821,420,0,4,-17,-1,0,4,4,-2,1,3,0,1,1,1,5,4,0,0,0,0,6,14,0,5,5,1,0,0,-1,0,0,-1,1,1
KR_6732989789,420,-6,-5,-26,-14,-3,2,5,-2,3,5,-5,1,6,-3,2,5,-1,0,1,0,-12,-15,0,4,4,11,0,1,-1,-1,1,-1,4,1
KR_6748290539,420,0,16,16,4,-2,2,4,-2,0,2,2,2,0,3,4,1,3,3,0,0,2,-43,3,1,4,25,0,1,1,1,1,-1,3,1
KR_6529250073,420,1,15,7,6,-4,3,7,3,4,1,2,5,3,5,7,2,0,1,1,0,10,4,2,5,7,3,0,2,1,1,1,1,3,1
KR_6653724159,420,5,100,10,10,4,4,0,-1,2,3,-2,2,4,7,9,2,2,2,0,0,5,4,1,1,2,5,0,1,1,-1,1,-1,4,1
KR_6648423472,420,0,46,20,-6,3,3,0,-5,1,6,2,5,3,-6,2,8,0,1,1,0,-18,-53,2,4,6,2,0,1,-1,1,1,-1,5,1
KR_6761252357,440,1,14,28,-1,2,2,0,1,5,4,-3,0,3,0,1,1,-1,0,1,0,1,0,-1,5,4,-1,0,0,-1,1,0,-1,2,1
KR_6760451069,440,-5,17,-8,-2,-3,0,3,1,2,1,-1,0,1,2,2,0,-1,1,2,0,1,2,-4,7,3,-2,0,0,1,-1,0,1,2,1
KR_6739525043,420,1,-15,28,4,-1,1,2,2,4,2,0,1,1,3,5,2,0,1,1,0,8,-3,-1,6,5,1,0,0,1,-1,-1,-1,6,1
KR_6765837417,420,4,11,-20,10,1,2,1,6,8,2,-1,3,4,1,2,1,3,3,0,0,7,-4,-3,7,4,3,0,2,1,-1,1,-1,4,1
KR_6763316319,440,2,-12,-19,6,1,1,0,1,1,0,4,5,1,3,4,1,-3,4,7,0,-1,-15,4,3,7,1,0,0,0,0,0,1,0,1
KR_6761212583,420,5,68,27,16,0,1,1,5,6,1,0,5,5,11,11,0,0,1,1,0,24,42,2,4,6,-25,0,2,-1,-1,1,-1,4,1
KR_6728203072,420,-4,3,-48,-1,2,2,0,0,3,3,-2,4,6,-3,2,5,2,3,1,0,1,-11,-1,4,3,0,0,1,0,0,1,-1,0,1
KR_6682982268,420,3,64,1,7,2,2,0,0,2,2,9,9,0,-3,1,4,-1,0,1,1,3,-1,0,6,6,-1,0,0,-1,1,0,1,6,1
KR_6747785616,420,0,10,-13,1,6,7,1,0,1,1,-1,3,4,-5,1,6,1,1,0,0,-4,-2,1,4,5,-3,0,0,-1,1,1,1,2,1
KR_6760744063,440,-1,5,-8,-5,-9,1,10,2,2,0,1,3,2,5,8,3,-4,1,5,0,-2,-5,0,4,4,0,0,-1,1,-1,-1,1,4,1
KR_6745224182,420,1,39,-21,-6,-2,1,3,2,4,2,-2,1,3,2,2,0,-6,0,6,-1,-9,42,6,4,10,-19,0,1,-1,1,1,-1,3,1
KR_6743722391,420,4,-24,44,7,0,1,1,5,5,0,2,2,0,1,1,0,-1,1,2,0,5,3,0,5,5,1,0,-1,0,1,-1,-1,0,1
KR_6624419794,420,2,118,20,2,-1,2,3,-1,0,1,1,2,1,1,3,2,2,2,0,0,2,11,5,2,7,-1,0,2,1,1,1,-1,6,1
KR_6762486630,420,1,33,-4,-1,-1,0,1,-1,2,3,-1,2,3,-1,3,4,3,5,2,0,-5,-79,0,4,4,5,0,0,-1,1,0,1,3,1
KR_6663811536,420,1,22,4,6,3,3,0,2,6,4,1,2,1,0,5,5,0,3,3,0,5,-1,-3,6,3,1,0,0,-1,1,1,1,5,1
KR_6722382400,420,4,36,23,9,-2,0,2,4,8,4,8,8,0,-1,2,3,0,3,3,0,3,-169,1,3,4,2,0,0,-1,-1,1,-1,5,1
KR_6750677593,420,3,38,20,5,1,5,4,-2,1,3,1,3,2,4,6,2,1,3,2,0,2,14,2,5,7,0,0,1,1,-1,1,-1,6,1
KR_6752950276,420,1,-21,28,4,2,3,1,0,1,1,0,0,0,1,1,0,1,1,0,0,4,-52,-3,5,2,15,0,0,-1,-1,0,1,1,1
KR_6581608390,420,4,107,4,3,2,6,4,-1,1,2,0,4,4,0,2,2,2,2,0,-1,1,-3,-3,4,1,4,0,2,-1,-1,1,-1,3,1
KR_6654205044,420,1,38,6,0,1,3,2,-1,1,2,-1,2,3,0,1,1,1,1,0,0,-1,-3,2,5,7,2,0,0,1,-1,0,1,6,1
KR_6738123287,420,0,-13,28,3,0,2,2,0,4,4,3,4,1,1,4,3,-1,2,3,0,-3,2,-4,6,2,0,0,0,0,1,1,1,0,1
KR_6756579114,420,5,62,36,1,-2,2,4,1,2,1,-1,2,3,3,4,1,0,0,0,0,-4,-3,-4,5,1,3,0,-1,1,-1,-1,1,2,1
KR_6751356305,420,4,38,20,6,4,5,1,-2,4,6,-4,3,7,5,7,2,3,4,1,0,13,-46,4,1,5,11,0,0,1,0,1,1,3,1
KR_6683048046,420,3,37,-5,12,3,3,0,4,4,0,2,5,3,-1,5,6,4,6,2,1,19,-3,0,7,7,3,0,0,0,1,0,1,0,1
KR_6615680254,420,7,42,28,13,2,3,1,5,5,0,3,4,1,-1,3,4,4,6,2,2,8,-3,-1,4,3,2,0,3,-1,1,1,1,6,1
KR_6762599786,420,4,58,-4,3,-1,1,2,0,3,3,1,3,2,2,2,0,1,1,0,0,5,3,3,1,4,2,0,-1,1,-1,1,1,6,1
KR_6759730873,440,1,-68,-1,9,-2,0,2,11,11,0,-1,1,2,-1,1,2,2,2,0,0,15,3,3,3,6,-4,0,3,1,1,1,-1,1,1
KR_6766952233,440,1,48,24,1,0,5,5,6,6,0,0,4,4,-4,0,4,-1,0,1,1,4,-1,2,2,4,1,0,0,0,0,0,1,0,1
KR_6636435902,420,-2,11,-16,-4,-1,1,2,-2,2,4,-7,1,8,8,8,0,-2,0,2,1,-4,13,-4,7,3,-4,0,1,1,-1,1,1,1,1
KR_6753321409,420,-3,-1,-16,-2,5,5,0,-1,2,3,-4,2,6,-2,2,4,0,0,0,0,-6,-51,-1,4,3,14,0,0,-1,-1,-1,1,5,1
KR_6720528296,420,0,-63,28,0,1,2,1,2,2,0,-2,4,6,-2,5,7,1,1,0,0,6,6,3,3,6,-2,0,0,-1,1,0,1,3,1
KR_6742281164,420,0,37,-24,3,3,3,0,0,3,3,1,4,3,-1,4,5,0,1,1,-1,4,-12,-2,7,5,1,0,-1,-1,1,-1,-1,3,1
KR_6740098053,420,0,11,-11,2,2,3,1,2,2,0,-1,2,3,1,3,2,-2,1,3,4,10,217,1,4,5,-1,0,0,1,-1,-1,1,5,1
KR_6554542391,420,1,13,13,-7,-4,0,4,-5,1,6,4,6,2,-2,3,5,0,1,1,0,-20,6,4,4,8,-2,0,0,1,-1,-1,-1,6,1
KR_6648818792,420,-2,-44,-12,5,2,3,1,-4,2,6,2,4,2,5,7,2,0,0,0,0,9,2,2,2,4,3,0,-1,1,-1,-1,1,2,1
KR_6765125122,420,2,76,20,-1,5,7,2,2,4,2,-2,3,5,-4,1,5,-2,2,4,0,-14,105,0,5,5,3,0,1,1,1,1,-1,3,1
KR_6763399689,420,0,-38,5,3,0,3,3,5,6,1,-4,0,4,-3,1,4,5,5,0,1,5,15,0,3,3,-1,0,1,1,-1,1,1,2,1
KR_6749950047,420,1,30,-7,-6,1,1,0,1,3,2,1,2,1,-6,4,10,-3,0,3,0,-12,4,0,4,4,-3,0,-1,1,1,-1,-1,6,1
KR_6719380921,420,1,102,17,2,2,3,1,-1,0,1,2,2,0,0,2,2,-1,1,2,0,-2,-35,2,4,6,19,0,1,-1,1,1,1,4,1
KR_6727550122,440,1,18,16,-1,-1,1,2,1,4,3,-2,2,4,2,5,3,-1,3,4,2,3,-289,-5,8,3,1,0,1,1,1,1,1,3,1
KR_6650264563,420,3,-65,3,5,5,6,1,1,3,2,1,3,2,5,6,1,-7,0,7,0,8,11,3,5,8,-10,0,0,-1,-1,0,-1,1,1
KR_6761675645,420,4,35,-20,19,4,4,0,8,8,0,2,2,0,1,2,1,4,4,0,1,21,-21,4,1,5,2,0,1,1,-1,1,1,5,1
KR_6718230060,420,3,-50,-16,10,2,2,0,0,2,2,2,4,2,2,3,1,4,4,0,0,5,-12,3,5,8,-1,0,0,-1,1,0,1,4,1
KR_6766603145,440,-1,110,-4,3,0,1,1,4,5,1,0,2,2,-1,3,4,0,0,0,0,2,4,-3,6,3,0,0,1,1,-1,1,-1,5,1
KR_6658389169,420,1,11,-4,5,1,2,1,-1,2,3,1,2,1,2,2,0,2,3,1,0,10,10,3,2,5,-6,0,0,1,-1,0,1,5,1
KR_6743142480,420,2,20,1,2,0,2,2,0,4,4,4,5,1,-2,3,5,0,3,3,0,1,1,4,0,4,-2,0,1,1,-1,1,1,2,1
KR_6744822874,420,1,8,18,0,-4,1,5,-2,1,3,6,9,3,1,2,1,-1,0,1,0,1,-56,2,3,5,-20,0,0,-1,1,-1,1,6,1
KR_6749096001,420,0,-36,15,10,4,6,2,5,5,0,-1,2,3,2,3,1,0,0,0,0,7,-40,2,2,4,2,0,-1,1,-1,-1,1,6,1
KR_6602255871,420,2,61,-16,6,3,3,0,-2,2,4,1,5,4,2,7,5,2,6,4,0,8,-7,2,6,8,0,0,1,-1,-1,1,-1,2,1
KR_6342697906,420,0,27,32,-4,-1,0,1,4,5,1,-4,0,4,-2,3,5,-1,1,2,0,-6,5,1,6,7,2,0,0,1,1,0,1,2,1
KR_6767157717,420,4,67,16,1,0,1,1,4,5,1,-1,0,1,-2,0,2,0,0,0,0,3,8,-1,8,7,1,0,1,1,0,1,-1,3,1
KR_6747093673,420,3,84,-14,-2,1,4,3,-3,1,4,-1,0,1,2,3,1,-1,1,2,0,-12,-154,-2,5,3,2,0,0,-1,1,-1,1,6,1
KR_6738830472,440,3,54,29,3,2,2,0,1,2,1,1,3,2,0,0,0,-1,0,1,0,1,6,0,5,5,-5,0,1,1,1,1,1,4,1
KR_6754980723,420,-1,-21,1,3,-3,3,6,5,6,1,1,1,0,0,3,3,0,0,0,0,4,-1,0,6,6,-1,0,0,1,1,0,1,4,1
KR_6758098967,440,5,70,28,7,0,3,3,2,2,0,3,4,1,-1,0,1,3,3,0,1,7,12,-3,6,3,6,0,1,0,0,1,1,0,1
KR_6525865388,420,-4,-31,-36,-9,0,2,2,-1,1,2,-1,1,2,-3,3,6,-4,0,4,0,-14,-131,-3,7,4,0,0,-1,-1,1,-1,1,2,1
KR_6767201490,420,2,-20,-20,1,-1,1,2,0,2,2,6,7,1,-4,3,7,0,0,0,0,2,73,-2,6,4,-4,0,0,-1,1,-1,-1,3,1
KR_6575167777,420,-3,-35,-6,-9,-2,0,2,-9,2,11,2,3,1,-1,0,1,1,1,0,0,-10,-5,-2,6,4,8,0,-2,-1,0,-1,1,3,1
KR_6708133768,420,6,91,28,15,3,3,0,6,9,3,-1,3,4,6,6,0,1,1,0,0,14,166,4,3,7,2,0,2,1,1,1,-1,6,1
KR_6752448149,420,5,155,-20,6,2,2,0,2,4,2,-5,1,6,7,7,0,0,0,0,0,3,36,0,8,8,-21,0,3,-1,1,1,-1,2,1
KR_6707887989,420,-1,-16,-12,0,0,1,1,0,2,2,-1,0,1,-3,3,6,4,5,1,0,-1,0,5,1,6,-3,0,-2,0,-1,-1,1,0,1
KR_6727462572,420,-2,-15,28,-6,-1,1,2,2,6,4,-3,0,3,-2,0,2,-2,1,3,0,-8,11,3,4,7,-3,0,0,1,-1,0,-1,4,1
KR_6762483781,420,-2,46,7,-2,1,1,0,1,2,1,0,0,0,-4,2,6,0,1,1,0,-2,2,-1,4,3,-2,0,0,0,1,0,-1,0,1
KR_6762406611,420,1,60,-12,5,3,4,1,3,5,2,-3,0,3,3,4,1,-1,0,1,-1,6,5,-1,4,3,2,0,0,1,0,0,-1,5,1
KR_6756782387,420,3,42,-6,15,2,3,1,3,4,1,5,5,0,5,5,0,0,1,1,0,23,-40,-2,5,3,16,0,0,1,-1,-1,1,3,1
KR_6534625526,420,2,7,-1,5,0,0,0,-1,1,2,1,1,0,8,9,1,-3,0,3,0,8,6,1,7,8,7,0,0,1,1,0,1,4,1
KR_6767937914,420,5,122,26,9,8,8,0,-1,1,2,-2,0,2,4,5,1,0,2,2,0,-7,10,1,2,3,1,0,2,0,-1,1,1,0,1
KR_6665715269,420,-2,8,-27,2,1,2,1,4,8,4,-2,1,3,0,5,5,-1,0,1,-1,9,19,-1,7,6,2,0,0,-1,1,-1,-1,1,1
KR_6750942444,420,0,-23,6,-1,1,1,0,5,5,0,-4,3,7,-1,0,1,-2,0,2,0,0,-13,1,3,4,3,0,-1,1,1,-1,1,2,1
KR_6759389094,420,2,44,-2,6,7,7,0,-3,0,3,6,7,1,-2,1,3,-2,1,3,0,0,2,3,3,6,-2,0,0,1,0,0,1,4,1
KR_6755417405,420,2,44,-20,4,2,2,0,0,1,1,2,4,2,0,0,0,0,1,1,0,0,14,6,1,7,-4,0,1,1,-1,1,-1,1,1
KR_6621087897,420,2,-9,32,6,0,2,2,1,2,1,2,5,3,3,4,1,0,0,0,0,4,-165,-2,3,1,2,0,1,-1,-1,1,-1,6,1
KR_6743596135,420,-1,-45,8,-2,4,6,2,0,3,3,-3,1,4,-1,3,4,-2,0,2,0,3,122,1,4,5,0,0,0,-1,1,1,1,2,1
KR_6757073315,420,2,106,-24,10,1,1,0,-2,2,4,7,7,0,2,3,1,2,4,2,1,9,-10,0,2,2,0,0,1,1,1,1,1,3,1
KR_6751316395,440,4,32,8,12,3,3,0,6,8,2,2,2,0,4,4,0,-3,0,3,0,9,2,2,1,3,-2,0,0,1,-1,0,-1,4,1
KR_6745458900,420,0,32,20,-2,3,3,0,2,3,1,-8,5,13,2,5,3,-1,2,3,-1,-8,3,-2,7,5,1,0,2,0,1,1,-1,0,1
KR_6757743515,420,3,40,17,11,8,8,0,4,6,2,2,4,2,-2,2,4,-1,0,1,1,12,-10,-8,11,3,0,0,3,1,-1,-1,1,5,1
KR_6676225304,420,0,-10,24,-12,3,3,0,-2,2,4,1,2,1,-14,2,16,0,1,1,-4,-25,-11,-8,9,1,8,0,-1,-1,1,-1,-1,4,1
KR_6741612048,420,5,-20,40,5,1,3,2,2,4,2,1,1,0,0,2,2,1,2,1,0,2,10,-2,7,5,0,0,0,1,1,0,1,1,1
KR_6742757255,420,0,-24,4,2,1,3,2,-1,2,3,1,3,2,1,6,5,0,2,2,0,10,14,0,4,4,2,0,0,-1,-1,-1,-1,3,1
KR_6653836123,420,3,37,10,4,6,7,1,5,5,0,-5,2,7,-2,0,2,0,1,1,0,3,167,-3,5,2,3,0,0,-1,1,1,-1,5,1
KR_6661390513,420,0,10,-20,8,-1,3,4,3,4,1,0,1,1,5,5,0,1,1,0,1,8,-2,3,3,6,-2,0,0,1,-1,-1,1,6,1
KR_6745404826,420,3,-4,-8,2,-1,0,1,1,4,3,2,3,1,0,1,1,0,2,2,0,5,16,-3,8,5,0,0,0,0,0,0,-1,0,1
KR_6634701396,420,3,58,-8,5,1,2,1,-2,2,4,3,7,4,5,5,0,-2,1,3,0,-3,1,3,4,7,-5,0,1,1,-1,1,1,3,1
KR_6630458036,420,-6,-65,-31,-7,-1,1,2,2,6,4,-4,2,6,-1,2,3,-3,1,4,0,-3,19,-3,5,2,-3,0,0,-1,1,1,1,1,1
KR_6626215047,420,2,56,-13,5,2,4,2,-1,0,1,0,2,2,3,5,2,1,1,0,0,-1,-5,5,2,7,2,0,1,1,-1,1,-1,4,1
KR_6740292237,420,3,-2,8,-2,-2,2,4,-1,3,4,-3,3,6,2,7,5,2,2,0,-3,-14,21,3,4,7,0,0,1,-1,-1,1,-1,6,1
KR_6739173751,420,5,65,-2,13,4,5,1,0,3,3,1,4,3,1,1,0,7,8,1,1,6,-10,-5,7,2,8,0,3,1,1,1,1,5,1
KR_6751212331,420,-2,4,16,3,2,4,2,-1,0,1,1,2,1,2,3,1,-1,1,2,0,4,11,3,3,6,-1,0,1,1,1,1,1,6,1
KR_6766569184,420,3,32,28,8,-3,0,3,2,4,2,8,9,1,1,3,2,0,0,0,0,7,-1,-3,4,1,1,0,1,0,1,1,-1,0,1
KR_6665419988,420,4,64,55,4,6,6,0,-1,2,3,-4,2,6,3,4,1,0,0,0,0,-6,19,5,3,8,2,0,0,1,1,1,1,3,1
KR_6709647971,420,3,20,16,8,2,3,1,2,2,0,1,2,1,-2,2,4,5,5,0,2,12,-5,1,1,2,3,0,1,1,1,-1,1,1,1
KR_6767831321,420,2,32,32,1,-3,1,4,-1,1,2,1,3,2,5,6,1,-1,0,1,0,3,-14,0,2,2,-3,0,-1,1,-1,-1,1,2,1
KR_5873141691,420,-3,-53,4,-9,3,5,2,-5,0,5,-3,1,4,-3,1,4,-1,1,2,0,-9,-3,-8,9,1,0,0,-1,-1,-1,1,-1,2,1
KR_6646679151,420,4,72,44,8,2,3,1,3,4,1,0,1,1,4,5,1,-1,0,1,0,10,-5,2,3,5,3,0,0,1,0,0,1,6,1
KR_6749969405,420,4,-52,4,2,0,0,0,5,5,0,-4,0,4,2,2,0,-1,0,1,0,5,-20,3,2,5,0,0,-1,1,-1,-1,-1,1,1
KR_6725482793,440,-1,-1,-4,4,-3,0,3,2,2,0,3,7,4,-2,3,5,4,4,0,0,8,18,4,4,8,4,0,-1,-1,1,-1,-1,5,1
KR_6607983235,420,4,84,39,10,-1,3,4,6,8,2,0,1,1,3,3,0,2,6,4,-1,3,-1,4,3,7,5,0,2,1,0,1,-1,1,1
KR_6762694451,420,3,-33,24,9,0,2,2,3,6,3,1,1,0,2,2,0,3,3,0,0,9,8,-1,4,3,1,0,1,1,1,1,1,1,1
KR_6693663773,420,3,44,-4,8,4,4,0,3,5,2,-2,2,4,2,4,2,1,1,0,0,10,25,1,1,2,2,0,1,1,1,1,1,2,1
KR_6683884283,420,3,35,47,8,2,2,0,1,6,5,2,3,1,3,4,1,0,2,2,0,5,1,2,1,3,5,0,3,-1,1,1,1,6,1
KR_6767943739,420,-1,-57,22,3,1,3,2,0,7,7,6,7,1,-2,2,4,-2,0,2,0,1,3,-4,7,3,-1,0,-1,1,1,-1,1,2,1
KR_6745747844,420,3,54,20,1,2,2,0,4,5,1,0,1,1,-2,3,5,-3,0,3,0,-2,11,2,3,5,-1,0,2,-1,1,1,-1,3,1
KR_6715424079,420,-1,-10,-4,0,-4,1,5,4,8,4,0,0,0,3,7,4,-3,0,3,0,1,-2,2,4,6,-4,0,-1,0,-1,-1,-1,0,1
KR_6757682741,420,2,23,-12,4,3,3,0,3,5,2,-1,2,3,1,2,1,-2,2,4,0,3,-1,0,2,2,2,0,2,-1,-1,1,1,6,1
KR_6761931141,420,1,30,-4,-2,-3,1,4,0,1,1,-2,4,6,4,8,4,-1,0,1,0,-3,7,2,1,3,2,0,1,-1,1,1,-1,2,1
KR_6619033287,440,4,65,28,6,7,7,0,-4,1,5,1,1,0,1,2,1,1,1,0,0,2,-6,-1,4,3,1,0,2,-1,1,1,1,4,1
KR_6763415560,420,-2,-1,-32,3,-2,0,2,1,3,2,0,2,2,2,2,0,2,3,1,0,9,5,-1,4,3,1,0,-1,1,-1,-1,1,6,1
KR_6649623265,420,0,-17,-12,5,-3,0,3,-1,2,3,4,5,1,3,4,1,2,3,1,0,10,-44,-1,1,0,16,0,1,1,0,1,1,5,1
KR_6693094276,420,-1,12,-11,1,0,2,2,3,4,1,-1,2,3,-2,3,5,1,2,1,0,3,-22,-3,6,3,4,0,0,1,-1,0,1,5,1
KR_6713402769,420,2,15,40,0,8,9,1,1,5,4,-4,1,5,-4,3,7,-1,0,1,-4,-16,-1,-4,5,1,-1,0,0,1,1,-1,-1,4,1
KR_6736292430,420,-2,-4,0,-3,1,1,0,0,2,2,-1,0,1,0,2,2,-3,1,4,0,-9,-3,0,7,7,3,0,-1,1,-1,-1,-1,3,1
KR_6554172392,420,3,25,-33,10,0,1,1,10,12,2,3,3,0,-2,1,3,-1,1,2,-1,7,-5,1,4,5,2,0,-2,-1,-1,-1,-1,3,1
KR_6689274052,420,2,42,2,7,8,8,0,-6,0,6,2,2,0,2,2,0,1,1,0,0,-3,-1,-1,6,5,-5,0,-1,1,-1,-1,1,2,1
KR_6658271276,420,1,54,-11,8,1,1,0,4,6,2,-1,1,2,2,5,3,2,4,2,0,10,-12,3,2,5,2,0,0,-1,1,0,1,2,1
KR_6050769158,420,3,68,11,10,5,5,0,4,7,3,2,2,0,-1,1,2,0,3,3,0,12,-28,1,6,7,13,0,1,1,1,1,1,4,1
KR_6757949024,420,5,31,-15,10,5,5,0,2,3,1,3,4,1,1,6,5,-1,2,3,0,3,5,1,5,6,3,0,-1,1,1,-1,-1,1,1
KR_6762714734,420,4,32,27,10,-2,2,4,7,7,0,-1,2,3,3,5,2,3,3,0,0,12,1,1,4,5,2,0,1,1,-1,1,-1,5,1
KR_6755356046,420,-1,0,6,-3,3,3,0,-2,2,4,-2,5,7,-1,3,4,-1,0,1,0,-4,276,0,3,3,-2,0,2,1,1,1,-1,4,1
KR_6738472096,440,0,-12,16,-3,2,3,1,-4,0,4,0,1,1,-1,3,4,0,1,1,0,-6,-4,-1,5,4,-3,0,1,0,1,1,-1,0,1
KR_6728160055,420,2,40,19,7,0,3,3,1,3,2,1,4,3,5,6,1,0,1,1,0,8,0,2,5,7,1,0,1,1,0,1,1,3,1
KR_6751180316,420,1,95,-13,3,-1,1,2,1,2,1,3,3,0,-4,2,6,4,5,1,-4,2,4,0,4,4,4,0,0,1,0,0,-1,1,1
KR_6747254545,420,-1,-4,20,-1,-2,1,3,-1,1,2,-1,1,2,3,3,0,0,0,0,0,3,-2,-2,5,3,2,0,0,0,-1,0,-1,0,1
KR_6752510265,420,1,-21,-3,3,0,0,0,2,4,2,2,3,1,-1,4,5,0,1,1,0,-2,49,-3,8,5,-26,0,0,-1,0,1,1,1,1
KR_6764876069,440,-3,-64,-2,-6,0,1,1,-2,2,4,-1,3,4,-4,1,5,1,2,1,0,-7,-10,-2,5,3,-2,0,-1,1,-1,1,-1,2,1
KR_6581853130,420,2,-8,23,5,2,3,1,3,5,2,-2,1,3,1,2,1,1,1,0,1,5,-8,2,4,6,-4,0,1,1,-1,1,1,4,1
KR_6763233200,420,1,20,-7,6,-1,0,1,7,7,0,-3,6,9,1,1,0,2,2,0,0,14,-7,2,5,7,-3,0,0,1,0,0,-1,4,1
KR_6734316386,420,4,69,18,14,3,3,0,3,8,5,4,5,1,6,6,0,-2,2,4,0,10,23,5,4,9,-3,0,3,1,1,1,1,1,1
KR_6641502324,420,4,101,-2,12,-3,1,4,5,7,2,1,2,1,8,8,0,1,1,0,1,16,12,4,4,8,1,0,1,1,-1,1,1,3,1
KR_6761680181,440,3,57,-4,4,0,2,2,-1,1,2,4,5,1,1,1,0,0,2,2,0,5,12,2,2,4,0,0,0,0,0,1,1,0,1
KR_6762284909,420,0,21,1,3,1,3,2,-1,3,4,2,6,4,0,2,2,1,1,0,0,11,11,2,3,5,3,0,0,-1,-1,0,1,2,1
KR_6763348829,420,4,38,27,6,3,5,2,4,8,4,1,1,0,-2,1,3,0,0,0,0,-7,-1,1,2,3,1,0,2,-1,1,1,1,1,1
KR_6660265448,420,2,29,27,5,2,3,1,-1,2,3,0,0,0,1,2,1,3,3,0,0,3,2,-3,8,5,-1,0,1,1,1,1,-1,3,1
KR_6747104990,420,1,43,0,0,-1,1,2,4,5,1,-4,1,5,1,2,1,0,0,0,0,1,8,0,4,4,-6,0,1,1,-1,1,-1,2,1
KR_6604375973,420,3,19,0,3,-1,0,1,1,4,3,1,1,0,-2,2,4,4,5,1,0,4,17,-5,9,4,3,0,1,-1,-1,1,1,5,1
KR_6706719224,420,0,7,-4,-7,-1,2,3,2,5,3,-3,3,6,-4,3,7,-1,0,1,-1,-16,19,1,3,4,-2,0,0,-1,-1,-1,-1,2,1
KR_6722227172,420,3,31,13,9,-1,1,2,3,4,1,2,5,3,2,3,1,3,3,0,0,8,1,-5,9,4,3,0,2,1,1,1,-1,2,1
KR_6739548190,420,5,74,-12,18,8,8,0,5,7,2,0,3,3,5,5,0,0,0,0,0,12,-2,0,3,3,3,0,2,-1,1,1,1,3,1
KR_6624622781,420,1,28,-32,-1,-1,1,2,-3,4,7,3,6,3,0,5,5,0,1,1,-2,0,-6,6,1,7,0,0,-2,1,0,-1,-1,1,1
KR_6765939518,420,6,124,-5,12,10,11,1,5,7,2,-1,4,5,0,2,2,-2,1,3,0,4,23,-1,2,1,0,0,2,1,1,1,-1,2,1
KR_6767882674,420,1,-9,-8,9,-3,1,4,0,2,2,1,3,2,7,9,2,4,5,1,2,10,2,3,4,7,1,0,0,1,1,1,1,6,1
KR_6756768223,420,2,-12,23,5,-1,1,2,8,8,0,1,1,0,-2,2,4,-1,1,2,0,5,0,-4,6,2,26,0,0,1,-1,-1,1,5,1
KR_6630620002,420,5,81,13,3,3,3,0,-1,3,4,4,4,0,-4,2,6,1,1,0,0,-2,5,-2,5,3,2,0,2,0,1,1,1,0,1
KR_6722068868,420,5,-27,16,7,12,13,1,0,3,3,-1,2,3,-6,1,7,2,3,1,1,-1,-3,0,5,5,-2,0,0,-1,-1,-1,1,6,1
KR_6748865211,420,-1,-9,25,2,1,2,1,-2,1,3,4,6,2,-1,0,1,0,0,0,0,-4,1,0,3,3,2,0,0,1,1,0,1,3,1
KR_6722738104,420,4,10,30,10,1,4,3,8,8,0,3,5,2,-3,3,6,1,3,2,0,2,-10,-6,8,2,8,0,-1,-1,1,1,1,3,1
KR_6733658340,420,6,139,32,11,1,2,1,2,5,3,5,6,1,4,4,0,-1,0,1,0,9,5,-1,5,4,1,0,3,1,1,1,1,1,1
KR_6728445921,420,5,51,4,7,-1,0,1,8,10,2,0,2,2,-1,0,1,1,2,1,0,14,10,-3,8,5,0,0,1,1,1,1,1,5,1
KR_6595401519,420,-2,-13,10,-3,-4,0,4,4,7,3,-1,3,4,0,5,5,-2,0,2,0,1,4,3,4,7,-2,0,-1,0,1,-1,-1,0,1
KR_6764791091,420,3,-11,-12,14,3,4,1,5,5,0,5,8,3,1,3,2,0,2,2,1,18,-10,2,0,2,2,0,0,1,1,1,1,6,1
KR_6705228115,420,3,-6,4,9,2,3,1,2,4,2,3,6,3,0,0,0,2,3,1,0,8,-2,1,4,5,4,0,0,1,-1,0,-1,2,1
KR_6767502135,420,5,49,35,6,0,2,2,1,2,1,-4,1,5,7,7,0,2,3,1,0,9,16,2,1,3,3,0,1,-1,1,1,1,1,1
KR_6722020008,420,-1,-25,12,1,-3,2,5,2,3,1,-1,4,5,2,4,2,1,4,3,3,17,-2,4,4,8,-3,0,0,-1,1,0,1,1,1
KR_6711526844,420,-1,-31,47,-6,-1,2,3,-2,3,5,-2,2,4,-1,2,3,0,0,0,0,-8,-34,5,2,7,23,0,2,1,1,1,1,2,1
KR_6569637614,420,3,10,8,0,1,1,0,4,5,1,-3,1,4,-4,5,9,2,3,1,-1,-1,-8,-1,4,3,0,0,-1,-1,1,-1,-1,6,1
KR_6722559912,420,0,-2,-8,-3,-1,2,3,0,4,4,-1,1,2,-1,0,1,0,0,0,-2,-4,-14,-3,7,4,1,0,-1,1,-1,1,-1,1,1
KR_6760898144,420,3,5,30,6,1,1,0,1,2,1,3,4,1,-1,5,6,2,2,0,0,4,6,3,3,6,5,0,0,-1,1,-1,1,3,1
KR_6680470598,420,0,-12,3,-1,-5,0,5,2,4,2,1,2,1,-1,0,1,2,2,0,0,6,12,2,0,2,-3,0,0,1,1,0,1,6,1
KR_6428623687,420,-2,-28,-5,-4,0,3,3,-4,3,7,4,6,2,-2,1,3,-2,2,4,0,-5,-3,2,2,4,0,0,0,0,-1,0,-1,0,1
KR_6761252167,420,0,5,-3,4,0,1,1,6,7,1,0,1,1,-3,3,6,1,2,1,0,8,-2,-2,5,3,-1,0,1,-1,1,1,-1,6,1
KR_6751769245,420,-1,-13,36,5,0,1,1,1,1,0,1,3,2,1,4,3,2,2,0,0,8,97,-1,6,5,-2,0,1,1,-1,1,1,6,1
KR_6739148842,420,7,94,38,9,3,3,0,2,3,1,3,6,3,0,1,1,1,3,2,0,4,0,1,2,3,3,0,1,1,-1,1,-1,3,1
KR_6758735524,420,-2,27,-3,-3,1,2,1,1,2,1,-3,3,6,-1,2,3,-1,0,1,-1,-5,23,5,0,5,-21,0,-1,1,-1,-1,-1,5,1
KR_6763347896,440,2,0,24,6,-1,3,4,3,3,0,5,5,0,-2,1,3,1,1,0,0,8,1,-4,5,1,3,0,0,1,1,1,1,2,1
KR_6697479536,420,5,48,-11,5,5,6,1,-2,2,4,0,3,3,1,3,2,1,4,3,1,1,102,5,3,8,2,0,0,-1,0,0,1,3,1
KR_6676648680,420,2,-28,51,12,-4,0,4,8,9,1,3,4,1,3,3,0,2,2,0,3,19,-1,2,2,4,2,0,0,1,0,0,1,3,1
KR_6738437849,420,3,56,0,10,4,5,1,6,6,0,-2,2,4,1,3,2,1,3,2,0,8,231,6,1,7,4,0,0,-1,1,1,1,2,1
KR_6763057373,420,1,-14,17,8,0,2,2,2,4,2,0,2,2,6,6,0,0,1,1,0,5,8,1,2,3,-2,0,0,-1,1,1,1,2,1
KR_6686012405,420,1,3,27,-1,-3,2,5,2,5,3,-1,2,3,2,2,0,-1,0,1,0,1,-18,3,5,8,-1,0,-1,1,0,-1,-1,2,1
KR_6664559625,420,-1,-52,-8,-1,5,6,1,-1,2,3,-2,2,4,0,4,4,-3,0,3,0,2,19,-1,6,5,-6,0,-2,-1,-1,-1,-1,1,1
KR_6761980698,420,3,-19,-1,2,-4,0,4,0,3,3,8,10,2,-1,0,1,-1,0,1,-1,-1,-4,0,7,7,-1,0,-1,-1,0,-1,-1,6,1
KR_6757961978,420,4,38,13,-4,2,2,0,-1,3,4,-1,2,3,-6,1,7,2,3,1,0,-6,3,-1,5,4,-1,0,0,1,0,0,-1,4,1
KR_6607661916,420,2,59,-2,2,1,2,1,-1,3,4,1,3,2,1,3,2,0,0,0,0,2,-7,3,2,5,-1,0,0,-1,-1,1,-1,4,1
KR_6759024491,420,1,80,-39,-2,8,9,1,-1,2,3,-1,1,2,-6,1,7,-2,1,3,0,-11,59,0,5,5,-12,0,1,-1,0,1,1,3,1
KR_6687189955,420,0,10,-2,1,-2,1,3,-1,3,4,1,2,1,2,3,1,1,2,1,0,-2,-91,-2,4,2,0,0,-1,1,-1,-1,1,5,1
KR_6751176532,420,-2,3,0,1,0,3,3,5,6,1,1,5,4,-6,2,8,1,3,2,0,-3,35,0,3,3,-4,0,1,1,1,1,1,6,1
KR_6741960041,440,2,100,-6,1,-1,0,1,2,2,0,1,3,2,-2,1,3,1,1,0,0,4,63,-1,3,2,-29,0,1,-1,1,1,-1,6,1
KR_6671691925,440,1,28,-28,10,4,5,1,0,2,2,-3,2,5,7,7,0,2,2,0,0,16,115,4,2,6,3,0,1,0,1,1,-1,0,1
KR_6754809435,420,1,73,-9,3,3,5,2,3,6,3,-2,0,2,-1,4,5,0,0,0,0,-2,10,2,2,4,-2,0,1,1,1,1,1,3,1
KR_6759332877,420,1,-47,-24,6,-1,1,2,3,5,2,7,10,3,-3,2,5,0,3,3,0,10,-3,-3,6,3,-1,0,0,0,1,-1,-1,0,1
KR_6752475720,420,1,-16,4,2,0,0,0,5,5,0,-4,0,4,0,2,2,1,1,0,0,1,-25,-3,6,3,-3,0,0,-1,-1,0,1,6,1
KR_6741964575,420,5,23,27,6,0,0,0,5,6,1,1,3,2,0,5,5,0,2,2,0,0,-161,-4,8,4,2,0,2,1,1,1,1,1,1
KR_6671246468,420,5,24,32,7,1,1,0,2,2,0,8,8,0,-3,1,4,-1,1,2,0,1,-2,1,6,7,2,0,2,1,1,1,1,2,1
KR_6757421362,420,2,22,-3,4,-3,1,4,3,3,0,3,4,1,1,2,1,0,0,0,0,6,4,3,2,5,-1,0,1,1,-1,1,-1,2,1
KR_6494975761,420,2,38,16,4,-3,1,4,0,3,3,1,2,1,6,6,0,0,1,1,0,10,-34,-5,6,1,6,0,0,1,1,1,1,5,1
KR_6757125985,420,1,16,8,-2,1,1,0,0,1,1,3,4,1,-2,4,6,-4,0,4,0,-3,4,4,2,6,-5,0,1,1,1,1,-1,3,1
KR_6448051628,420,1,-14,21,-1,-6,2,8,-1,2,3,4,7,3,1,1,0,1,1,0,0,-3,-6,0,6,6,-3,0,-1,1,-1,-1,1,1,1
KR_6760851930,420,3,-16,-13,10,0,1,1,7,7,0,-1,3,4,2,6,4,2,2,0,-1,24,7,0,2,2,0,0,0,1,0,0,-1,3,1
KR_6731560232,420,1,-40,20,4,-1,2,3,1,3,2,0,1,1,0,1,1,4,4,0,0,6,1,1,4,5,0,0,-1,1,-1,-1,1,2,1
KR_6617133926,420,1,44,7,3,2,4,2,1,3,2,3,5,2,-2,3,5,-1,1,2,0,-6,195,-6,8,2,1,0,0,-1,-1,1,-1,1,1
KR_6393781090,440,4,150,-3,11,9,9,0,4,6,2,1,1,0,0,0,0,-3,2,5,0,14,2,1,7,8,3,0,0,0,-1,1,1,0,1
KR_6638358931,420,-3,-73,-13,0,0,2,2,2,2,0,2,2,0,-6,2,8,2,3,1,-1,3,-5,0,4,4,-2,0,0,-1,-1,-1,-1,3,1
KR_6723024845,420,0,60,4,4,-1,0,1,0,2,2,4,6,2,2,3,1,-1,1,2,0,-1,-41,1,3,4,3,0,0,1,1,0,1,2,1
KR_6736392293,420,6,108,21,11,3,4,1,1,5,4,1,1,0,8,8,0,-2,1,3,0,13,56,2,2,4,-14,0,3,1,1,1,1,4,1
KR_6719839700,420,2,2,20,3,-1,1,2,1,2,1,3,3,0,1,2,1,-1,0,1,0,4,-44,1,4,5,38,0,0,1,1,1,-1,2,1
KR_6763111844,420,-1,11,4,-8,1,1,0,0,3,3,-1,1,2,-6,0,6,-2,0,2,0,-12,0,2,3,5,2,0,1,-1,1,1,-1,3,1
KR_6759694408,440,-2,-31,6,-4,-2,2,4,-2,0,2,0,4,4,1,7,6,-1,0,1,0,-6,-4,-1,3,2,-2,0,0,-1,0,-1,-1,2,1
KR_6722874966,420,6,103,36,22,1,2,1,4,5,1,12,12,0,3,4,1,2,2,0,0,20,142,4,1,5,6,0,1,1,1,1,1,4,1
KR_6761856420,420,-1,5,-15,1,1,2,1,1,2,1,-2,2,4,0,1,1,1,1,0,0,0,-5,-1,4,3,2,0,0,0,1,0,1,0,1
KR_6740095791,440,1,48,9,7,2,3,1,0,1,1,4,4,0,3,3,0,-2,1,3,0,7,3,-5,8,3,1,0,1,-1,1,1,1,4,1
KR_6695002983,420,5,132,0,10,4,4,0,0,4,4,3,3,0,2,2,0,1,1,0,1,0,4,2,1,3,2,0,1,1,1,1,1,5,1
KR_6743501846,420,3,62,17,1,0,2,2,3,3,0,-3,0,3,-5,1,6,6,6,0,1,5,-1,-3,5,2,2,0,1,-1,1,1,1,6,1
KR_6612036382,420,5,148,18,20,7,7,0,-2,2,4,10,11,1,2,6,4,3,3,0,2,12,7,3,3,6,-4,0,3,1,-1,1,1,2,1
KR_6766696955,420,2,-8,21,7,3,3,0,3,6,3,1,1,0,0,3,3,0,0,0,1,12,18,-3,5,2,1,0,0,1,-1,-1,1,1,1
KR_6730967581,440,4,63,31,4,0,2,2,-2,1,3,2,2,0,5,6,1,-1,1,2,0,0,11,1,1,2,2,0,1,1,1,1,1,5,1
KR_6755640804,420,4,37,-1,12,-1,1,2,-1,2,3,5,5,0,7,7,0,2,2,0,0,13,-23,-1,6,5,4,0,2,1,1,1,1,4,1
KR_6759749767,420,1,-13,24,2,-2,1,3,5,7,2,-1,1,2,0,1,1,0,0,0,0,6,9,1,3,4,-3,0,1,1,-1,1,-1,3,1
KR_6764687027,420,2,34,6,1,2,4,2,-4,2,6,3,6,3,0,3,3,0,1,1,2,7,-204,0,7,7,3,0,0,1,-1,-1,1,3,1
KR_6748449174,420,-2,-36,-16,-1,-2,0,2,-1,0,1,8,9,1,-3,1,4,-3,0,3,0,1,-117,-1,5,4,-24,0,-1,1,1,-1,1,5,1
KR_6762603057,420,1,1,4,4,1,1,0,5,7,2,-2,0,2,-2,2,4,2,3,1,0,-2,-2,2,2,4,0,0,0,-1,1,1,-1,4,1
KR_6761710050,420,4,133,1,3,2,3,1,1,6,5,-3,0,3,3,7,4,0,1,1,0,0,59,-1,4,3,-21,0,2,0,1,1,-1,0,1
KR_6733727998,420,2,-16,-20,7,-1,1,2,4,4,0,2,3,1,4,6,2,-2,0,2,1,14,2,-1,5,4,0,0,1,1,1,1,1,2,1
KR_6608393563,420,-2,-36,-36,1,-2,1,3,0,3,3,-5,2,7,5,6,1,3,4,1,0,-3,280,4,1,5,0,0,0,1,-1,1,-1,4,1
KR_6721188293,420,-1,7,-16,-1,0,1,1,-1,3,4,1,3,2,1,4,3,-2,0,2,0,10,7,-2,7,5,-1,0,0,-1,-1,-1,1,6,1
KR_6621009167,420,3,63,34,4,4,5,1,3,4,1,0,4,4,1,4,3,-4,0,4,0,-4,-9,-5,8,3,1,0,2,-1,-1,1,-1,6,1
KR_6754793599,440,-3,-76,4,-1,0,3,3,-3,0,3,-1,0,1,3,3,0,0,0,0,0,0,3,-4,5,1,-2,0,-1,-1,-1,-1,1,5,1
KR_6664432048,420,2,34,26,2,1,2,1,-2,1,3,3,3,0,-3,0,3,3,3,0,1,2,-7,-1,4,3,0,0,-2,-1,-1,-1,1,3,1
KR_6764696230,420,-1,1,-28,3,1,2,1,-1,1,2,0,3,3,3,5,2,0,2,2,1,7,0,3,2,5,-2,0,0,1,1,0,1,6,1
KR_6392060090,420,2,5,20,4,-1,1,2,4,5,1,1,3,2,1,4,3,-1,0,1,1,8,14,6,6,12,-5,0,0,1,-1,0,1,3,1
KR_6765925346,420,4,115,4,1,2,2,0,1,2,1,0,1,1,-3,2,5,1,1,0,0,-2,-8,-2,3,1,3,0,1,1,1,1,-1,1,1
KR_6751813377,420,3,2,12,4,1,2,1,-2,2,4,0,2,2,5,7,2,0,0,0,-1,0,7,3,2,5,-1,0,1,1,1,1,-1,5,1
KR_6767302761,420,1,-24,8,9,2,4,2,0,2,2,6,6,0,1,3,2,0,2,2,0,3,-14,2,4,6,6,0,2,1,1,1,1,4,1
KR_6658555758,420,-1,-16,24,0,2,3,1,1,2,1,-3,2,5,-1,1,2,1,3,2,0,-1,-10,-3,6,3,5,0,0,1,1,1,-1,4,1
KR_6760669471,420,2,-6,14,8,-3,1,4,4,7,3,0,3,3,6,7,1,1,1,0,1,22,5,0,2,2,1,0,1,1,1,1,1,6,1
KR_6726165796,440,3,-36,16,9,4,5,1,4,4,0,1,5,4,1,4,3,-1,0,1,0,8,16,-5,6,1,1,0,1,-1,1,1,1,1,1
KR_6728666121,420,3,31,8,3,1,3,2,4,5,1,-3,1,4,1,4,3,0,0,0,1,2,26,8,1,9,0,0,2,-1,1,1,1,6,1
KR_6728544326,420,1,56,-7,-4,2,5,3,-10,0,10,4,4,0,0,3,3,0,0,0,0,-4,-16,-2,7,5,2,0,1,0,-1,1,1,0,1
KR_6698720547,420,3,42,-17,10,0,0,0,4,4,0,-1,2,3,6,7,1,1,2,1,0,12,60,7,1,8,3,0,1,1,-1,1,-1,5,1
KR_6763909785,420,5,119,20,-2,-1,0,1,0,4,4,-5,1,6,4,4,0,0,0,0,0,1,14,5,1,6,2,0,1,-1,-1,1,1,2,1
KR_6634704874,420,2,-14,19,5,-1,0,1,1,5,4,0,2,2,0,3,3,5,5,0,0,8,10,-7,12,5,3,0,1,1,1,1,1,4,1
KR_6742481409,440,1,-20,8,2,2,5,3,6,6,0,-3,1,4,-3,2,5,0,0,0,0,4,-34,0,6,6,11,0,-1,0,1,-1,-1,0,1
KR_6758703094,420,2,24,-8,7,4,5,1,0,3,3,2,3,1,1,3,2,0,1,1,0,6,-12,1,4,5,1,0,0,1,1,-1,1,3,1
KR_6683995750,420,1,-15,32,4,2,3,1,0,2,2,-1,3,4,2,6,4,1,1,0,0,5,0,-4,5,1,3,0,0,1,-1,0,1,2,1
KR_6692944054,420,4,43,-31,9,4,6,2,2,3,1,-1,2,3,5,6,1,-1,2,3,1,8,25,2,2,4,-8,0,2,0,1,1,1,0,1
KR_6683875881,420,2,9,-4,4,-1,1,2,3,5,2,-2,2,4,-4,6,10,8,8,0,-1,2,5,1,3,4,-1,0,1,1,0,1,-1,6,1
KR_6757742104,420,0,-95,4,3,-1,4,5,4,6,2,7,7,0,-6,1,7,-1,1,2,0,2,2,-2,5,3,2,0,-1,-1,1,-1,1,3,1
KR_6660984963,420,2,80,-7,-4,1,1,0,-3,1,4,-2,4,6,3,5,2,-3,1,4,-2,-11,4,4,1,5,-2,0,1,1,-1,-1,-1,1,1
KR_6744531227,420,0,78,28,7,1,3,2,6,9,3,-1,3,4,0,2,2,1,2,1,0,6,20,1,2,3,3,0,0,-1,0,0,1,3,1
KR_6635358946,440,1,-61,12,7,1,2,1,4,4,0,0,1,1,-1,4,5,3,5,2,0,16,16,-1,7,6,1,0,0,1,1,0,1,3,1
KR_6731890263,420,3,18,21,6,1,3,2,0,4,4,3,3,0,4,6,2,-2,0,2,-1,2,2,4,3,7,2,0,0,1,1,-1,-1,4,1
KR_6762664805,420,0,42,-8,5,0,1,1,3,4,1,1,5,4,1,1,0,0,2,2,1,4,-3,2,3,5,3,0,0,1,0,0,1,1,1
KR_6731364915,440,1,16,3,6,-2,0,2,-1,1,2,5,7,2,3,3,0,1,3,2,0,1,15,2,1,3,1,0,0,1,1,0,1,4,1
KR_6653907343,420,5,56,12,9,5,5,0,0,1,1,-1,4,5,3,4,1,2,3,1,0,4,1,-1,8,7,3,0,2,1,1,1,1,5,1
KR_6735503536,420,0,-29,-48,5,-2,2,4,1,2,1,0,3,3,5,5,0,1,2,1,1,16,-2,6,4,10,-1,0,-1,1,-1,1,1,3,1
KR_6749467782,420,0,63,-23,3,0,2,2,2,2,0,6,8,2,-5,1,6,0,0,0,0,5,-8,2,5,7,-1,0,3,1,0,1,1,6,1
KR_6765595538,420,2,71,11,3,-3,0,3,4,6,2,3,4,1,-2,1,3,1,2,1,0,-2,1,-3,6,3,3,0,1,-1,1,1,1,4,1
KR_6762717324,420,6,46,14,19,3,3,0,3,4,1,7,9,2,5,6,1,1,2,1,4,19,12,1,2,3,1,0,3,1,1,1,1,6,1
KR_6698392941,420,3,49,28,-3,-2,0,2,-2,1,3,1,3,2,0,2,2,0,1,1,0,-3,-9,1,5,6,2,0,1,1,-1,1,1,3,1
KR_6714059671,420,3,16,24,4,5,5,0,3,4,1,-2,3,5,-2,4,6,0,1,1,-2,-5,-8,-4,9,5,4,0,0,-1,0,0,-1,1,1
KR_6705119649,440,2,66,-36,2,1,2,1,3,4,1,-3,2,5,0,2,2,1,1,0,1,2,-6,0,7,7,5,0,0,-1,1,0,1,5,1
KR_6654243035,420,-3,-52,0,-4,-1,0,1,-3,4,7,0,3,3,1,3,2,-1,0,1,0,-6,6,3,4,7,-5,0,0,1,-1,0,1,2,1
KR_6740582658,440,-1,-20,2,-2,0,0,0,-1,1,2,2,4,2,-2,0,2,-1,1,2,0,-8,6,-2,2,0,3,0,0,-1,1,0,1,4,1
KR_6760889825,420,-2,-14,-17,-8,-6,1,7,-3,2,5,0,1,1,0,4,4,1,1,0,-2,-10,44,-7,8,1,2,0,-1,1,-1,-1,-1,1,1
KR_6723154349,420,4,49,-4,6,-2,1,3,1,5,4,1,2,1,4,4,0,2,2,0,-1,5,-25,3,2,5,0,0,1,1,1,1,-1,4,1
KR_6762588749,440,4,64,-12,5,0,0,0,3,6,3,4,5,1,0,1,1,-2,4,6,1,13,13,-1,3,2,3,0,0,1,-1,1,1,3,1
KR_6724123684,420,-1,1,16,-1,1,2,1,2,3,1,2,5,3,-1,1,2,-5,3,8,0,3,4,-2,7,5,-9,0,0,0,-1,0,-1,0,1
KR_6748887260,420,-2,-48,-10,0,0,2,2,3,3,0,-5,1,6,0,3,3,2,4,2,0,1,0,1,4,5,-4,0,0,-1,-1,0,1,4,1
KR_6724305705,440,2,46,10,3,-1,1,2,-3,2,5,0,4,4,3,4,1,4,4,0,0,6,-136,-6,9,3,2,0,0,0,-1,1,-1,0,1
KR_6766666903,420,2,-21,-24,5,6,6,0,0,7,7,2,3,1,-2,1,3,-1,0,1,-1,-8,8,1,8,9,-4,0,1,1,1,1,-1,3,1
KR_6767522290,420,3,-63,-4,13,2,8,6,-1,0,1,3,3,0,2,4,2,7,7,0,0,17,34,0,3,3,0,0,0,-1,1,-1,1,5,1
KR_6612460988,420,0,1,15,-6,-3,1,4,-2,1,3,-1,0,1,1,2,1,-1,0,1,0,-6,-12,1,7,8,-1,0,0,-1,-1,0,-1,2,1
KR_6764488756,420,3,2,16,5,0,2,2,3,7,4,1,3,2,1,3,2,0,1,1,0,10,8,3,3,6,-2,0,1,-1,1,1,-1,1,1
KR_6681539488,420,-2,-32,1,-8,2,3,1,0,3,3,-6,0,6,-1,0,1,-3,0,3,-1,-13,12,4,5,9,-4,0,1,-1,1,1,-1,3,1
KR_6764585751,420,4,91,-1,11,1,1,0,7,7,0,1,6,5,1,5,4,1,1,0,1,22,-17,-5,9,4,6,0,3,-1,1,1,1,3,1
KR_6766651445,440,8,86,29,25,6,7,1,1,2,1,-1,2,3,18,19,1,1,1,0,0,22,10,3,2,5,-3,0,2,1,1,1,1,4,1
KR_6747231624,420,2,25,11,4,4,4,0,-2,3,5,0,3,3,3,4,1,-1,0,1,0,10,-340,1,3,4,3,0,1,-1,1,1,1,5,1
KR_6548897712,420,1,35,44,1,2,2,0,2,2,0,-3,3,6,0,4,4,0,0,0,0,-5,-11,-4,6,2,0,0,0,0,0,0,-1,0,1
KR_6766979763,420,2,96,11,12,1,1,0,3,4,1,1,1,0,5,7,2,2,2,0,0,13,139,1,3,4,9,0,3,1,1,1,1,4,1
KR_6766936627,440,1,98,-8,4,0,1,1,-3,1,4,4,5,1,3,4,1,0,1,1,0,6,5,-1,2,1,-4,0,0,1,1,0,1,1,1
KR_6751090828,440,2,52,-4,-4,0,1,1,3,5,2,0,2,2,-1,0,1,-6,0,6,-2,-6,2,3,1,4,-4,0,2,-1,1,1,-1,1,1
KR_6467109610,420,6,38,16,11,2,3,1,1,7,6,1,4,3,3,7,4,4,5,1,2,14,-15,1,6,7,6,0,1,1,1,1,1,3,1
KR_6750068668,440,3,17,32,-2,-2,4,6,-2,1,3,2,4,2,-1,2,3,1,4,3,-1,-6,3,-2,2,0,0,0,1,1,0,1,-1,4,1
KR_6723199127,420,-2,-65,-8,5,-3,1,4,1,1,0,3,4,1,4,6,2,0,0,0,0,10,28,-5,9,4,-20,0,1,1,1,1,-1,1,1
KR_6760662137,420,-4,-36,0,-11,-2,1,3,1,2,1,-3,2,5,-5,0,5,-2,1,3,0,-3,-8,-4,8,4,-1,0,-1,-1,-1,-1,-1,5,1
KR_6701738964,420,3,33,8,0,-1,1,2,-5,2,7,2,2,0,4,5,1,0,2,2,0,-10,-5,0,3,3,-2,0,0,0,1,-1,1,0,1
KR_6764802964,420,0,27,-16,3,1,1,0,-2,3,5,0,1,1,3,8,5,1,1,0,0,3,7,-2,4,2,-1,0,2,-1,1,1,-1,5,1
KR_6750586694,420,-1,-46,-16,1,-2,2,4,2,2,0,1,1,0,-1,4,5,1,4,3,0,11,179,-1,6,5,-4,0,1,1,1,1,1,4,1
KR_6641555654,420,1,22,24,4,-2,3,5,3,4,1,4,4,0,1,4,3,-2,0,2,0,3,264,-2,5,3,4,0,-1,1,1,-1,-1,6,1
KR_6750375571,420,-2,-16,-27,-8,-1,1,2,-3,1,4,-8,3,11,3,4,1,1,2,1,0,2,4,-3,4,1,1,0,-1,-1,-1,-1,-1,3,1
KR_6757506926,420,3,86,12,10,2,4,2,-2,0,2,9,10,1,2,4,2,-1,2,3,0,0,1,0,4,4,7,0,0,1,1,1,1,4,1
KR_6750676013,420,3,65,7,8,6,6,0,-1,2,3,4,6,2,-4,0,4,3,4,1,1,10,-6,-5,7,2,5,0,1,-1,1,1,1,1,1
KR_6671047050,420,0,2,-20,-2,1,1,0,-1,3,4,-3,1,4,1,2,1,0,1,1,0,-1,-115,1,4,5,-4,0,-1,1,-1,-1,-1,4,1
KR_6657878896,420,2,-13,-6,0,2,3,1,0,1,1,-4,1,5,3,3,0,-1,0,1,0,1,6,1,2,3,-2,0,1,-1,0,1,1,4,1
KR_6716586104,420,4,73,16,7,1,2,1,-3,3,6,4,4,0,5,5,0,0,0,0,0,11,-1,3,2,5,1,0,0,1,1,0,1,4,1
KR_6606508510,420,-2,-4,3,-1,-1,2,3,1,2,1,-1,0,1,2,4,2,-2,1,3,0,3,-1,-2,7,5,5,0,1,-1,1,1,1,3,1
KR_6732845275,440,3,56,11,-2,2,3,1,1,5,4,-2,1,3,-1,2,3,-2,1,3,0,-5,-3,-3,9,6,-1,0,0,1,-1,1,1,4,1
KR_6715588886,420,5,-27,40,7,1,3,2,4,5,1,4,5,1,2,6,4,-4,0,4,0,-5,-149,2,4,6,4,0,1,1,-1,1,1,1,1
KR_6328368095,420,6,101,-12,8,0,2,2,-4,1,5,5,6,1,6,6,0,1,2,1,0,3,8,-2,5,3,-1,0,2,1,-1,1,1,3,1
KR_6667735962,420,4,68,-4,4,0,2,2,8,11,3,0,2,2,-3,2,5,-1,2,3,0,-2,-6,2,2,4,2,0,1,-1,1,1,-1,5,1
KR_6674891844,420,-1,-16,24,0,-5,2,7,2,5,3,4,5,1,1,4,3,-2,1,3,-1,-6,5,6,1,7,4,0,0,1,1,-1,-1,6,1
KR_6767112724,420,0,0,3,2,2,2,0,2,3,1,-4,1,5,1,2,1,1,2,1,0,2,2,5,4,9,-4,0,0,1,1,0,1,2,1
KR_6752407656,420,0,-33,22,7,3,4,1,4,6,2,0,2,2,0,3,3,0,1,1,2,11,-6,-2,10,8,3,0,1,-1,-1,-1,1,5,1
KR_6733321675,420,0,11,22,1,-4,6,10,-2,1,3,3,3,0,3,7,4,1,1,0,-1,-5,9,1,2,3,-3,0,1,-1,1,1,-1,3,1
KR_6731749972,420,2,68,-24,10,2,2,0,-2,0,2,1,2,1,3,7,4,6,6,0,0,11,3,7,0,7,-1,0,1,1,-1,-1,1,4,1
KR_6707885389,420,3,74,40,7,-2,1,3,0,2,2,10,10,0,1,2,1,-2,2,4,0,12,17,4,1,5,-1,0,4,-1,1,1,-1,1,1
KR_6620895789,420,-1,30,0,-7,0,2,2,0,2,2,-3,1,4,-2,2,4,-2,2,4,0,-12,0,3,3,6,0,0,0,-1,-1,0,1,1,1
KR_6663624462,420,5,80,-1,13,3,5,2,8,8,0,0,3,3,0,3,3,2,2,0,0,19,11,4,4,8,-3,0,-1,1,1,-1,1,1,1
KR_6709373720,420,2,-22,-3,3,3,5,2,2,3,1,-6,2,8,3,5,2,1,1,0,-2,5,8,3,2,5,-1,0,1,1,1,1,1,4,1
KR_6704254717,420,-4,-18,12,-7,-3,2,5,0,2,2,0,1,1,0,0,0,-4,0,4,1,-3,0,0,4,4,-5,0,-1,0,0,-1,1,0,1
KR_6647524816,420,3,0,0,7,3,3,0,2,2,0,4,4,0,-1,2,3,-1,0,1,0,3,6,8,2,10,1,0,0,1,1,1,-1,6,1
KR_6755184424,420,-1,16,-46,-6,0,1,1,-4,0,4,0,2,2,0,6,6,-2,1,3,0,-3,10,5,2,7,-4,0,0,-1,-1,-1,-1,3,1
KR_6688237258,420,4,23,-11,1,3,3,0,-3,4,7,-2,3,5,2,3,1,1,1,0,0,-2,-36,1,4,5,9,0,-1,1,-1,-1,1,3,1
KR_6764748582,420,3,34,-4,4,3,3,0,1,2,1,-2,0,2,1,2,1,1,1,0,0,5,7,3,2,5,-4,0,2,1,1,1,1,3,1
KR_6764643008,420,2,13,-6,0,1,2,1,1,2,1,-3,2,5,-1,1,2,2,4,2,0,0,-24,0,5,5,31,0,0,1,1,1,-1,1,1
KR_6767252233,420,5,90,12,15,1,3,2,2,6,4,4,5,1,5,6,1,3,5,2,0,11,-8,-2,5,3,3,0,1,1,0,1,-1,3,1
KR_6651696420,420,-2,33,-12,-3,0,3,3,0,1,1,-1,1,2,-1,4,5,-1,2,3,2,-6,-53,0,4,4,14,0,1,1,-1,1,1,3,1
KR_6764637556,420,3,99,18,6,0,0,0,0,2,2,6,6,0,0,1,1,0,2,2,0,3,1,5,4,9,5,0,1,1,-1,1,1,1,1
KR_6141687557,420,2,16,12,8,4,5,1,-1,5,6,3,4,1,2,2,0,0,2,2,1,-3,-9,12,1,13,-5,0,2,-1,1,1,1,3,1
KR_6767314448,420,0,37,-8,2,-1,0,1,-1,2,3,-2,1,3,6,6,0,0,1,1,0,2,133,1,4,5,4,0,1,1,0,1,1,5,1
KR_6610374621,420,3,-13,14,10,0,1,1,2,5,3,5,6,1,1,2,1,2,2,0,2,16,2,0,2,2,-4,0,-1,1,0,1,1,2,1
KR_6615592532,440,-2,-41,-1,-4,-2,2,4,1,1,0,1,3,2,-1,3,4,-3,0,3,0,-1,3,-1,3,2,-3,0,0,-1,-1,-1,1,5,1
KR_6758439381,420,-3,-53,4,6,-2,2,4,-2,5,7,9,12,3,1,4,3,0,1,1,0,17,-45,0,4,4,24,0,0,1,1,1,1,1,1
KR_6560072732,440,6,93,12,9,0,5,5,0,5,5,3,5,2,4,4,0,2,4,2,0,0,118,2,1,3,1,0,3,0,-1,1,1,0,1
KR_6751359846,440,3,11,16,12,-1,3,4,1,3,2,3,4,1,8,8,0,1,1,0,0,10,-30,-1,4,3,26,0,1,1,-1,1,-1,5,1
KR_6651387783,420,1,-19,-3,5,-3,2,5,3,3,0,3,4,1,2,6,4,0,2,2,0,10,17,-1,5,4,5,0,0,1,1,0,-1,1,1
KR_6623458643,420,2,-30,8,8,1,3,2,1,2,1,0,2,2,4,7,3,2,2,0,0,12,7,-1,6,5,1,0,1,1,-1,1,-1,2,1
KR_6673567868,420,-1,6,-12,5,-2,2,4,-3,1,4,-1,4,5,7,7,0,4,4,0,2,16,17,5,1,6,-1,0,2,-1,-1,1,1,5,1
KR_6762369769,420,1,-10,4,5,4,5,1,2,2,0,-3,1,4,2,3,1,0,3,3,0,6,-4,0,3,3,-3,0,1,-1,0,1,1,3,1
KR_6764626728,420,2,-1,29,2,-1,2,3,-4,1,5,2,5,3,3,4,1,2,2,0,0,0,-3,-2,4,2,2,0,2,1,1,1,-1,6,1
KR_6764863263,440,4,50,-16,10,2,4,2,2,5,3,7,9,2,-1,3,4,0,0,0,0,4,-1,4,2,6,2,0,1,0,1,1,-1,0,1
KR_6732759112,420,0,-38,-12,5,-1,1,2,2,5,3,2,2,0,2,4,2,0,1,1,0,14,0,-1,8,7,2,0,1,-1,1,1,-1,1,1
KR_6741726291,420,-1,35,-4,3,1,2,1,0,2,2,2,3,1,1,2,1,-1,1,2,1,4,-1,1,1,2,-1,0,0,-1,1,-1,1,1,1
KR_6757630942,420,1,17,0,3,2,2,0,1,2,1,1,3,2,-2,2,4,1,1,0,-1,4,6,1,3,4,-1,0,0,-1,1,1,-1,2,1
KR_6764553230,420,-3,-96,-8,-3,-7,0,7,3,3,0,0,1,1,3,3,0,-2,0,2,0,0,-14,3,6,9,-1,0,-3,1,-1,-1,-1,3,1
KR_6725718412,440,3,-7,20,0,3,5,2,1,2,1,-1,1,2,0,4,4,-3,0,3,0,-8,-1,5,5,10,0,0,1,1,1,1,-1,1,1
KR_6765011095,420,-1,4,-21,0,-1,1,2,2,3,1,0,1,1,-1,0,1,0,1,1,0,7,87,3,4,7,4,0,-1,-1,1,-1,1,2,1
KR_6763670199,420,0,31,-25,-2,2,3,1,-5,3,8,-1,2,3,1,1,0,1,2,1,0,-2,4,-2,6,4,-3,0,0,1,0,0,-1,4,1
KR_6760698272,420,-2,-22,3,-3,-5,0,5,-4,0,4,1,2,1,1,3,2,4,4,0,0,0,7,-1,3,2,-1,0,0,1,0,0,1,6,1
KR_6685732415,420,3,-4,8,10,-2,2,4,0,2,2,6,7,1,7,9,2,-1,1,2,1,7,-9,0,5,5,1,0,1,-1,1,1,1,4,1
KR_6731963588,420,1,-43,-4,-3,0,2,2,2,4,2,0,3,3,-5,0,5,0,1,1,-2,-16,-5,1,2,3,-1,0,0,0,0,-1,-1,0,1
KR_6718207752,440,-4,-48,-19,-12,-2,1,3,5,9,4,-1,3,4,-12,1,13,-2,0,2,-1,-9,16,2,5,7,-4,0,0,1,-1,-1,-1,5,1
KR_6761436692,420,3,8,19,8,-1,2,3,2,2,0,4,7,3,1,3,2,2,3,1,0,10,1,2,4,6,1,0,2,1,0,1,1,5,1
KR_6718160294,420,0,-34,-8,1,-1,0,1,-2,2,4,1,3,2,3,5,2,0,1,1,0,2,-10,-2,6,4,9,0,0,1,1,0,-1,2,1
KR_6757997157,420,-2,-30,-18,-5,1,3,2,-2,1,3,-1,6,7,-3,1,4,0,1,1,0,-1,-13,0,4,4,1,0,0,-1,1,1,1,2,1
KR_6453860831,420,3,26,2,7,0,2,2,5,6,1,-3,0,3,1,1,0,4,6,2,0,5,-16,-5,9,4,4,0,2,1,0,1,-1,5,1
KR_6707409914,420,5,15,35,11,-1,3,4,-1,2,3,3,3,0,9,9,0,1,2,1,0,12,-31,3,4,7,0,0,0,1,1,0,-1,6,1
KR_6759123473,420,0,-43,-12,0,-3,0,3,-2,2,4,2,4,2,2,3,1,1,2,1,0,5,-11,-8,8,0,0,0,0,1,-1,0,-1,6,1
KR_6570781940,420,0,-12,-8,5,1,2,1,6,8,2,-3,1,4,-2,4,6,3,3,0,0,12,5,3,1,4,0,0,0,1,-1,-1,1,6,1
KR_6744969570,420,-2,-36,40,-3,0,0,0,0,4,4,-4,0,4,-1,2,3,2,2,0,0,0,15,-1,4,3,-4,0,-1,-1,1,-1,1,5,1
KR_6677844757,420,4,37,20,11,7,8,1,-1,1,2,3,3,0,1,3,2,1,1,0,0,6,40,3,5,8,0,0,1,1,1,1,1,2,1
KR_6653155237,420,3,37,8,2,-1,1,2,2,4,2,1,1,0,-2,1,3,2,2,0,0,0,7,3,4,7,-4,0,0,1,-1,0,1,4,1
KR_6683919966,420,4,42,20,10,4,6,2,-1,0,1,1,3,2,6,7,1,0,1,1,1,7,19,2,4,6,4,0,1,1,1,1,1,1,1
KR_6683061436,420,5,134,21,8,3,4,1,0,2,2,1,2,1,1,5,4,3,4,1,1,3,-4,-2,4,2,4,0,2,-1,1,1,1,2,1
KR_6726800127,440,5,61,52,7,-1,0,1,0,0,0,2,4,2,4,4,0,2,3,1,1,3,4,2,4,6,2,0,0,-1,1,1,1,5,1
KR_6747689360,420,1,-60,-20,8,0,5,5,1,3,2,5,8,3,2,3,1,0,0,0,0,4,-4,-7,8,1,5,0,0,-1,1,1,-1,3,1
KR_6720662591,420,4,90,46,13,0,1,1,3,3,0,3,5,2,7,8,1,0,1,1,0,10,18,7,2,9,0,0,4,1,1,1,1,5,1
KR_6766512165,420,4,16,17,6,0,3,3,0,2,2,3,3,0,1,4,3,2,2,0,0,7,1,1,4,5,1,0,1,-1,1,1,1,1,1
KR_6755395330,420,4,50,-9,11,8,8,0,0,2,2,0,2,2,0,3,3,3,4,1,0,7,5,-3,6,3,0,0,1,-1,-1,1,-1,5,1
KR_6630708675,420,5,13,11,9,1,4,3,2,8,6,3,4,1,2,3,1,1,2,1,2,1,9,3,2,5,4,0,1,-1,1,1,1,3,1
KR_6705119257,420,1,31,1,10,-1,5,6,2,4,2,1,3,2,8,8,0,0,1,1,-1,8,3,3,0,3,-1,0,1,0,1,1,-1,0,1
KR_6751892272,420,1,37,8,15,4,4,0,4,4,0,4,7,3,2,8,6,1,1,0,0,14,-7,3,7,10,1,0,1,-1,1,1,1,1,1
KR_6759462930,420,-3,-40,-20,-7,-3,0,3,1,2,1,-4,0,4,0,2,2,-1,1,2,0,-2,-24,-1,2,1,0,0,-1,-1,1,-1,-1,5,1
KR_6705028707,420,1,-18,15,1,-1,2,3,1,2,1,-1,3,4,2,3,1,0,3,3,0,6,-4,-4,6,2,1,0,0,1,1,0,-1,2,1
KR_6767663343,420,4,30,29,5,0,2,2,1,4,3,-1,4,5,1,3,2,4,8,4,0,4,-3,-3,4,1,4,0,0,1,-1,0,-1,6,1
KR_6763884562,420,-2,-57,-48,4,0,0,0,0,2,2,1,2,1,1,2,1,2,2,0,0,3,-8,-1,6,5,7,0,0,1,1,-1,1,5,1
KR_6759221665,420,2,42,17,2,2,2,0,-3,0,3,-2,2,4,2,2,0,3,3,0,1,1,-33,-3,4,1,10,0,1,0,1,1,1,0,1
KR_6746551133,420,4,-11,12,10,3,3,0,3,3,0,-2,1,3,5,5,0,1,2,1,0,12,-4,1,2,3,3,0,0,-1,-1,0,-1,6,1
KR_6745865822,440,4,32,-15,9,2,3,1,3,4,1,5,5,0,-1,0,1,0,1,1,0,9,-8,-1,2,1,5,0,0,1,1,1,1,4,1
KR_6747379883,420,3,10,-5,7,4,6,2,2,4,2,-1,3,4,2,4,2,0,0,0,0,12,-2,0,4,4,7,0,1,1,-1,1,1,1,1
KR_6724825033,420,5,33,9,10,2,3,1,4,6,2,3,6,3,2,4,2,-1,1,2,1,10,71,0,2,2,0,0,0,1,1,0,1,1,1
KR_6736909249,420,3,79,-12,14,2,3,1,2,4,2,7,10,3,2,4,2,1,3,2,2,16,14,3,3,6,-2,0,1,1,1,1,1,1,1
KR_6673236342,420,1,-28,-12,1,3,4,1,4,5,1,-5,2,7,0,3,3,-1,0,1,-2,-1,4,-1,3,2,-1,0,-1,-1,0,-1,-1,2,1
KR_6759553213,420,1,49,-37,4,-1,0,1,-1,2,3,3,7,4,1,3,2,2,2,0,0,8,-10,0,3,3,0,0,2,-1,1,1,1,1,1
KR_6757061555,420,4,80,3,5,0,1,1,2,5,3,0,1,1,3,8,5,0,1,1,0,3,8,-2,6,4,2,0,1,1,0,1,-1,6,1
KR_6657943160,420,1,-44,20,1,-3,0,3,1,2,1,2,3,1,1,3,2,0,1,1,0,0,4,3,6,9,0,0,0,1,-1,0,1,2,1
KR_6694585718,420,-2,-55,5,-5,3,4,1,-3,1,4,-2,0,2,-2,1,3,-1,0,1,-1,-8,97,-3,5,2,0,0,0,-1,1,-1,-1,2,1
KR_6601187132,420,5,29,20,21,5,6,1,3,3,0,5,7,2,7,8,1,1,1,0,0,14,-10,-4,8,4,6,0,1,1,1,1,1,2,1
KR_6753916833,420,0,30,4,3,0,5,5,-2,1,3,4,5,1,1,3,2,0,1,1,1,1,-5,-2,5,3,0,0,0,1,-1,1,1,2,1
KR_6767971997,420,2,14,13,5,2,4,2,-2,2,4,3,4,1,1,4,3,1,1,0,1,10,10,4,2,6,1,0,2,1,1,1,1,4,1
KR_6625215660,440,0,-14,-6,5,4,4,0,1,1,0,0,1,1,1,3,2,-1,1,2,0,6,117,0,4,4,3,0,2,0,1,1,1,0,1
KR_6760602828,440,5,55,30,11,3,4,1,1,1,0,4,5,1,3,3,0,0,1,1,0,9,119,-5,7,2,4,0,4,1,1,1,1,3,1
KR_6741588762,420,4,57,-5,4,-2,0,2,0,1,1,-2,2,4,5,6,1,3,4,1,0,8,10,0,4,4,1,0,3,1,1,1,1,4,1
KR_6761482788,420,0,28,-3,-1,2,2,0,-1,1,2,3,3,0,1,1,0,-6,0,6,1,-8,51,4,5,9,-32,0,1,1,1,1,1,4,1
KR_6649417891,420,0,-58,-7,3,1,3,2,7,9,2,-2,2,4,-1,1,2,-2,0,2,1,9,36,1,3,4,-14,0,1,1,1,1,1,6,1
KR_6723329380,420,4,33,-6,7,-2,2,4,5,5,0,1,4,3,5,7,2,-2,2,4,0,9,-30,-1,3,2,4,0,-1,1,-1,-1,-1,3,1
KR_6744992813,420,6,50,-4,15,3,3,0,3,5,2,4,7,3,3,5,2,2,3,1,0,9,-5,1,4,5,5,0,0,-1,-1,0,-1,6,1
KR_6765482254,420,1,92,16,8,0,1,1,1,3,2,-1,0,1,6,7,1,2,2,0,1,12,1,1,3,4,6,0,2,1,1,1,1,1,1
KR_6707822467,420,0,-10,3,-5,2,3,1,0,3,3,-2,2,4,-5,0,5,0,1,1,-1,-7,-27,0,4,4,1,0,-1,1,-1,-1,-1,4,1
KR_6690692934,420,-2,-64,-16,-2,-3,0,3,1,3,2,-1,3,4,-2,4,6,3,4,1,0,7,153,-1,4,3,-1,0,-1,1,1,-1,-1,2,1
KR_6740050538,420,2,-17,20,7,0,1,1,1,2,1,0,2,2,3,4,1,3,4,1,0,12,10,4,1,5,-1,0,0,0,0,-1,1,0,1
KR_6752557431,420,0,-51,21,1,4,4,0,2,6,4,2,5,3,-6,1,7,-1,1,2,0,4,-3,1,3,4,-3,0,0,1,1,1,1,1,1
KR_6762436845,440,-3,18,-16,-4,3,4,1,-4,2,6,4,4,0,-5,1,6,-2,1,3,2,-7,-18,1,4,5,-2,0,-2,-1,-1,-1,1,4,1
KR_6762414061,420,-3,-100,-15,-6,4,6,2,-4,2,6,-5,0,5,1,1,0,-2,0,2,0,-3,-12,-3,5,2,-1,0,-3,-1,-1,-1,-1,1,1
KR_6706532452,420,3,56,26,11,3,3,0,0,1,1,0,2,2,7,8,1,1,1,0,2,10,25,-2,4,2,6,0,4,-1,-1,1,1,6,1
KR_6706953712,420,0,46,-12,4,3,4,1,-1,3,4,-2,2,4,3,3,0,1,1,0,0,-6,-13,2,3,5,1,0,1,1,1,1,-1,5,1
KR_6757751243,420,-1,5,-21,-1,1,2,1,-4,2,6,0,0,0,0,2,2,2,2,0,0,-2,-4,3,1,4,2,0,-1,1,-1,-1,1,5,1
KR_6767883568,420,0,-1,-28,-1,-1,3,4,1,1,0,-4,3,7,4,4,0,-1,0,1,0,1,39,1,6,7,-16,0,-1,1,-1,-1,-1,2,1
KR_6677574562,420,2,17,32,10,3,4,1,5,5,0,-1,1,2,2,4,2,1,3,2,0,12,-253,3,2,5,-2,0,-1,1,0,-1,1,3,1
KR_6766170367,420,5,84,26,9,-1,3,4,1,1,0,0,2,2,9,10,1,0,1,1,0,11,-97,3,4,7,1,0,0,1,1,-1,1,3,1
KR_6750390307,420,2,-18,-5,16,2,4,2,-4,0,4,6,9,3,8,8,0,4,4,0,1,17,-42,1,6,7,21,0,2,1,-1,1,1,5,1
KR_6745423429,420,2,17,-33,1,1,2,1,-2,2,4,0,3,3,3,4,1,-1,0,1,0,3,-21,-3,4,1,7,0,0,-1,-1,0,-1,4,1
KR_6760050952,420,1,15,17,-1,0,5,5,2,3,1,3,4,1,-4,3,7,-2,1,3,4,0,-11,-1,7,6,0,0,1,0,1,1,1,0,1
KR_6746023235,440,6,39,41,8,1,2,1,1,1,0,6,7,1,-2,1,3,2,7,5,0,2,-2,-1,5,4,2,0,2,1,1,1,-1,2,1
KR_6765705001,420,0,-12,8,0,-1,1,2,2,3,1,0,1,1,-1,3,4,0,0,0,0,-1,16,-4,7,3,1,0,1,-1,1,1,1,4,1
KR_6626757281,420,2,2,36,-2,-4,0,4,-1,4,5,2,3,1,-1,3,4,2,4,2,0,0,2,1,6,7,1,0,0,1,-1,-1,1,4,1
KR_6684723552,420,3,-57,0,5,1,2,1,-2,1,3,1,4,3,3,3,0,2,2,0,0,9,448,-3,6,3,-1,0,0,1,-1,0,-1,3,1
KR_6743425395,440,0,-50,-14,4,0,3,3,2,3,1,3,3,0,-1,4,5,0,1,1,0,9,24,1,4,5,-6,0,0,-1,1,1,1,4,1
KR_6767141501,420,3,-12,0,9,-1,1,2,3,3,0,9,11,2,-4,1,5,2,2,0,0,12,-22,-3,7,4,6,0,0,-1,1,0,1,4,1
KR_6755856460,420,-3,21,-28,-12,-3,0,3,0,3,3,-1,5,6,-5,3,8,-3,1,4,0,-12,-18,-8,10,2,1,0,0,-1,-1,-1,-1,5,1
KR_6753224793,440,-1,6,-11,-3,2,2,0,-1,0,1,-5,0,5,-3,2,5,4,4,0,0,-4,18,-2,5,3,1,0,0,1,-1,-1,-1,5,1
KR_6755158265,420,-3,22,-27,-3,3,4,1,-6,0,6,1,2,1,-1,3,4,0,1,1,1,-6,-42,-3,9,6,4,0,0,0,1,-1,1,0,1
KR_6747262667,440,-2,-29,-12,1,0,0,0,-2,1,3,0,2,2,3,5,2,0,1,1,0,-1,6,5,3,8,3,0,0,1,1,0,1,1,1
KR_6735797642,440,1,7,-16,12,-1,2,3,0,4,4,1,2,1,12,13,1,0,0,0,0,13,-31,3,1,4,-1,0,1,0,1,1,-1,0,1
KR_6759656018,420,6,88,48,9,0,0,0,1,3,2,1,2,1,6,9,3,1,1,0,0,6,-90,1,1,2,-26,0,2,1,1,1,1,1,1
KR_6748920388,420,-3,-12,4,-14,-2,0,2,-1,2,3,-4,0,4,-5,2,7,-2,0,2,0,-17,10,-3,3,0,0,0,-2,0,-1,-1,-1,0,1
KR_6592966496,420,3,51,32,3,0,2,2,5,5,0,2,2,0,-4,0,4,0,1,1,0,-1,-15,-7,7,0,3,0,1,-1,-1,1,1,1,1
KR_6602828729,420,0,-47,-8,0,2,3,1,2,4,2,-4,0,4,-1,1,2,1,1,0,0,-1,10,-2,7,5,5,0,0,-1,0,0,-1,6,1
KR_6707357917,420,3,17,31,2,2,2,0,1,2,1,-2,1,3,1,3,2,0,0,0,1,3,28,0,3,3,-14,0,1,1,1,1,1,4,1
KR_6543837963,420,1,17,28,3,2,4,2,-3,4,7,2,3,1,1,2,1,1,2,1,0,8,0,1,3,4,0,0,-1,1,1,-1,1,2,1
KR_6720278319,420,-1,-51,36,-4,1,2,1,-3,0,3,3,3,0,-3,0,3,-2,3,5,0,-4,-8,-2,4,2,0,0,0,1,1,1,1,1,1
KR_6765141224,420,0,39,-37,7,2,4,2,-1,2,3,0,2,2,5,5,0,1,1,0,0,6,-4,2,2,4,2,0,1,1,1,1,1,2,1
KR_6765146952,420,0,-12,-4,-5,-6,1,7,2,2,0,1,3,2,0,3,3,-2,2,4,-1,-3,12,5,1,6,-4,0,0,1,-1,-1,-1,5,1
KR_6674798925,420,-3,-41,20,-3,-3,0,3,0,2,2,-1,2,3,-3,1,4,4,5,1,0,1,26,-4,7,3,0,0,0,1,1,1,-1,4,1
KR_6733149651,420,2,28,-8,8,1,2,1,2,4,2,3,4,1,1,1,0,1,1,0,0,5,0,1,7,8,2,0,0,-1,1,1,-1,6,1
KR_6745186548,420,-1,19,-24,-2,4,5,1,1,3,2,-4,0,4,2,5,3,-5,0,5,0,1,1,5,0,5,-3,0,1,1,-1,1,1,2,1
KR_6766128470,420,3,8,15,2,2,5,3,-1,1,2,-6,0,6,6,8,2,1,1,0,0,-7,-21,-4,5,1,2,0,-1,-1,-1,-1,1,6,1
KR_6763398092,420,2,67,-14,5,2,4,2,0,3,3,-1,0,1,1,1,0,3,5,2,0,0,3,4,0,4,-1,0,0,1,0,0,1,3,1
KR_6627885304,420,0,-45,39,3,2,4,2,3,7,4,-2,1,3,2,2,0,-2,1,3,0,9,-9,-3,6,3,-1,0,0,1,1,0,1,5,1
KR_6636839022,420,-1,19,-20,7,2,2,0,3,4,1,-2,3,5,3,5,2,1,1,0,-2,6,7,-1,5,4,-1,0,0,-1,1,1,1,1,1
KR_6702469840,420,2,-21,-8,7,2,3,1,4,6,2,2,3,1,-1,1,2,0,0,0,1,6,3,2,4,6,7,0,1,-1,1,1,1,5,1
KR_6707910829,420,3,-17,21,7,-1,1,2,7,8,1,2,3,1,-2,1,3,1,2,1,-1,5,9,1,7,8,1,0,1,1,1,1,-1,5,1
KR_6724281742,440,3,111,0,3,1,2,1,-3,3,6,0,0,0,2,6,4,3,3,0,0,7,0,3,4,7,1,0,1,1,-1,1,-1,1,1
KR_6653204861,420,-1,-30,-22,4,1,3,2,-4,1,5,5,5,0,1,2,1,1,1,0,0,5,8,5,1,6,0,0,0,1,0,1,1,6,1
KR_6764219538,440,-1,-10,-28,-1,2,4,2,0,1,1,0,1,1,-3,3,6,0,1,1,-1,-5,2,2,0,2,-1,0,-1,-1,1,-1,-1,5,1
KR_6768023625,420,-1,49,-3,-5,-3,1,4,0,3,3,0,2,2,0,2,2,-2,0,2,0,-4,-13,1,3,4,-2,0,1,-1,1,1,-1,6,1
KR_6664635228,420,4,48,16,13,2,4,2,1,2,1,3,6,3,8,12,4,-1,0,1,1,6,-1,3,4,7,-2,0,2,1,1,1,1,2,1
KR_6745815283,420,-1,-3,-16,-3,0,0,0,2,2,0,-3,0,3,0,4,4,-2,0,2,-1,-1,-7,4,2,6,0,0,1,-1,1,1,-1,1,1
KR_6735045304,420,4,45,28,11,4,5,1,5,5,0,2,4,2,1,2,1,-1,0,1,0,1,142,6,1,7,-20,0,1,1,1,1,1,4,1
KR_6762081334,420,1,-12,8,-3,-6,1,7,3,5,2,1,3,2,-1,1,2,0,0,0,2,-3,4,1,5,6,0,0,0,1,1,0,1,5,1
KR_6747774212,420,0,-30,0,3,-2,1,3,0,2,2,5,5,0,0,3,3,0,0,0,1,2,0,6,1,7,-2,0,-1,1,-1,-1,1,5,1
KR_6753125666,420,6,-40,39,13,4,5,1,4,6,2,3,4,1,1,3,2,1,1,0,1,10,4,1,5,6,5,0,0,1,0,0,1,2,1
KR_6754792230,420,2,34,-1,0,-4,1,5,3,7,4,2,4,2,2,3,1,-3,0,3,0,4,4,3,7,10,1,0,-1,1,-1,-1,1,5,1
KR_6756197544,440,2,41,-3,3,1,4,3,-6,0,6,3,4,1,-1,1,2,6,8,2,1,5,-2,-5,8,3,5,0,2,1,-1,1,1,3,1
KR_6665578880,420,1,23,-4,0,0,2,2,-2,1,3,5,6,1,-3,0,3,0,2,2,0,0,-2,-1,6,5,-1,0,0,1,-1,0,1,5,1
KR_6752445928,420,2,71,-36,5,0,1,1,3,4,1,-2,2,4,4,5,1,0,1,1,1,11,-89,0,7,7,0,0,0,-1,-1,0,1,4,1
KR_6724741677,420,4,48,9,9,3,3,0,6,6,0,-2,1,3,2,3,1,0,1,1,0,9,-4,7,3,10,2,0,2,1,1,1,-1,2,1
KR_6616686523,420,6,91,36,10,3,3,0,4,7,3,0,1,1,3,4,1,0,1,1,0,5,-9,-1,6,5,7,0,1,1,1,1,1,5,1
KR_6661303056,420,-2,16,8,-3,0,3,3,6,6,0,-6,3,9,1,2,1,-4,0,4,0,-2,-36,2,4,6,1,0,0,-1,1,1,1,3,1
KR_6733389492,420,2,82,-44,12,4,5,1,9,11,2,-1,2,3,0,1,1,0,1,1,0,9,-7,-4,6,2,3,0,0,-1,-1,0,1,5,1
KR_6719644927,420,-2,-49,-34,1,-4,0,4,-1,4,5,-5,2,7,9,10,1,2,2,0,-1,15,2,5,3,8,-4,0,0,1,1,1,-1,2,1
KR_6743306070,420,1,24,-9,-2,2,2,0,-1,3,4,1,2,1,-4,1,5,0,2,2,0,-5,15,1,4,5,1,0,0,-1,1,1,-1,2,1
KR_6652623358,420,4,147,21,4,6,6,0,1,5,4,1,4,3,-2,1,3,-2,1,3,0,-3,10,2,2,4,-2,0,2,1,1,1,1,6,1
KR_6760843232,440,4,-5,15,10,-2,1,3,8,8,0,5,5,0,0,1,1,-1,0,1,0,20,-1,0,1,1,0,0,1,-1,-1,-1,-1,5,1
KR_6716260099,440,3,19,48,7,3,3,0,-2,0,2,4,5,1,-2,1,3,4,5,1,1,-3,4,-3,4,1,-3,0,1,0,1,1,1,0,1
KR_6750678680,420,-1,73,-6,8,6,6,0,-3,2,5,-2,3,5,6,6,0,1,1,0,0,3,1,3,5,8,3,0,0,0,1,1,-1,0,1
KR_6725419532,420,0,10,0,3,-4,0,4,2,4,2,2,4,2,2,2,0,1,1,0,0,4,-21,-3,5,2,2,0,0,0,-1,0,1,0,1
KR_6696021954,420,1,42,-3,3,2,5,3,1,2,1,-4,2,6,3,4,1,1,2,1,0,7,0,-1,8,7,-1,0,2,1,1,1,1,2,1
KR_6767231589,420,1,10,47,-3,0,2,2,-2,1,3,-4,3,7,4,4,0,-1,2,3,0,-3,5,0,6,6,1,0,0,1,-1,1,1,2,1
KR_6763622119,420,3,33,-20,2,0,2,2,0,3,3,0,2,2,0,0,0,2,2,0,0,4,3,0,3,3,1,0,0,0,1,1,-1,0,1
KR_6732938437,420,-1,-36,-7,-12,3,5,2,-4,2,6,-1,2,3,-10,2,12,0,0,0,0,-14,-1,0,2,2,-1,0,-1,1,0,-1,-1,1,1
KR_6767806190,420,1,16,-6,-3,-1,3,4,2,2,0,-4,0,4,-2,3,5,2,2,0,0,-4,3,-3,6,3,1,0,1,-1,1,1,-1,4,1
KR_6749174019,420,2,-27,3,-2,-2,0,2,1,5,4,-2,1,3,1,4,3,0,1,1,-3,-12,8,2,5,7,-2,0,0,-1,-1,0,-1,2,1
KR_6766088426,420,6,107,5,15,6,8,2,5,6,1,0,1,1,0,1,1,4,4,0,0,13,-2,2,1,3,3,0,1,1,-1,1,-1,3,1
KR_6747363266,420,4,68,31,4,2,3,1,0,3,3,2,3,1,0,1,1,0,2,2,0,-4,18,4,2,6,1,0,1,1,0,1,1,6,1
KR_6707330500,420,4,43,38,8,2,2,0,3,3,0,-1,2,3,0,7,7,4,4,0,0,8,-4,-3,5,2,4,0,2,-1,1,-1,1,2,1
KR_6742948728,420,0,-35,12,5,1,1,0,2,4,2,2,3,1,-3,2,5,3,3,0,0,2,117,-2,7,5,2,0,1,1,0,1,1,6,1
KR_6766677186,420,-1,1,12,3,-2,2,4,1,6,5,0,4,4,4,4,0,0,0,0,0,0,9,-4,9,5,3,0,0,-1,-1,0,-1,5,1
KR_6577538034,420,-1,-18,-12,3,0,2,2,-2,4,6,3,4,1,-2,2,4,4,4,0,0,2,15,-1,4,3,-4,0,0,-1,1,1,1,1,1
KR_6626892874,420,0,-27,-3,-4,-2,0,2,1,2,1,-1,0,1,-1,2,3,-1,1,2,0,0,-5,0,7,7,2,0,1,1,1,1,-1,4,1
KR_6766900238,420,2,66,8,3,2,3,1,-4,3,7,6,6,0,-1,0,1,0,1,1,0,3,-4,-6,10,4,8,0,1,1,0,1,1,1,1
KR_6767229721,420,4,-15,8,15,-1,2,3,8,9,1,3,5,2,3,6,3,2,3,1,1,13,-3,2,1,3,2,0,1,-1,1,1,1,6,1
KR_6719017105,420,-4,-76,-52,0,-1,1,2,0,3,3,1,1,0,-2,2,4,2,4,2,0,0,35,9,4,13,-5,0,-1,-1,1,-1,-1,3,1
KR_6743408822,420,0,-10,8,-1,0,2,2,-1,2,3,0,2,2,1,4,3,-1,0,1,0,-1,-1,2,1,3,3,0,2,1,1,1,-1,5,1
KR_6709628094,420,2,1,-20,1,0,0,0,0,2,2,4,4,0,2,4,2,-5,0,5,-2,5,-119,3,1,4,-2,0,0,1,-1,0,-1,1,1
KR_6608064416,420,3,70,14,7,3,4,1,1,4,3,2,2,0,2,4,2,-1,0,1,1,2,-43,-1,6,5,10,0,1,1,1,1,1,4,1
KR_6735026587,420,1,-17,-10,6,1,2,1,-1,4,5,-1,3,4,1,4,3,6,7,1,0,2,4,7,4,11,-9,0,0,1,1,0,-1,5,1
KR_5883735827,420,1,28,-16,1,-8,1,9,-2,2,4,9,10,1,1,5,4,1,2,1,0,6,-12,-2,6,4,7,0,2,1,-1,1,-1,2,1
KR_6765303036,420,5,117,-8,11,9,11,2,1,2,1,0,0,0,3,4,1,-2,0,2,0,6,6,1,2,3,-1,0,3,-1,1,1,1,1,1
KR_6756488594,420,2,-10,0,2,-7,0,7,1,2,1,1,2,1,6,8,2,1,4,3,0,2,-35,3,2,5,0,0,1,1,-1,1,1,5,1
KR_6733354524,420,-1,-78,10,-1,-1,1,2,4,6,2,-4,1,5,-1,0,1,1,3,2,0,4,-16,-2,5,3,-3,0,0,1,-1,0,-1,3,1
KR_6684730423,420,0,17,-20,-1,-7,0,7,1,5,4,3,4,1,3,5,2,-1,0,1,0,2,-12,4,4,8,3,0,0,1,1,0,-1,3,1
KR_6732073330,420,3,40,36,7,4,4,0,-3,1,4,0,0,0,2,2,0,4,4,0,0,6,19,5,2,7,0,0,0,1,0,1,1,1,1
KR_6764394558,420,2,39,28,10,3,3,0,-2,3,5,2,3,1,6,9,3,1,3,2,0,11,-6,4,2,6,2,0,0,0,1,0,1,0,1
KR_6763098541,420,4,74,17,7,0,0,0,1,3,2,-1,1,2,3,4,1,4,4,0,0,10,54,3,3,6,-13,0,2,0,1,1,-1,0,1
KR_6747578183,420,0,-22,-15,-2,0,1,1,0,0,0,0,1,1,-1,2,3,-1,0,1,0,-3,1,-2,5,3,-6,0,0,-1,0,0,-1,3,1
KR_6740672319,420,0,14,8,3,2,3,1,4,6,2,0,1,1,-4,0,4,1,1,0,1,9,-218,0,3,3,3,0,0,-1,0,0,1,1,1
KR_6733879408,420,3,10,-31,6,0,1,1,-2,2,4,0,2,2,6,6,0,2,3,1,0,9,-10,3,5,8,3,0,2,1,1,1,-1,3,1
KR_6727667346,420,1,5,29,-1,-2,1,3,-1,5,6,3,5,2,0,4,4,-1,0,1,1,-4,-10,-2,3,1,5,0,-1,1,-1,-1,1,4,1
KR_6744729299,440,2,73,15,10,-2,0,2,4,5,1,3,7,4,5,8,3,0,1,1,0,11,-414,1,3,4,-1,0,0,1,1,0,1,1,1
KR_6660534628,420,0,1,24,-8,1,4,3,-4,3,7,1,2,1,-2,2,4,-4,3,7,0,-12,-4,-9,10,1,2,0,0,-1,-1,-1,-1,1,1
KR_6689219348,420,1,81,-11,2,3,6,3,-1,1,2,-1,1,2,2,5,3,-1,1,2,0,-1,2,1,4,5,3,0,2,1,-1,1,1,5,1
KR_6731236257,420,4,59,-4,13,6,6,0,-2,3,5,1,1,0,8,8,0,0,0,0,1,11,-8,0,4,4,4,0,1,1,1,1,1,3,1
KR_6749239402,420,1,-10,-25,3,2,3,1,2,3,1,1,3,2,-2,0,2,0,0,0,0,6,119,4,2,6,-3,0,-1,1,1,-1,1,5,1
KR_6759010520,420,1,-31,16,-1,1,2,1,-5,0,5,0,4,4,0,3,3,3,3,0,0,-2,2,-2,4,2,-2,0,-1,0,1,-1,-1,0,1
KR_6717370891,420,-2,-39,3,2,-2,4,6,-1,3,4,2,2,0,2,2,0,1,2,1,-1,2,1,1,4,5,1,0,0,1,1,1,-1,3,1
KR_6754510335,420,4,41,8,6,-1,1,2,1,4,3,4,6,2,5,6,1,-3,0,3,0,-3,-2,-2,7,5,5,0,3,1,1,1,1,3,1
KR_6765978606,420,2,-24,44,0,-3,0,3,-2,1,3,7,8,1,-3,0,3,1,2,1,0,-2,-5,-1,4,3,2,0,0,1,1,0,-1,6,1
KR_6716441082,440,1,2,-19,4,2,5,3,0,3,3,4,4,0,-1,0,1,-1,1,2,0,2,1,3,5,8,-2,0,0,-1,1,-1,1,6,1
KR_6749400601,440,1,18,8,3,-1,2,3,-1,3,4,5,6,1,3,5,2,-3,0,3,0,7,-3,1,0,1,0,0,-1,-1,-1,-1,1,1,1
KR_6703264109,420,2,96,1,11,4,5,1,3,5,2,4,4,0,0,1,1,0,0,0,0,4,2,-1,4,3,-1,0,3,1,1,1,1,3,1
KR_6615786625,420,3,0,19,6,3,5,2,7,8,1,0,4,4,-5,0,5,1,2,1,0,0,298,-5,6,1,-1,0,2,1,1,1,1,6,1
KR_6732877090,420,4,118,16,7,2,2,0,0,0,0,0,4,4,4,6,2,1,1,0,0,8,6,2,5,7,2,0,0,0,1,0,1,0,1
KR_6445399287,420,-2,-41,-12,-2,0,1,1,1,2,1,2,4,2,1,3,2,-6,0,6,0,-3,3,-5,9,4,0,0,0,-1,-1,0,1,4,1
KR_6765255242,420,-2,23,4,-11,-1,2,3,-5,1,6,-7,2,9,2,4,2,0,1,1,0,-12,18,-2,6,4,-6,0,0,0,-1,0,-1,0,1
KR_6761925519,420,-2,-99,20,-10,-4,1,5,5,5,0,-8,0,8,0,2,2,-3,0,3,-1,-1,6,0,6,6,-3,0,0,-1,1,0,-1,4,1
KR_6653808658,420,2,20,-8,0,-3,1,4,3,5,2,-2,0,2,0,0,0,2,2,0,0,6,-11,-5,13,8,0,0,0,1,-1,0,-1,1,1
KR_6733674415,420,4,45,-8,7,4,5,1,0,1,1,0,1,1,3,3,0,0,0,0,0,5,12,2,1,3,-1,0,2,1,-1,1,1,6,1
KR_6739885846,440,0,54,-6,7,0,3,3,-5,2,7,3,4,1,8,8,0,1,1,0,0,4,3,-3,4,1,2,0,0,0,0,0,-1,0,1
KR_6719661699,420,6,23,24,17,1,2,1,2,3,1,7,8,1,7,7,0,0,0,0,0,18,53,6,1,7,-6,0,0,-1,1,1,-1,1,1
KR_6763527866,440,1,-19,19,4,2,2,0,-4,1,5,4,5,1,2,8,6,0,0,0,-1,5,154,-5,10,5,-16,0,0,1,-1,-1,-1,4,1
KR_6750901457,420,3,-11,16,9,8,9,1,-1,2,3,3,4,1,-1,2,3,0,0,0,0,-5,-4,0,2,2,3,0,0,1,0,0,1,5,1
KR_6723592228,420,4,-13,32,1,4,5,1,-1,3,4,-2,2,4,0,2,2,0,0,0,0,-5,29,-3,6,3,5,0,1,1,1,1,1,5,1
KR_6724389703,440,3,33,-4,3,3,3,0,-4,1,5,0,0,0,2,5,3,2,4,2,0,7,1,-1,4,3,3,0,0,1,1,1,-1,6,1
KR_6607562486,420,5,70,25,10,1,1,0,2,3,1,2,3,1,3,5,2,2,3,1,0,15,8,4,3,7,-1,0,1,1,1,1,1,4,1
KR_6761761923,420,-1,-42,-24,-7,2,3,1,1,5,4,-1,1,2,-9,1,10,0,0,0,0,-5,3,0,3,3,3,0,0,-1,1,-1,-1,4,1
KR_6705464379,420,-1,-20,7,0,0,1,1,5,7,2,-1,1,2,-2,1,3,-2,1,3,0,7,5,-4,10,6,-5,0,0,1,-1,-1,1,4,1
KR_6692534762,420,-1,26,4,-1,1,2,1,-1,4,5,1,1,0,-3,0,3,1,2,1,0,-4,-1,0,6,6,-2,0,1,-1,1,1,1,3,1
KR_6764561290,420,0,91,0,-2,3,5,2,-1,3,4,5,6,1,-6,2,8,-3,0,3,-1,-11,-6,0,5,5,1,0,1,-1,0,-1,-1,1,1
KR_6607799916,420,1,-4,12,5,0,0,0,-1,2,3,8,8,0,-4,2,6,2,2,0,0,11,159,-4,6,2,2,0,1,1,-1,1,-1,5,1
KR_6695909852,420,3,61,31,11,2,3,1,7,9,2,-1,2,3,3,5,2,0,1,1,3,21,6,-1,9,8,-2,0,0,1,-1,1,1,1,1
KR_6760353328,420,1,-41,-2,-2,2,2,0,1,1,0,1,2,1,-5,1,6,-1,1,2,0,-6,3,-1,4,3,3,0,1,-1,-1,-1,-1,6,1
KR_6726489298,440,6,70,12,7,2,3,1,-2,1,3,-5,0,5,6,7,1,6,8,2,0,0,2,-2,5,3,5,0,1,0,-1,1,-1,0,1
KR_6672707070,420,3,-6,20,5,1,5,4,0,1,1,4,4,0,1,1,0,-1,0,1,0,0,12,3,4,7,2,0,0,1,1,0,-1,6,1
KR_6729330177,420,2,30,20,15,2,2,0,-1,1,2,13,15,2,-1,1,2,2,2,0,0,7,1,2,5,7,2,0,3,1,1,1,1,5,1
KR_6484189178,440,4,101,13,2,1,3,2,-3,1,4,1,4,3,1,2,1,2,3,1,0,-4,6,-2,9,7,2,0,1,1,1,1,1,6,1
KR_6766566929,420,-1,-68,-4,-7,-1,0,1,1,2,1,-7,0,7,0,4,4,0,1,1,0,2,76,2,5,7,15,0,0,1,-1,-1,-1,2,1
KR_6635202284,420,3,71,-6,1,1,2,1,0,4,4,-4,0,4,4,4,0,0,0,0,0,1,-100,4,3,7,1,0,0,1,1,1,-1,6,1
KR_6413063761,420,-3,-66,-9,-10,-4,1,5,-3,1,4,-5,1,6,2,3,1,0,0,0,0,-1,-6,-1,5,4,3,0,-1,-1,-1,-1,-1,6,1
KR_6758127528,420,0,7,2,0,0,1,1,-2,1,3,1,4,3,2,3,1,-1,1,2,0,4,-48,5,3,8,-10,0,0,-1,1,0,-1,3,1
KR_6725979100,420,0,-58,4,6,-2,0,2,4,4,0,3,6,3,-1,1,2,2,4,2,2,10,0,-3,6,3,0,0,0,1,1,1,1,1,1
KR_6596440700,420,4,25,-12,5,1,3,2,1,1,0,1,2,1,2,3,1,0,1,1,0,1,-20,2,3,5,0,0,1,1,-1,1,1,4,1
KR_6758419026,440,3,108,1,6,3,5,2,-2,1,3,1,2,1,3,3,0,1,1,0,0,0,11,7,1,8,-2,0,2,1,-1,1,1,6,1
KR_6654508572,420,4,13,21,10,-1,1,2,3,4,1,2,5,3,3,3,0,3,3,0,0,12,0,-2,5,3,0,0,1,1,1,1,1,2,1
KR_6767871613,420,1,-50,8,5,1,3,2,4,6,2,-3,1,4,1,2,1,2,2,0,0,7,-2,-5,8,3,3,0,0,1,-1,0,-1,2,1
KR_6664903010,420,1,3,34,5,0,1,1,0,2,2,1,3,2,3,5,2,1,2,1,0,4,17,0,6,6,-4,0,0,1,1,0,1,5,1
KR_6641324129,420,1,10,-14,8,3,4,1,1,4,3,3,4,1,-4,8,12,5,6,1,0,5,-51,-1,6,5,9,0,0,0,1,1,1,0,1
KR_6739293600,440,5,-33,-24,4,0,3,3,4,5,1,2,4,2,-2,1,3,0,2,2,1,14,-1,-8,9,1,2,0,1,1,-1,1,1,6,1
KR_6754629494,420,1,41,1,6,-2,1,3,3,3,0,1,1,0,4,4,0,0,0,0,1,10,7,4,3,7,3,0,0,-1,1,0,1,6,1
KR_6722655636,420,5,69,-6,7,2,3,1,-1,3,4,3,3,0,4,5,1,-1,1,2,0,11,109,-1,6,5,1,0,1,1,1,1,-1,1,1
KR_6739960239,440,6,87,-14,19,9,10,1,4,4,0,5,5,0,1,2,1,0,0,0,0,10,54,0,3,3,-18,0,2,1,-1,1,1,2,1
KR_6095848432,420,0,83,10,-2,0,5,5,4,5,1,-2,3,5,-2,4,6,-2,0,2,-2,-5,-4,1,5,6,6,0,1,1,-1,1,1,5,1
KR_6741315339,420,1,-25,5,4,-4,0,4,0,4,4,-1,0,1,6,7,1,3,4,1,1,14,-320,3,2,5,1,0,-1,1,-1,-1,-1,1,1
KR_6733203989,420,-1,-62,21,-4,-4,0,4,3,5,2,2,4,2,-4,0,4,-1,2,3,1,-1,1,-1,5,4,-1,0,-2,-1,-1,-1,1,1,1
KR_6756212878,420,2,17,44,1,-1,0,1,0,3,3,7,7,0,-3,2,5,-2,0,2,0,5,-6,-3,7,4,-5,0,0,-1,0,0,1,1,1
KR_6739975677,420,2,38,-1,-2,2,5,3,-2,1,3,0,5,5,-3,2,5,1,1,0,0,-3,284,-1,7,6,14,0,1,-1,1,1,-1,6,1
KR_6177114556,420,4,23,8,11,-1,1,2,1,3,2,6,7,1,4,4,0,1,1,0,0,5,16,0,4,4,1,0,0,-1,1,1,1,5,1
KR_6733416433,420,-1,-25,0,-1,-2,1,3,6,7,1,-2,2,4,-1,2,3,-2,1,3,0,-1,22,0,6,6,1,0,-1,1,1,-1,1,2,1
KR_6762831716,420,7,97,41,7,1,1,0,3,4,1,2,2,0,2,4,2,-1,0,1,0,5,-241,-2,5,3,1,0,0,1,0,1,1,5,1
KR_6720611251,420,7,159,15,11,4,4,0,7,9,2,0,2,2,1,3,2,-1,0,1,0,13,14,1,4,5,0,0,3,-1,1,1,-1,2,1
KR_6766802753,420,1,6,-4,1,0,2,2,-3,0,3,-2,0,2,5,5,0,1,3,2,-1,2,67,2,2,4,-24,0,1,-1,1,1,-1,4,1
KR_6728588889,420,3,77,-20,6,3,3,0,3,4,1,4,6,2,-1,2,3,-3,0,3,1,-2,12,1,3,4,6,0,2,1,1,1,1,4,1
KR_6715447140,420,6,108,46,14,1,2,1,1,3,2,7,8,1,2,6,4,3,4,1,1,16,6,2,2,4,1,1,5,0,1,1,1,0,1
KR_6760201327,420,2,42,10,8,-3,1,4,6,7,1,5,6,1,1,2,1,-1,2,3,0,10,10,5,1,6,-1,0,1,1,1,1,1,2,1
KR_6343582480,420,4,43,16,8,1,4,3,-1,1,2,6,10,4,1,1,0,1,1,0,0,8,0,-1,5,4,-2,0,0,1,0,0,-1,2,1
KR_6767884638,420,-1,-86,-7,-1,0,0,0,2,2,0,-1,1,2,-1,1,2,-1,0,1,0,-1,5,2,2,4,2,0,1,-1,1,1,1,6,1
KR_6759718078,420,-1,-41,3,-9,2,3,1,2,4,2,-4,0,4,-8,1,9,-1,0,1,-1,-5,-6,-6,9,3,-2,0,0,-1,1,1,-1,3,1
KR_6764339554,440,2,21,11,17,1,5,4,2,2,0,5,6,1,7,9,2,2,2,0,1,22,-13,-1,5,4,4,0,1,1,-1,1,1,2,1
KR_6723295074,420,1,12,21,-4,0,2,2,-3,3,6,2,3,1,-2,0,2,-1,0,1,0,-6,-4,0,3,3,-4,0,-2,1,-1,-1,-1,2,1
KR_6724015419,420,-3,-68,-8,-8,-3,1,4,3,7,4,0,2,2,-5,1,6,-3,2,5,0,-11,3,3,0,3,-3,0,-1,-1,-1,-1,1,5,1
KR_6649320019,420,-1,14,26,3,-3,0,3,2,3,1,7,8,1,-2,1,3,-1,0,1,0,5,-3,2,3,5,1,0,-1,-1,1,-1,-1,1,1
KR_6677950794,420,0,54,0,-4,1,3,2,-1,4,5,-2,1,3,-1,3,4,-1,0,1,0,-7,-45,-8,8,0,-18,0,1,1,1,1,1,4,1
KR_6745134958,420,-1,-41,-12,3,-5,1,6,-2,2,4,1,2,1,9,12,3,0,1,1,0,-2,269,-7,8,1,2,0,0,1,1,1,-1,4,1
KR_6659049723,440,-5,-41,12,-11,-5,1,6,-5,3,8,2,2,0,-5,0,5,2,2,0,-1,-11,-35,-3,8,5,17,0,0,1,1,0,-1,2,1
KR_6727368933,420,1,32,-26,5,4,4,0,-3,0,3,1,2,1,3,4,1,0,0,0,0,3,-43,0,5,5,19,0,0,-1,1,-1,-1,6,1
KR_6762565038,420,2,-28,12,2,2,2,0,3,4,1,1,3,2,-3,4,7,-1,1,2,0,2,2,4,2,6,-1,0,1,1,1,1,1,4,1
KR_6731563891,440,1,26,-4,1,-1,0,1,0,0,0,0,1,1,2,3,1,0,1,1,0,2,0,3,4,7,2,0,0,1,-1,0,1,2,1
KR_6761886084,420,1,-60,-2,-7,0,1,1,2,2,0,0,5,5,-7,1,8,-2,2,4,0,-11,-18,-5,5,0,-1,0,1,0,-1,1,1,0,1
KR_6635067116,420,-3,-12,-12,-5,-4,1,5,1,3,2,0,2,2,-1,0,1,-1,0,1,0,-6,-15,-1,4,3,2,0,1,-1,1,1,1,4,1
KR_6750265031,420,1,-17,20,1,-3,1,4,-1,2,3,2,3,1,4,5,1,-1,0,1,-1,2,113,0,7,7,-2,0,0,-1,-1,0,-1,1,1
KR_6674061137,420,2,32,-17,5,3,3,0,2,4,2,-1,2,3,2,4,2,-1,0,1,0,4,-23,-4,8,4,-1,0,1,-1,1,1,1,6,1
KR_6759042107,420,0,45,4,2,-1,0,1,1,1,0,1,2,1,2,2,0,-1,0,1,0,0,-5,-3,6,3,4,0,1,1,1,1,1,3,1
KR_6716817377,440,0,-18,21,-1,-4,1,5,0,4,4,1,2,1,0,5,5,2,3,1,-1,4,-5,4,0,4,-4,0,0,-1,1,1,-1,3,1
KR_6590048579,420,0,11,15,8,0,1,1,0,0,0,10,11,1,-3,1,4,1,4,3,4,7,7,1,5,6,2,0,3,1,1,1,1,5,1
KR_6759243517,420,0,69,-1,0,0,2,2,1,4,3,-2,3,5,-1,3,4,2,2,0,0,-3,10,3,2,5,-3,0,1,-1,1,1,1,2,1
KR_6659707837,420,-1,-42,-23,2,-3,0,3,2,2,0,1,1,0,3,3,0,-1,2,3,0,2,15,0,3,3,1,0,1,1,-1,1,-1,6,1
KR_6677659355,420,2,-15,4,-2,-5,2,7,-3,1,4,7,8,1,-2,1,3,1,2,1,0,-4,-41,3,1,4,12,0,0,0,-1,-1,-1,0,1
KR_6766643491,440,5,75,56,12,1,2,1,3,4,1,2,5,3,5,5,0,1,1,0,0,17,-1,-2,6,4,7,0,0,-1,1,0,1,1,1
KR_6679791783,420,2,-26,0,-1,1,1,0,2,2,0,0,2,2,-6,1,7,2,3,1,0,-3,-28,-1,7,6,0,0,-1,-1,-1,-1,-1,4,1
KR_6627716334,420,4,79,19,6,-2,0,2,5,6,1,1,5,4,-1,0,1,3,6,3,0,3,-9,-5,7,2,9,0,1,0,1,1,-1,0,1
KR_6384789195,420,7,101,16,16,8,8,0,8,9,1,-2,0,2,1,2,1,1,3,2,0,13,7,-2,5,3,12,0,4,1,1,1,1,4,1
KR_6185825558,440,2,20,13,3,4,5,1,3,3,0,1,1,0,-1,2,3,-4,2,6,0,3,117,-2,9,7,7,0,1,0,1,1,1,0,1
KR_6763756960,420,3,104,31,-1,2,3,1,2,4,2,0,1,1,-2,0,2,-3,0,3,0,-4,-38,0,4,4,21,0,0,1,0,0,-1,6,1
KR_6756947076,420,1,-5,-4,-3,0,0,0,-6,1,7,-1,1,2,6,8,2,-2,0,2,0,4,9,3,2,5,0,0,-1,1,-1,-1,-1,3,1
KR_6760219365,420,1,44,-18,1,0,0,0,-3,2,5,5,7,2,1,7,6,-2,1,3,0,-7,8,2,2,4,0,0,1,1,-1,1,1,1,1
KR_6612600079,420,-2,-11,-12,3,-2,1,3,-2,1,3,4,5,1,3,3,0,0,1,1,0,6,-111,-2,6,4,-1,0,-1,1,-1,-1,1,2,1
KR_6761763388,440,0,-24,-8,6,-3,0,3,0,0,0,6,7,1,2,2,0,1,2,1,0,8,7,1,4,5,2,0,1,1,1,1,1,5,1
KR_6760918347,420,-3,-15,17,-10,-1,1,2,-2,3,5,-2,1,3,-4,4,8,-1,1,2,0,-11,-1,2,4,6,-1,0,2,1,1,-1,-1,2,1
KR_6734165461,440,2,154,8,5,7,7,0,-3,1,4,-2,1,3,6,6,0,-3,0,3,0,-5,2,2,3,5,4,0,1,1,1,1,1,6,1
KR_6673120830,420,6,44,39,14,1,1,0,8,8,0,5,6,1,0,2,2,0,4,4,1,11,-9,2,3,5,5,0,1,0,1,1,1,0,1
KR_6661792213,420,2,13,-11,5,2,2,0,3,9,6,3,6,3,-3,1,4,0,0,0,0,6,-12,-4,5,1,3,0,-1,1,-1,-1,-1,5,1
KR_6703934158,420,5,45,52,0,2,3,1,-1,3,4,0,0,0,-1,1,2,0,1,1,-1,-8,7,0,6,6,-4,0,1,1,1,1,-1,2,1
KR_6633245491,420,-1,1,-26,-8,4,5,1,-2,2,4,-3,0,3,0,1,1,-7,1,8,-3,-11,4,2,5,7,-2,0,0,1,-1,1,-1,3,1
KR_6728395346,440,3,-46,24,5,0,4,4,-4,0,4,1,4,3,4,6,2,4,4,0,0,-3,0,3,5,8,-2,0,1,1,1,1,-1,1,1
KR_6762736125,420,1,40,8,0,2,2,0,1,3,2,-3,0,3,0,1,1,0,0,0,0,-3,-13,0,3,3,-3,0,1,1,1,1,-1,2,1
KR_6661463349,420,2,-28,-8,5,2,4,2,-3,3,6,4,4,0,3,5,2,-1,0,1,0,8,-5,-2,7,5,8,0,1,-1,1,1,1,5,1
KR_6185760445,440,-1,-23,6,-2,-1,0,1,-2,1,3,2,3,1,-1,0,1,0,0,0,0,-2,3,0,3,3,3,0,-1,1,-1,-1,-1,3,1
KR_6636173377,420,-1,31,28,1,-1,0,1,3,7,4,-2,0,2,0,2,2,1,1,0,0,1,-17,-5,7,2,2,0,1,-1,1,1,-1,3,1
KR_6759163018,440,4,106,16,12,0,1,1,-1,3,4,3,4,1,7,7,0,3,3,0,0,6,-5,-5,7,2,0,0,1,1,0,1,1,5,1
KR_6731804852,420,3,1,16,5,0,1,1,5,5,0,1,4,3,0,3,3,-1,2,3,-1,11,2,3,3,6,3,0,0,1,1,0,-1,1,1
KR_6629598371,420,1,74,23,1,4,4,0,-6,1,7,1,1,0,2,5,3,0,0,0,0,-1,18,-4,7,3,7,0,0,1,1,1,1,1,1
KR_6744758186,440,-1,-3,-9,-5,-4,2,6,-2,4,6,7,7,0,-5,1,6,-1,1,2,-1,0,-9,-5,7,2,6,0,1,1,0,1,-1,4,1
KR_6752137391,440,3,83,24,4,3,3,0,1,2,1,3,5,2,-3,5,8,0,1,1,0,-4,3,-1,3,2,-2,0,1,-1,1,1,-1,4,1
KR_6544081814,420,3,69,16,4,3,3,0,1,3,2,2,3,1,0,4,4,-2,0,2,1,7,-13,5,2,7,-1,0,2,1,1,1,1,1,1
KR_6724346248,420,1,49,9,1,-4,0,4,-2,4,6,3,3,0,4,4,0,0,0,0,0,5,3,0,2,2,3,0,-1,1,-1,-1,1,6,1
KR_6716924045,420,2,73,21,9,-1,3,4,4,4,0,3,5,2,2,2,0,1,1,0,0,6,15,2,3,5,3,0,2,0,-1,1,1,0,1
KR_6764451265,420,0,12,15,0,4,6,2,4,4,0,1,4,3,-5,1,6,-4,1,5,1,-9,-6,3,1,4,-2,0,1,0,1,1,1,0,1
KR_6752879538,420,2,24,5,5,3,6,3,-4,1,5,5,6,1,0,1,1,1,1,0,1,-7,-2,1,4,5,3,0,1,-1,1,1,1,3,1
KR_6748888172,440,1,-3,4,4,-2,3,5,0,1,1,2,3,1,3,3,0,1,1,0,0,4,-96,-1,6,5,4,0,0,1,-1,0,-1,2,1
KR_6745374788,420,1,24,-4,2,-3,1,4,2,4,2,4,5,1,-2,5,7,1,3,2,-2,-2,2,1,0,1,2,0,1,1,-1,1,-1,6,1
KR_6561308010,420,5,49,-8,9,1,3,2,4,4,0,5,7,2,0,3,3,-1,1,2,-1,13,26,3,4,7,1,0,1,-1,-1,1,-1,5,1
KR_6762530079,420,2,40,0,5,-2,1,3,1,1,0,4,5,1,2,2,0,0,0,0,1,8,4,1,4,5,2,0,0,1,-1,0,1,3,1
KR_6755405791,420,5,54,24,8,6,6,0,-1,3,4,2,3,1,2,4,2,-1,0,1,0,-2,258,-5,6,1,-1,0,0,1,1,0,1,4,1
KR_6761579432,440,4,95,-15,2,-5,0,5,-1,1,2,1,3,2,3,4,1,4,4,0,0,-2,-5,-1,5,4,-2,0,1,1,-1,1,-1,4,1
KR_6606003566,420,8,120,-14,15,4,4,0,1,6,5,5,6,1,3,4,1,2,2,0,0,14,58,1,3,4,1,0,2,-1,1,1,1,1,1
KR_6713114774,420,-1,-17,-6,3,2,5,3,-3,0,3,1,2,1,2,3,1,1,2,1,0,-4,-6,-5,8,3,4,0,1,-1,1,1,1,4,1
KR_6664448979,420,2,18,12,7,3,4,1,1,3,2,-1,0,1,4,4,0,0,3,3,0,5,0,-1,8,7,6,0,0,1,-1,1,1,4,1
KR_6688271423,420,2,18,20,3,-5,4,9,-1,0,1,4,4,0,3,4,1,2,4,2,1,4,6,5,0,5,2,0,1,-1,1,1,1,3,1
KR_6761911600,420,-1,-2,-37,0,-1,1,2,-4,0,4,2,2,0,0,3,3,3,4,1,0,-4,-5,-6,7,1,5,0,1,1,-1,1,-1,6,1
KR_6764491734,440,1,10,0,2,0,2,2,2,2,0,1,3,2,1,1,0,-2,0,2,0,1,19,2,0,2,0,0,0,0,-1,0,1,0,1
KR_6731311659,440,1,-9,-16,4,-3,0,3,3,4,1,-1,3,4,4,4,0,1,2,1,1,8,1,-1,3,2,-2,0,1,-1,1,1,1,6,1
KR_6721819781,420,5,96,36,14,4,4,0,4,4,0,4,4,0,4,6,2,-2,0,2,0,11,14,6,5,11,-2,0,2,-1,1,1,1,3,1
KR_6753198475,420,2,-52,59,5,-2,1,3,2,2,0,2,3,1,4,6,2,-1,2,3,0,2,5,0,4,4,0,0,1,1,1,1,1,6,1
KR_6754700855,420,6,15,16,10,3,3,0,1,4,3,5,5,0,1,4,3,0,1,1,0,4,-25,-3,3,0,10,0,1,1,1,1,-1,1,1
KR_6689417728,420,4,23,24,14,0,2,2,2,2,0,5,6,1,5,6,1,2,2,0,0,17,1,0,4,4,-2,0,1,-1,1,1,1,4,1
KR_6627273582,420,-3,16,-10,-8,3,3,0,-2,2,4,-1,2,3,-4,0,4,-4,2,6,0,-8,-20,-1,4,3,-2,0,-2,-1,-1,-1,-1,6,1
KR_6736463223,420,-1,21,16,-7,-3,1,4,0,1,1,-2,4,6,0,2,2,-2,0,2,-1,-12,35,-4,9,5,-12,0,2,-1,1,1,-1,5,1
KR_6766972614,420,2,6,16,3,-1,0,1,0,2,2,3,4,1,2,3,1,-1,1,2,0,6,-115,6,1,7,6,0,0,1,-1,0,1,5,1
KR_6742447743,440,1,16,8,2,0,1,1,3,4,1,1,1,0,0,2,2,-2,0,2,1,9,-3,0,5,5,-1,0,0,1,-1,0,1,4,1
KR_6721082075,440,0,3,28,-3,-2,2,4,-3,3,6,2,5,3,0,3,3,0,0,0,1,-7,0,0,6,6,-2,0,-1,1,1,-1,1,1,1
KR_6763643145,420,2,95,1,0,-2,0,2,-3,1,4,5,10,5,0,4,4,0,3,3,0,-3,-44,-1,3,2,2,0,0,-1,-1,0,-1,3,1
KR_6680606488,420,-2,4,4,-5,-1,1,2,-5,4,9,-2,0,2,5,8,3,-2,1,3,-1,-7,-29,-1,5,4,2,0,0,1,-1,0,1,2,1
KR_6701569847,420,6,53,29,11,0,1,1,1,2,1,2,3,1,6,6,0,2,4,2,1,9,38,2,2,4,0,0,0,1,1,0,1,2,1
KR_6719131920,440,-1,-20,-8,3,-3,0,3,5,5,0,-4,2,6,0,0,0,5,6,1,0,11,-3,0,5,5,0,0,1,-1,1,1,-1,4,1
KR_6732294155,420,-4,56,-16,-5,5,6,1,3,3,0,-3,0,3,-5,0,5,-5,0,5,0,-4,10,1,5,6,-1,0,1,-1,1,1,1,4,1
KR_6581290518,420,1,-18,-40,0,-1,2,3,0,1,1,-6,2,8,6,6,0,1,2,1,-1,12,2,-2,5,3,-2,0,0,-1,-1,-1,-1,1,1
KR_6732860519,420,1,20,-2,4,4,6,2,2,3,1,3,5,2,-3,0,3,-2,2,4,0,-2,-6,-6,8,2,-1,0,0,1,1,1,1,2,1
KR_6738687538,420,-3,14,-44,-5,-5,0,5,-2,2,4,-4,3,7,6,9,3,0,1,1,0,-8,74,4,2,6,-27,0,0,-1,1,0,1,5,1
KR_6755827352,420,5,80,24,2,-1,0,1,0,3,3,6,12,6,-4,0,4,1,1,0,0,-4,-12,0,4,4,0,0,1,1,0,1,-1,3,1
KR_6759078409,420,8,164,45,9,-1,1,2,0,2,2,4,4,0,7,9,2,-1,2,3,2,7,9,3,2,5,0,0,3,1,1,1,1,1,1
KR_6757446882,440,-3,-53,-16,-2,-1,0,1,1,4,3,-1,0,1,1,3,2,-2,1,3,1,6,21,2,3,5,-3,0,0,-1,-1,0,1,5,1
KR_6766934828,440,2,-44,-2,8,0,2,2,2,4,2,5,6,1,2,3,1,-1,1,2,0,10,21,4,5,9,-3,0,0,-1,1,-1,1,5,1
KR_6525169804,420,-2,-42,-16,-5,-1,1,2,-1,5,6,2,3,1,-3,2,5,-2,0,2,-1,-11,10,3,2,5,2,0,-2,1,-1,-1,-1,5,1
KR_6733915020,440,1,37,-20,2,4,4,0,1,1,0,-2,2,4,1,1,0,-2,0,2,0,6,5,0,5,5,2,0,-1,-1,1,-1,-1,1,1
KR_6746431747,420,-2,-28,-21,-6,-1,2,3,2,6,4,-4,2,6,-7,4,11,4,5,1,0,-11,0,-2,6,4,-4,0,0,0,0,0,-1,0,1
KR_6685974840,420,0,25,12,-5,0,2,2,-2,0,2,-2,0,2,-2,1,3,1,1,0,1,-3,7,2,2,4,-3,0,0,1,-1,0,1,3,1
KR_6745505371,420,3,7,6,7,0,1,1,1,3,2,0,0,0,4,5,1,2,3,1,1,9,7,4,3,7,0,0,0,1,1,0,1,5,1
KR_6682123516,440,1,-55,0,-10,5,7,2,-3,1,4,-7,0,7,-6,0,6,1,1,0,0,-6,2,-2,3,1,-1,0,-1,1,-1,-1,-1,2,1
KR_6748076196,420,-5,-83,-8,-6,0,3,3,-1,0,1,1,2,1,-3,0,3,-3,0,3,0,-6,-1,2,1,3,1,0,-1,-1,0,-1,-1,2,1
KR_6704756120,420,0,22,-12,-1,0,1,1,-1,2,3,1,4,3,-2,4,6,1,2,1,0,1,15,1,2,3,1,0,0,1,0,0,1,2,1
KR_6761573168,420,4,28,0,13,5,5,0,4,8,4,1,2,1,4,5,1,-1,0,1,-1,10,7,-1,7,6,0,0,-1,-1,0,-1,-1,4,1
KR_6759718454,440,-1,-76,-10,0,1,4,3,-1,2,3,5,8,3,-4,1,5,-1,3,4,0,6,0,4,1,5,2,0,0,1,-1,0,-1,2,1
KR_6705431145,440,-3,-44,21,-5,-2,2,4,1,5,4,2,5,3,-5,0,5,-1,0,1,2,6,6,5,5,10,-4,0,-2,1,-1,-1,1,3,1
KR_6761105781,420,0,-1,-6,-3,-3,0,3,-4,1,5,3,4,1,0,2,2,1,1,0,0,2,-3,0,4,4,-1,0,0,-1,0,0,-1,4,1
KR_6658472906,420,4,37,21,5,2,2,0,1,3,2,5,5,0,-5,1,6,2,3,1,-1,-4,4,1,5,6,2,0,2,-1,1,1,-1,2,1
KR_6741351179,420,-1,34,-20,-3,-1,0,1,-2,0,2,1,2,1,-1,2,3,0,1,1,0,-6,-4,-8,9,1,-2,0,0,0,0,0,1,0,1
KR_6765196340,420,-1,-34,16,-3,-2,1,3,-1,3,4,0,4,4,1,3,2,-1,1,2,0,-3,5,-3,5,2,-1,0,1,1,0,-1,-1,2,1
KR_6763377443,440,2,-14,17,4,-1,1,2,-4,4,8,4,4,0,6,9,3,-1,1,2,-1,0,16,-7,11,4,-3,0,0,1,1,0,-1,3,1
KR_6694153464,420,6,111,-10,5,2,2,0,2,4,2,-1,1,2,3,3,0,-1,0,1,0,5,-14,-1,5,4,2,0,1,1,0,1,1,6,1
KR_6716330041,420,-1,-37,-19,7,2,2,0,-2,1,3,0,1,1,6,7,1,1,2,1,0,6,-1,-2,5,3,-2,0,0,-1,1,-1,1,4,1
KR_6745232014,420,1,6,27,0,3,3,0,-1,4,5,1,2,1,-4,6,10,1,1,0,0,-5,3,0,8,8,1,0,0,-1,-1,1,1,2,1
KR_6759812353,440,3,48,-4,3,3,4,1,0,2,2,-3,2,5,3,5,2,0,2,2,0,4,10,1,1,2,1,0,1,1,0,1,-1,2,1
KR_6679846594,420,2,80,-8,-1,4,4,0,-5,2,7,1,2,1,0,1,1,-1,0,1,0,-4,5,5,1,6,0,0,2,-1,1,1,-1,1,1
KR_6732943928,420,2,55,43,-1,0,1,1,3,4,1,-2,1,3,-2,1,3,0,1,1,0,-7,43,2,2,4,-13,0,1,1,1,1,1,3,1
KR_6716950190,420,-1,-43,14,-6,-1,1,2,3,8,5,-2,2,4,-2,1,3,-4,0,4,0,-4,-12,-5,7,2,0,0,0,0,-1,-1,-1,0,1
KR_6766857995,420,1,-23,20,4,4,7,3,2,5,3,2,2,0,-2,1,3,-2,1,3,0,6,-180,0,4,4,-16,0,1,-1,1,1,-1,5,1
KR_6761520472,440,-3,-54,-34,-10,-2,1,3,3,3,0,-5,1,6,-3,4,7,-3,0,3,-1,-15,-9,-1,3,2,3,0,-1,-1,-1,-1,-1,4,1
KR_6762619689,420,4,30,13,16,2,3,1,4,4,0,2,4,2,6,6,0,2,3,1,0,11,-9,-2,7,5,7,0,2,1,-1,1,1,4,1
KR_6766652412,420,-4,14,-64,-4,1,1,0,-2,1,3,-7,0,7,4,4,0,0,0,0,0,1,-14,1,3,4,3,0,-1,1,-1,-1,-1,2,1
KR_6757868075,420,1,-10,-9,4,1,3,2,2,4,2,2,5,3,0,2,2,-1,0,1,0,9,14,3,1,4,-4,0,0,-1,-1,-1,-1,2,1
KR_6757318430,420,2,7,12,2,0,0,0,-5,2,7,2,5,3,4,5,1,1,1,0,0,8,3,-4,9,5,2,0,1,1,0,1,1,5,1
KR_6706325786,420,3,-18,4,7,0,1,1,2,7,5,0,2,2,2,4,2,3,3,0,0,12,-34,3,3,6,19,0,0,1,-1,-1,1,4,1
KR_6763557415,440,-2,84,-20,-6,2,4,2,-3,1,4,0,1,1,-1,1,2,-4,1,5,0,-9,-2,-3,8,5,1,0,0,1,0,0,1,2,1
KR_6505784395,420,1,43,-12,1,2,2,0,2,5,3,-3,0,3,0,2,2,0,0,0,0,0,-10,0,2,2,1,0,0,1,0,1,1,2,1
KR_6722064704,420,3,1,8,11,-3,0,3,2,3,1,1,4,3,7,8,1,4,4,0,0,14,16,2,0,2,2,0,0,1,-1,1,1,1,1
KR_6707107625,420,1,49,-8,1,-5,1,6,1,4,3,4,5,1,2,2,0,-1,0,1,0,3,4,1,3,4,-4,0,0,0,-1,0,1,0,1
KR_6754821494,420,3,26,20,4,1,2,1,0,4,4,1,3,2,1,2,1,1,2,1,0,1,3,4,0,4,-4,0,1,1,1,1,1,4,1
KR_6765097571,420,0,56,-12,0,6,7,1,0,2,2,2,2,0,-3,1,4,-5,0,5,0,-11,1,2,4,6,0,0,0,1,1,1,-1,2,1
KR_6744929787,420,2,26,12,5,-1,0,1,1,3,2,-1,0,1,4,4,0,2,2,0,0,7,-8,-6,7,1,8,0,1,1,0,1,1,4,1
KR_6693138173,420,4,84,4,5,3,4,1,4,5,1,-2,0,2,0,3,3,0,0,0,0,6,5,7,1,8,-2,0,0,1,-1,1,-1,3,1
KR_6594908458,420,2,88,0,6,9,10,1,-4,0,4,1,3,2,3,3,0,-3,0,3,0,3,24,0,5,5,-22,0,2,1,1,1,1,5,1
KR_6744126989,420,-3,-36,0,-5,-4,1,5,3,5,2,0,4,4,-6,0,6,2,2,0,0,-3,-1,-1,6,5,-2,0,-1,-1,1,-1,-1,5,1
KR_6506945611,420,2,-14,32,-3,1,4,3,0,1,1,-3,1,4,-2,1,3,1,1,0,0,-8,36,1,5,6,-19,0,0,0,1,1,1,0,1
KR_6735485819,420,2,60,15,6,0,0,0,-1,1,2,2,6,4,3,4,1,2,2,0,0,4,11,5,2,7,-2,0,1,1,1,1,1,3,1
KR_6679539868,420,1,89,10,4,2,2,0,2,4,2,-1,3,4,2,4,2,-1,1,2,4,8,0,1,2,3,1,0,1,-1,1,1,1,4,1
KR_6598124488,420,1,-44,0,4,-4,1,5,5,6,1,-1,1,2,1,6,5,3,3,0,0,4,-1,-3,6,3,-2,0,-1,1,-1,-1,-1,4,1
KR_6624589465,440,1,24,-12,4,-1,1,2,-1,3,4,3,6,3,0,2,2,3,5,2,0,6,2,-4,5,1,1,0,-1,1,1,1,1,3,1
KR_6754475803,420,-2,54,-11,-1,2,3,1,0,3,3,1,2,1,-4,0,4,0,0,0,0,-1,-13,-2,5,3,4,0,0,-1,1,0,-1,2,1
KR_6660981297,440,1,30,-4,6,0,0,0,3,3,0,1,2,1,4,5,1,-2,1,3,0,3,0,3,2,5,1,0,0,1,0,0,1,6,1
KR_6758906823,420,4,79,12,-4,-1,1,2,0,3,3,1,4,3,-6,2,8,2,4,2,1,-4,3,2,2,4,-1,0,0,1,1,1,1,4,1
KR_6766607945,440,0,25,12,-2,0,0,0,1,2,1,-4,0,4,1,3,2,0,2,2,0,1,1,-4,5,1,1,0,1,1,-1,1,-1,4,1
KR_6444042306,420,2,59,16,6,1,1,0,-1,2,3,0,1,1,6,7,1,0,1,1,3,10,20,-1,5,4,0,0,0,1,1,0,1,6,1
KR_6763444556,420,-2,19,-12,-9,-3,0,3,-1,1,2,1,2,1,-7,2,9,1,1,0,0,-6,10,1,3,4,0,0,0,1,0,0,-1,1,1
KR_6766719458,420,0,-19,0,3,2,4,2,0,3,3,-1,0,1,2,4,2,0,0,0,0,5,7,0,2,2,-1,0,-1,1,1,-1,1,6,1
KR_6762321455,420,2,19,-8,3,-2,0,2,0,3,3,4,6,2,0,4,4,1,2,1,0,2,2,-1,4,3,1,0,-1,1,-1,-1,1,2,1
KR_6762932556,420,2,21,12,6,3,5,2,7,8,1,-5,1,6,4,4,0,-3,0,3,0,4,0,2,3,5,0,0,0,0,1,1,1,0,1
KR_6750350717,420,2,7,4,5,-2,0,2,2,3,1,0,1,1,3,3,0,2,2,0,0,6,2,0,3,3,3,0,1,1,-1,1,1,1,1
KR_6751437497,420,2,7,20,3,2,4,2,2,5,3,4,5,1,-4,3,7,-1,0,1,0,3,-3,1,3,4,1,0,0,-1,-1,-1,1,4,1
KR_6719779021,420,4,8,3,8,2,2,0,2,6,4,2,3,1,2,6,4,0,0,0,-2,2,11,0,4,4,1,0,1,1,-1,1,1,3,1
KR_6763320252,420,3,85,11,9,3,3,0,1,1,0,1,1,0,4,4,0,0,2,2,0,10,22,-1,4,3,-1,0,1,-1,1,1,1,2,1
KR_6739262049,420,-1,27,8,-1,-4,0,4,-1,1,2,3,3,0,1,1,0,0,1,1,0,2,46,0,4,4,-34,0,0,1,-1,0,1,3,1
KR_6745260583,420,-1,-8,8,4,-4,2,6,0,1,1,3,4,1,3,4,1,2,2,0,2,6,-6,-3,5,2,4,0,0,1,-1,0,1,4,1
KR_6752264749,420,1,14,-2,-1,-2,2,4,-5,0,5,1,4,3,2,2,0,3,5,2,1,1,-47,-7,13,6,6,0,0,1,-1,0,1,3,1
KR_6763627228,440,2,32,-4,4,1,3,2,-4,2,6,-1,3,4,3,7,4,5,5,0,1,11,-3,0,6,6,1,0,0,1,-1,0,1,6,1
KR_6752716498,420,0,11,-9,-1,0,3,3,-1,0,1,-2,0,2,1,1,0,1,1,0,0,1,-28,-3,4,1,13,0,0,-1,-1,0,-1,4,1
KR_6755457534,420,-1,38,-31,3,3,3,0,2,7,5,-2,1,3,4,5,1,-4,1,5,0,9,16,-2,6,4,4,0,-1,-1,-1,-1,-1,4,1
KR_6634984862,420,0,-29,21,-1,-2,0,2,6,9,3,-1,2,3,-4,0,4,0,0,0,0,2,31,2,5,7,-6,0,1,-1,1,1,-1,3,1
KR_6709748284,420,2,98,16,1,3,4,1,-5,1,6,-2,3,5,4,6,2,1,1,0,1,-1,5,1,2,3,4,0,0,1,-1,1,1,3,1
KR_6748728890,420,0,8,13,-4,-1,2,3,-1,3,4,-6,3,9,2,5,3,2,3,1,0,-3,-1,-2,5,3,-1,0,-1,0,-1,-1,-1,0,1
KR_6481181036,420,-1,-25,-4,-3,-3,2,5,-2,3,5,-1,1,2,3,4,1,0,0,0,-2,-11,-1,-4,5,1,2,0,1,0,1,1,-1,0,1
KR_6768000428,420,4,48,-15,4,2,4,2,1,3,2,1,3,2,-1,3,4,1,2,1,0,2,46,2,5,7,-23,0,0,-1,1,0,-1,1,1
KR_6673520053,420,0,-7,7,-1,2,2,0,0,5,5,0,0,0,-2,0,2,-1,2,3,0,-3,-4,1,3,4,5,0,0,-1,1,0,-1,2,1
KR_6658590157,420,4,56,24,9,1,3,2,0,1,1,3,3,0,2,4,2,3,3,0,0,8,-73,-4,5,1,3,0,1,1,-1,1,1,4,1
KR_6708741779,440,0,7,20,-1,-3,1,4,2,4,2,-1,0,1,-1,0,1,2,2,0,0,-1,185,-4,6,2,-3,0,0,0,-1,0,1,0,1
KR_6767509803,420,-1,40,5,2,0,2,2,3,3,0,-3,1,4,2,3,1,0,0,0,0,5,2,2,6,8,4,0,0,-1,0,0,-1,2,1
KR_6652640322,420,6,72,21,12,2,4,2,6,6,0,6,6,0,-3,2,5,1,1,0,0,2,7,2,2,4,-2,0,2,1,1,1,1,2,1
KR_6759668186,420,-3,0,-12,-10,-4,1,5,-5,3,8,-6,1,7,4,4,0,1,2,1,0,-2,-2,-1,3,2,1,0,0,-1,-1,1,1,2,1
KR_6526495090,420,2,79,30,3,0,2,2,6,6,0,0,5,5,0,2,2,-3,3,6,0,-8,-2,-1,3,2,1,0,0,1,1,1,1,2,1
KR_6764634543,440,4,77,16,12,-1,0,1,4,4,0,6,8,2,3,4,1,0,1,1,1,7,-405,2,1,3,1,0,1,0,1,1,1,0,1
KR_6463194534,420,1,25,5,10,-4,0,4,2,3,1,8,10,2,0,0,0,4,4,0,0,10,-13,-2,6,4,4,0,1,1,-1,-1,1,3,1
KR_6766034119,420,1,-16,-4,5,2,3,1,2,2,0,4,5,1,0,5,5,-3,0,3,0,5,100,0,4,4,5,0,-1,1,1,-1,1,2,1
KR_6767907905,420,4,82,9,2,4,4,0,0,4,4,0,2,2,-2,1,3,0,1,1,1,-8,-8,-4,7,3,4,0,0,-1,1,-1,1,4,1
KR_6713528481,420,2,67,13,2,3,3,0,4,4,0,-2,0,2,0,3,3,-3,4,7,0,4,-22,3,6,9,13,0,0,-1,0,0,-1,6,1
KR_6758218997,440,2,-8,-4,5,2,2,0,2,3,1,4,5,1,-1,1,2,-2,0,2,0,4,-3,-1,7,6,6,0,0,1,1,0,1,3,1
KR_6761426959,440,6,63,-3,16,1,1,0,1,3,2,1,1,0,7,8,1,6,7,1,0,13,-1,-6,7,1,2,0,1,1,1,1,1,5,1
KR_6672539387,420,4,24,4,17,5,6,1,10,10,0,2,4,2,-1,1,2,1,1,0,0,16,4,-1,5,4,-4,0,0,-1,1,0,1,3,1
KR_6742181310,420,2,-66,51,4,-2,2,4,-1,0,1,-2,3,5,6,6,0,3,6,3,1,4,-42,-4,5,1,4,0,0,1,0,1,1,5,1
KR_6741627262,420,-1,-16,3,1,0,1,1,-1,2,3,1,2,1,1,2,1,0,0,0,0,-3,9,3,4,7,-2,0,0,-1,1,0,-1,6,1
KR_6653283194,420,4,73,19,5,1,1,0,1,1,0,7,10,3,-3,4,7,-1,0,1,0,-5,1,3,2,5,3,0,2,-1,1,1,-1,1,1
KR_6763736059,420,-3,-30,-12,-5,1,1,0,-2,1,3,-2,2,4,-2,0,2,0,0,0,0,-4,118,-4,6,2,1,0,0,0,-1,1,-1,0,1
KR_6590017331,420,-1,23,12,-2,3,3,0,-2,1,3,2,4,2,-4,2,6,-1,0,1,-1,-6,-247,-2,7,5,1,0,1,0,-1,1,-1,0,1
KR_6761545825,420,0,21,-24,9,5,5,0,-2,2,4,3,7,4,3,4,1,0,2,2,0,6,4,4,2,6,-3,0,0,-1,0,1,1,4,1
KR_6697960047,440,3,-4,12,7,1,2,1,0,1,1,2,4,2,1,1,0,3,6,3,0,6,-27,0,5,5,12,0,0,1,-1,0,-1,1,1
KR_6631436182,420,2,45,-7,5,5,7,2,0,1,1,1,3,2,-1,3,4,0,1,1,0,10,-41,5,2,7,21,0,-2,-1,1,-1,1,5,1
KR_6693098384,420,0,-33,22,2,3,4,1,-1,4,5,1,3,2,0,0,0,-1,0,1,0,-4,4,4,1,5,1,0,1,1,1,1,1,4,1
KR_6759574211,420,-1,-41,41,-4,-1,0,1,-1,3,4,1,3,2,-2,1,3,-1,1,2,0,2,-2,1,5,6,3,0,-1,1,1,-1,-1,4,1
KR_6737599348,440,-1,-15,6,-1,4,6,2,0,3,3,-3,3,6,-4,2,6,2,2,0,0,9,-7,2,4,6,4,0,1,1,-1,1,-1,1,1
KR_6728538207,440,0,30,24,4,-3,1,4,-3,0,3,4,5,1,4,4,0,2,2,0,0,8,9,4,3,7,4,0,0,1,0,1,1,3,1
KR_6555407351,420,6,57,50,5,2,2,0,-3,2,5,2,4,2,1,2,1,3,3,0,1,3,-11,1,3,4,-1,0,1,1,1,1,1,5,1
KR_6762447511,420,5,30,23,11,6,6,0,1,2,1,3,3,0,1,7,6,0,0,0,0,7,34,-4,6,2,-19,0,2,-1,1,1,-1,5,1
KR_6760988761,420,2,-80,-9,4,1,4,3,1,2,1,-1,3,4,4,6,2,-1,4,5,1,12,10,0,4,4,-4,0,1,1,1,1,1,5,1
KR_6759471127,440,1,29,-19,14,1,5,4,4,4,0,0,2,2,6,6,0,3,6,3,1,11,-2,3,0,3,-1,0,2,1,1,1,1,3,1
KR_6679750571,420,5,45,-5,4,-1,1,2,2,4,2,4,7,3,3,6,3,-4,1,5,2,10,39,1,2,3,1,0,2,1,1,1,1,5,1
KR_6709861326,420,5,93,0,13,9,11,2,-1,1,2,2,6,4,3,4,1,0,1,1,2,9,-16,2,3,5,2,0,3,-1,1,1,1,4,1
KR_6747212508,420,5,56,20,8,3,3,0,-2,0,2,0,1,1,4,4,0,3,4,1,0,8,-11,0,6,6,2,0,0,1,1,0,1,1,1
KR_6737629465,440,4,57,34,-1,0,2,2,-3,1,4,1,3,2,1,3,2,0,1,1,0,-10,1,-4,5,1,-1,0,0,-1,0,0,-1,5,1
KR_6652903740,420,-2,-3,-8,-8,2,3,1,-6,1,7,2,4,2,-4,1,5,-2,1,3,0,-15,-9,0,2,2,-2,0,1,1,1,-1,1,1,1
KR_6712499471,420,4,-11,-16,4,0,0,0,3,6,3,4,5,1,-3,1,4,0,0,0,0,6,-21,0,5,5,1,0,0,1,1,1,-1,6,1
KR_6758242476,420,2,-29,-7,13,3,5,2,3,4,1,0,3,3,6,7,1,1,1,0,0,16,-3,5,1,6,4,0,-1,1,-1,-1,1,3,1
KR_6754719657,420,3,87,44,4,6,7,1,7,7,0,-3,0,3,-4,0,4,-2,0,2,0,-4,44,0,3,3,-6,0,3,1,1,1,1,2,1
KR_6765235416,420,-2,-31,-4,4,-4,1,5,4,5,1,2,2,0,2,3,1,0,2,2,0,3,-12,-4,5,1,2,0,-2,-1,-1,-1,1,5,1
KR_6751322182,420,2,91,-6,5,0,0,0,-2,0,2,2,4,2,4,5,1,1,2,1,0,5,-29,3,3,6,3,0,0,0,1,0,-1,0,1
KR_6714058094,420,3,-7,31,9,1,3,2,4,4,0,3,4,1,1,4,3,0,0,0,0,8,-2,1,1,2,3,0,1,1,0,1,1,5,1
KR_6758937654,420,-3,-53,-54,3,-3,0,3,0,2,2,3,4,1,4,4,0,-1,0,1,0,2,-26,-3,5,2,2,0,0,1,1,-1,1,3,1
KR_6657912854,420,4,14,27,17,1,1,0,10,11,1,4,4,0,3,5,2,-1,0,1,-1,22,2,4,2,6,-3,0,1,1,1,1,-1,5,1
KR_6747331112,420,4,6,6,6,0,2,2,9,9,0,-6,0,6,1,2,1,2,2,0,0,10,-18,-2,5,3,2,0,1,1,1,1,-1,1,1
KR_6741780353,420,-2,-5,-11,0,0,3,3,0,2,2,1,2,1,0,3,3,-1,0,1,2,3,3,1,3,4,6,0,0,1,1,0,1,3,1
KR_6763501885,440,-2,-8,11,-3,-6,0,6,1,3,2,1,2,1,3,5,2,-2,0,2,-2,-5,-3,-1,6,5,0,0,-1,-1,-1,-1,-1,5,1
KR_6593199531,420,6,78,16,12,1,1,0,2,3,1,2,3,1,2,5,3,5,5,0,0,18,-9,3,2,5,3,0,1,1,1,1,1,4,1
KR_6747325217,420,4,42,17,9,-1,1,2,3,4,1,0,2,2,7,9,2,0,0,0,0,10,-7,2,3,5,5,0,0,1,1,1,1,3,1
KR_6757564519,440,7,56,10,8,3,4,1,7,8,1,0,2,2,-1,3,4,-1,3,4,-1,7,8,3,1,4,1,0,3,0,1,1,-1,0,1
KR_6505626588,420,4,59,-16,6,-1,2,3,-1,1,2,0,4,4,5,6,1,3,3,0,0,7,-2,2,4,6,6,0,1,-1,1,1,-1,5,1
KR_6722074085,420,1,39,-18,4,1,3,2,3,6,3,1,4,3,-2,3,5,1,1,0,0,12,3,-1,6,5,1,0,0,-1,-1,0,-1,3,1
KR_6764750480,420,1,56,-28,0,4,4,0,-5,2,7,1,1,0,0,4,4,0,3,3,0,-8,-13,-1,3,2,16,0,1,-1,1,1,1,2,1
KR_6758182312,420,1,43,0,5,6,7,1,2,3,1,1,3,2,-4,1,5,0,0,0,0,-2,-5,-3,6,3,3,0,1,1,-1,1,1,3,1
KR_6755444820,420,2,37,30,2,2,5,3,0,1,1,-3,4,7,-1,1,2,4,6,2,0,-4,-4,-6,9,3,-6,0,2,1,-1,1,-1,4,1
KR_6653350357,420,-1,28,-28,5,-1,0,1,2,5,3,0,1,1,3,4,1,1,1,0,0,13,-97,-1,5,4,-1,0,1,-1,0,1,1,1,1
KR_6482467685,420,4,77,4,5,1,2,1,-1,2,3,5,7,2,0,1,1,0,1,1,0,4,6,-2,3,1,1,0,1,1,0,1,-1,5,1
KR_6748522406,420,4,103,40,2,-3,2,5,-1,0,1,-1,0,1,6,7,1,1,3,2,0,6,5,0,3,3,3,0,3,-1,1,1,1,2,1
KR_6672920087,420,4,18,30,11,7,9,2,1,5,4,3,6,3,0,1,1,0,1,1,1,0,-16,-5,9,4,1,0,2,-1,1,1,1,5,1
KR_6759938132,420,3,37,44,7,2,4,2,-2,1,3,3,4,1,2,3,1,2,6,4,0,-1,341,-3,6,3,2,0,0,1,1,1,1,3,1
KR_6744859924,420,1,-4,-28,-1,2,3,1,5,6,1,-2,2,4,-4,2,6,-2,2,4,0,1,22,-1,6,5,1,0,0,-1,-1,0,-1,1,1
KR_6705682694,420,0,-10,16,-4,1,2,1,-4,2,6,2,3,1,1,4,3,-4,0,4,0,-8,6,3,2,5,-7,0,0,-1,-1,0,1,2,1
KR_6704421759,420,2,-4,0,9,-1,1,2,4,6,2,5,7,2,1,3,2,0,2,2,1,17,1,-1,6,5,1,0,0,0,1,0,1,0,1
KR_6765391859,420,-1,-15,0,-8,-6,1,7,0,2,2,0,6,6,-3,3,6,1,2,1,-1,-3,1,-7,8,1,4,0,-1,0,-1,-1,-1,0,1
KR_6753608294,420,2,2,31,4,-1,0,1,0,1,1,3,4,1,0,3,3,2,3,1,-1,-2,186,3,2,5,4,0,0,1,1,0,-1,3,1
KR_6660908305,420,-2,-87,-2,-1,-7,0,7,3,4,1,0,3,3,-1,3,4,4,4,0,-1,10,13,0,8,8,4,0,-1,-1,-1,-1,-1,1,1
KR_6723088117,420,2,76,-19,9,6,6,0,-2,2,4,2,3,1,3,3,0,0,0,0,0,3,8,2,2,4,-3,0,1,1,1,1,1,3,1
KR_6764751951,420,1,3,-2,2,1,2,1,2,2,0,3,5,2,-3,2,5,-1,0,1,0,-5,4,1,6,7,-1,0,0,-1,-1,1,-1,4,1
KR_6672961107,420,4,112,0,6,1,1,0,0,2,2,1,2,1,4,6,2,0,1,1,0,4,21,-1,4,3,-1,0,1,-1,1,1,1,1,1
KR_6658842722,420,-1,39,-15,0,1,3,2,-1,3,4,-2,2,4,1,3,2,1,1,0,0,3,136,-3,7,4,3,0,1,-1,1,1,-1,4,1
KR_6739524661,420,1,9,14,-4,-3,2,5,1,3,2,-3,0,3,0,2,2,1,1,0,0,2,55,-5,8,3,-8,0,1,1,-1,1,-1,5,1
KR_6694334398,420,0,10,-17,3,0,0,0,1,4,3,1,5,4,0,3,3,1,1,0,-1,8,4,2,4,6,-3,0,0,1,-1,-1,-1,4,1
KR_6741476341,420,-5,-48,-2,0,-5,0,5,5,8,3,-3,1,4,3,5,2,0,1,1,0,8,-4,3,4,7,-4,0,-1,-1,0,-1,-1,2,1
KR_6694030131,420,5,69,12,6,0,2,2,1,4,3,0,3,3,3,3,0,2,2,0,0,3,6,3,2,5,0,0,2,-1,0,1,1,4,1
KR_6679020970,420,4,46,-8,8,2,5,3,2,2,0,0,2,2,5,6,1,-1,0,1,1,8,45,4,3,7,-6,0,2,1,1,1,1,1,1
KR_6765048861,420,1,63,-19,4,-1,0,1,-4,0,4,3,5,2,5,6,1,1,2,1,0,0,-14,2,0,2,2,0,0,1,1,0,1,2,1
KR_6672908666,420,1,57,-23,-2,1,3,2,-1,2,3,-4,1,5,4,6,2,-2,0,2,0,3,-33,3,2,5,2,0,0,-1,-1,1,-1,3,1
KR_6715340649,420,0,-10,8,5,-1,3,4,4,6,2,-1,1,2,-1,5,6,4,4,0,-3,7,2,1,4,5,1,0,1,-1,0,1,-1,3,1
KR_6755402417,420,3,-22,-12,8,0,0,0,1,2,1,6,6,0,-1,0,1,2,2,0,0,6,126,3,2,5,0,0,0,1,1,0,1,1,1
KR_6767785182,420,3,51,25,10,4,4,0,3,4,1,2,3,1,1,3,2,0,3,3,0,4,-123,4,0,4,-1,0,1,1,1,-1,-1,6,1
KR_6755515085,420,6,73,8,10,2,3,1,1,3,2,-2,2,4,9,10,1,0,1,1,0,9,-6,2,4,6,3,0,2,-1,-1,1,1,5,1
KR_6693383224,420,1,-53,-1,0,-1,0,1,-1,1,2,-1,1,2,3,6,3,0,2,2,0,2,-3,0,5,5,2,0,-1,-1,-1,-1,-1,6,1
KR_6706249811,420,0,-20,15,1,1,1,0,0,2,2,3,7,4,1,3,2,-4,0,4,0,-3,-19,-2,4,2,5,0,0,1,1,1,-1,2,1
KR_6724647733,420,2,56,-12,2,-3,4,7,5,7,2,3,4,1,-1,3,4,-2,1,3,0,0,-102,2,2,4,-2,0,3,1,1,1,1,1,1
KR_6755425945,420,6,21,32,1,-1,1,2,2,4,2,1,2,1,0,3,3,-1,2,3,0,-6,14,2,4,6,-5,0,0,1,0,0,-1,4,1
KR_6726465835,440,5,81,28,7,1,2,1,2,5,3,2,5,3,1,4,3,1,2,1,0,6,18,-3,6,3,0,0,2,1,-1,1,1,6,1
KR_6620874050,420,5,95,-19,18,6,6,0,2,3,1,3,4,1,3,3,0,4,4,0,3,20,1,3,4,7,1,0,1,1,1,1,1,4,1
KR_6724566554,440,5,46,-9,13,2,2,0,5,8,3,2,3,1,4,4,0,0,0,0,0,9,1,-2,4,2,2,0,1,0,1,1,1,0,1
KR_6760269895,420,1,-40,-12,1,1,1,0,0,4,4,5,5,0,-1,1,2,-4,1,5,-1,-2,-9,0,4,4,3,0,0,0,1,0,-1,0,1
KR_6760048096,420,5,44,32,8,-4,1,5,-1,1,2,-1,1,2,8,9,1,6,6,0,1,9,3,2,4,6,-2,0,3,1,1,1,1,3,1
KR_6761814691,440,3,74,19,8,1,1,0,-2,0,2,4,5,1,1,3,2,4,4,0,0,11,1,1,3,4,5,0,0,1,1,0,1,6,1
KR_6766485717,420,2,-76,-9,0,-3,0,3,3,5,2,0,2,2,1,3,2,-1,0,1,0,6,-45,-1,4,3,19,0,-1,1,1,-1,1,4,1
KR_6747478614,420,6,64,28,16,3,3,0,6,6,0,-3,2,5,10,11,1,0,2,2,1,20,2,1,4,5,5,0,3,1,1,1,1,5,1
KR_6693514966,420,-2,66,-32,-4,-1,3,4,0,4,4,0,1,1,0,2,2,-3,4,7,0,-4,-1,1,2,3,0,0,0,-1,-1,0,-1,6,1
KR_6720625551,420,1,52,-12,3,4,4,0,-5,4,9,-2,2,4,4,6,2,2,3,1,1,4,-23,2,3,5,1,0,1,1,-1,1,1,5,1
KR_6731822793,420,4,47,4,10,7,7,0,1,2,1,0,3,3,4,4,0,-2,2,4,0,12,-5,1,2,3,1,0,2,1,1,1,1,5,1
KR_6672755275,420,-2,-12,16,-9,-1,1,2,3,4,1,-7,1,8,-1,4,5,-3,0,3,-1,-5,5,0,7,7,-5,0,-1,-1,-1,-1,-1,3,1
KR_6730604278,440,-2,-34,-16,0,-4,0,4,-1,3,4,1,3,2,1,1,0,3,3,0,0,6,-24,3,3,6,8,0,1,1,1,-1,1,3,1
KR_6728530747,420,1,10,-6,5,-2,1,3,4,6,2,-2,0,2,4,5,1,1,1,0,2,8,10,4,5,9,1,0,0,1,-1,0,1,3,1
KR_6738159579,420,0,-11,15,-2,0,2,2,2,5,3,-6,0,6,0,0,0,2,2,0,0,-1,-3,-2,8,6,-1,0,0,1,-1,0,1,2,1
KR_6725582918,420,1,67,32,1,4,5,1,1,3,2,-1,3,4,-4,1,5,1,1,0,1,1,-1,-1,5,4,4,0,-1,-1,-1,-1,1,6,1
KR_6758727852,420,-6,-138,-11,-3,-1,3,4,-3,1,4,0,1,1,0,2,2,1,2,1,0,0,4,0,3,3,-2,0,-2,0,-1,-1,1,0,1
KR_6643934492,440,3,25,28,5,1,2,1,0,2,2,2,5,3,3,5,2,-1,0,1,0,9,-3,-1,5,4,-4,0,0,1,-1,1,1,3,1
KR_6471496801,420,4,-7,-28,11,-1,1,2,10,11,1,-2,3,5,3,4,1,1,2,1,1,17,-1,2,3,5,5,0,1,1,1,1,1,6,1
KR_6632323006,420,6,-33,78,4,-1,0,1,1,2,1,-4,1,5,3,5,2,5,5,0,0,4,10,0,1,1,1,0,1,1,1,1,1,5,1
KR_6704871852,420,0,-19,27,0,-1,1,2,1,3,2,-3,1,4,2,2,0,1,1,0,0,5,3,-2,4,2,-2,0,0,1,1,0,1,4,1
KR_6765613016,420,1,43,-4,2,3,3,0,0,2,2,0,0,0,-1,2,3,0,1,1,0,-1,-15,-2,5,3,3,0,1,-1,-1,1,-1,4,1
KR_6740482942,440,0,-30,-19,1,-2,4,6,-2,1,3,3,4,1,1,2,1,1,1,0,0,2,-10,-1,4,3,7,0,0,0,1,0,-1,0,1
KR_6716616063,420,4,2,24,6,-2,1,3,0,1,1,-1,1,2,6,8,2,3,4,1,0,12,15,3,3,6,-2,0,1,1,0,1,1,4,1
KR_6740819933,420,5,48,76,8,6,6,0,1,2,1,2,4,2,-2,3,5,1,2,1,0,6,-5,-1,3,2,1,0,1,1,1,1,-1,6,1
KR_6708806593,420,-3,-84,5,-10,0,0,0,4,5,1,-6,0,6,-6,0,6,-2,0,2,0,-2,116,-3,7,4,-3,0,-2,-1,1,-1,-1,4,1
KR_6702920854,420,1,2,20,-3,0,2,2,-2,0,2,-1,1,2,2,3,1,-2,0,2,0,-3,37,5,2,7,-14,0,0,-1,1,0,-1,6,1
KR_6762591611,440,2,2,-4,2,2,3,1,2,4,2,-2,1,3,0,3,3,0,0,0,-1,7,5,0,3,3,-2,0,-1,-1,-1,-1,-1,2,1
KR_6692497188,420,0,-36,7,1,-1,0,1,-1,0,1,2,2,0,0,2,2,1,2,1,0,3,-13,-7,12,5,3,0,0,-1,1,0,1,6,1
KR_6750763193,420,0,-14,0,0,-2,1,3,-2,1,3,2,4,2,2,4,2,0,0,0,1,5,31,3,4,7,-11,0,1,1,-1,1,1,5,1
KR_6735327219,420,2,38,28,-2,1,2,1,-2,2,4,-3,1,4,2,4,2,0,1,1,0,-7,0,-3,5,2,0,0,1,1,-1,1,-1,2,1
KR_6733521325,420,5,4,-15,8,0,0,0,1,1,0,5,8,3,2,2,0,0,0,0,0,8,10,2,2,4,-4,0,0,1,-1,0,1,2,1
KR_6608149020,420,1,-33,8,5,0,0,0,-2,2,4,4,5,1,-3,3,6,6,7,1,0,4,9,-4,6,2,4,0,0,-1,1,0,1,5,1
KR_6752589885,440,3,35,36,7,2,2,0,1,2,1,0,3,3,4,5,1,0,1,1,0,6,0,2,0,2,2,0,0,1,-1,0,-1,6,1
KR_6750368554,420,-1,2,-9,-1,-1,4,5,-1,0,1,1,6,5,0,1,1,0,0,0,0,-5,5,1,3,4,-5,0,2,-1,1,1,1,1,1
KR_6646406542,420,0,-3,41,1,-1,3,4,2,4,2,0,0,0,-1,2,3,1,1,0,0,-1,-10,-3,5,2,1,0,0,1,1,-1,-1,5,1
KR_6749130857,420,1,-37,1,10,-1,0,1,6,6,0,1,3,2,2,2,0,2,2,0,0,19,4,-2,5,3,2,0,-1,1,0,-1,-1,2,1
KR_6766092873,420,5,36,32,3,1,1,0,5,8,3,-7,2,9,-1,1,2,5,5,0,0,1,-1,-2,4,2,5,0,-1,1,-1,-1,1,5,1
KR_6692786992,440,7,32,66,8,3,5,2,1,3,2,-2,3,5,0,4,4,6,7,1,0,8,-80,-2,6,4,3,0,5,1,1,1,1,4,1
KR_6763338504,420,2,48,-4,2,2,3,1,-3,0,3,2,2,0,0,0,0,1,1,0,0,2,15,-3,6,3,-1,0,1,1,-1,1,-1,4,1
KR_6761375584,420,1,29,8,9,-1,0,1,2,2,0,1,5,4,4,4,0,3,3,0,0,9,-7,4,1,5,-2,0,0,1,1,0,1,2,1
KR_6762208069,420,5,1,49,21,10,11,1,3,5,2,2,2,0,5,6,1,1,1,0,0,10,-15,-2,4,2,3,0,1,1,1,1,1,3,1
KR_6626380881,420,1,53,24,10,2,6,4,3,4,1,6,6,0,-3,1,4,2,4,2,1,8,-5,0,2,2,-2,0,0,1,1,-1,1,1,1
KR_6767379488,420,0,-26,-19,-1,2,2,0,2,2,0,0,2,2,-3,2,5,-2,0,2,0,0,258,2,3,5,13,0,0,1,1,0,1,6,1
KR_6761922134,420,5,64,19,8,2,3,1,3,5,2,1,1,0,2,2,0,0,1,1,1,9,11,5,0,5,-2,0,2,1,1,1,1,6,1
KR_6705230022,440,-4,-47,3,-2,3,3,0,-1,1,2,0,3,3,0,4,4,-4,3,7,0,0,12,5,5,10,0,0,-2,1,1,-1,-1,2,1
KR_6642178004,420,0,-12,12,2,4,5,1,-1,3,4,-1,1,2,0,3,3,0,0,0,1,4,6,2,2,4,4,0,0,1,1,1,1,4,1
KR_6731791575,420,0,-4,12,1,4,5,1,-2,1,3,-2,3,5,2,4,2,-1,3,4,0,-1,10,5,3,8,2,0,0,-1,1,1,1,3,1
KR_6727317349,420,3,-17,4,4,-4,0,4,3,5,2,2,2,0,-1,3,4,4,5,1,0,8,-2,-4,7,3,3,0,0,-1,-1,0,-1,2,1
KR_6750800416,420,2,-25,35,1,1,3,2,-2,2,4,2,3,1,1,2,1,-1,0,1,-1,3,-8,0,5,5,1,0,0,1,0,0,-1,1,1
KR_6570730128,420,5,92,22,13,2,2,0,2,4,2,3,4,1,3,6,3,3,4,1,0,4,-101,2,5,7,2,0,2,1,1,1,1,6,1
KR_6716331847,440,0,-47,32,0,1,3,2,2,3,1,-1,1,2,-2,3,5,0,0,0,0,-4,25,1,4,5,0,0,0,1,1,1,1,6,1
KR_6649316260,420,-1,25,-8,4,0,1,1,0,1,1,2,3,1,3,3,0,-1,1,2,-1,8,5,3,3,6,-1,0,0,-1,0,0,-1,6,1
KR_6764520134,440,-1,-4,-8,2,2,3,1,0,2,2,-1,0,1,-1,1,2,2,3,1,0,-1,3,2,1,3,1,0,1,-1,1,1,1,5,1
KR_6755845209,420,1,118,-5,0,5,5,0,0,5,5,1,5,4,-4,2,6,-2,0,2,0,-16,13,-4,6,2,-1,0,3,1,1,1,1,2,1
KR_6575358049,420,4,52,-33,9,0,1,1,2,3,1,2,2,0,2,5,3,3,3,0,0,4,5,2,1,3,0,0,0,1,0,1,-1,4,1
KR_6742797456,420,4,66,-12,11,5,6,1,0,3,3,2,2,0,3,3,0,1,2,1,0,8,-10,-6,6,0,4,0,1,1,-1,1,-1,6,1
KR_6768035840,420,4,35,31,2,0,3,3,3,6,3,0,2,2,0,3,3,-1,1,2,0,2,-1,-2,7,5,4,0,0,1,1,-1,1,3,1
KR_6767165249,440,1,38,8,17,2,3,1,4,8,4,3,3,0,7,9,2,1,5,4,2,26,-15,5,5,10,-3,0,1,1,-1,1,1,4,1
KR_6710166885,420,-1,-60,16,-1,-4,0,4,-2,2,4,4,7,3,1,2,1,0,1,1,0,3,-17,2,3,5,4,0,-1,0,-1,-1,-1,0,1
KR_6752923846,420,-2,-76,4,-5,-2,0,2,1,1,0,-2,2,4,-1,1,2,-1,1,2,0,1,-3,0,5,5,4,0,1,1,-1,1,-1,5,1
KR_6741276508,440,1,-28,-4,-1,-1,0,1,2,5,3,0,4,4,0,3,3,-2,1,3,0,4,-16,-5,5,0,3,0,1,1,-1,1,-1,6,1
KR_6765948117,420,3,0,8,7,1,2,1,0,5,5,3,3,0,3,7,4,0,1,1,0,7,2,-2,4,2,0,0,0,-1,0,0,-1,3,1
KR_6757977568,420,-1,-62,-5,5,-1,1,2,7,9,2,-2,4,6,0,2,2,1,1,0,0,10,-4,-5,10,5,-3,0,-1,1,-1,-1,-1,3,1
KR_6745494470,420,1,26,-3,12,-2,2,4,5,7,2,6,7,1,2,3,1,1,1,0,1,22,-3,-1,2,1,1,0,1,1,1,1,1,5,1
KR_6725943972,440,0,-37,37,5,0,0,0,0,1,1,5,6,1,0,3,3,0,0,0,0,2,-212,0,4,4,-4,0,2,-1,1,1,1,4,1
KR_6736248691,420,-1,-7,9,-3,3,4,1,-1,2,3,2,2,0,-7,2,9,0,0,0,0,-9,-1,4,4,8,2,0,0,1,1,-1,1,2,1
KR_6726310626,440,6,72,-13,15,3,4,1,2,2,0,2,3,1,3,4,1,5,5,0,0,18,-1,8,5,13,-6,0,2,-1,1,1,1,1,1
KR_6746044862,420,4,26,9,6,-1,2,3,1,2,1,5,5,0,0,1,1,1,2,1,0,3,3,2,4,6,1,0,2,1,1,1,1,2,1
KR_6733477287,420,1,45,28,-4,-2,1,3,-6,2,8,6,8,2,-1,4,5,-1,2,3,0,-7,23,1,0,1,1,0,0,-1,1,1,-1,2,1
KR_6760345597,440,2,37,19,1,4,4,0,0,2,2,0,4,4,-4,3,7,1,3,2,0,-3,-2,3,3,6,7,0,0,1,0,0,-1,2,1
KR_6664902849,420,1,-16,30,-1,-4,0,4,5,5,0,-1,2,3,2,4,2,-3,1,4,-1,2,1,0,1,1,0,0,0,1,-1,-1,-1,4,1
KR_6703928278,420,6,58,9,15,-1,1,2,-1,2,3,4,5,1,-2,1,3,15,18,3,0,16,-9,4,0,4,1,0,2,1,0,1,-1,2,1
KR_6723531468,420,2,39,13,1,1,4,3,3,3,0,-4,1,5,1,1,0,0,1,1,0,3,3,5,1,6,-2,0,2,1,1,1,-1,6,1
KR_6651437699,420,1,20,-8,7,0,0,0,0,1,1,3,3,0,0,3,3,4,4,0,0,7,22,-1,4,3,2,0,1,0,1,1,1,0,1
KR_6708355821,420,-2,-51,-12,-1,-2,1,3,-1,3,4,0,3,3,1,2,1,1,2,1,-1,11,-2,2,7,9,-2,0,0,1,-1,0,-1,6,1
KR_6710991421,420,0,-28,-7,6,3,3,0,0,0,0,0,5,5,4,4,0,-1,1,2,-1,8,6,7,1,8,-2,0,0,1,1,1,-1,1,1
KR_6764350957,440,6,88,-20,10,-1,2,3,4,5,1,5,8,3,2,2,0,0,1,1,0,10,1,3,3,6,-1,0,0,1,-1,1,1,3,1
KR_6635290519,420,-3,-77,5,-4,-3,0,3,3,6,3,-1,4,5,1,3,2,-4,0,4,-1,-12,-15,4,3,7,-8,0,-2,-1,1,-1,-1,2,1
KR_6767487627,420,-3,-36,32,-5,1,3,2,1,1,0,-2,1,3,-2,1,3,-3,0,3,0,-1,-5,-5,5,0,1,0,-1,1,-1,-1,-1,3,1
KR_6764924731,420,0,1,14,0,1,1,0,-2,1,3,1,5,4,0,1,1,0,1,1,0,-2,21,4,3,7,-1,0,0,1,-1,0,1,2,1
KR_6621579441,420,2,18,25,3,2,3,1,0,2,2,0,3,3,2,3,1,-1,1,2,0,2,-128,1,4,5,0,0,-1,1,1,-1,1,1,1
KR_6615538543,420,3,-36,26,7,4,4,0,2,3,1,0,1,1,-2,0,2,3,4,1,0,3,1,2,4,6,0,0,0,0,1,0,1,0,1
KR_6736931317,440,6,66,-14,19,16,16,0,5,5,0,1,1,0,-8,1,9,5,6,1,0,10,-1,-2,4,2,4,0,3,0,1,1,-1,0,1
KR_6639536581,420,3,35,23,12,0,0,0,8,8,0,0,2,2,2,2,0,2,2,0,0,11,-123,4,1,5,6,0,1,1,1,1,1,5,1
KR_6739689450,420,2,-28,16,9,1,1,0,2,4,2,5,9,4,1,3,2,0,0,0,0,0,4,4,0,4,0,0,0,1,1,-1,-1,1,1
KR_6738513092,420,-1,-35,-42,2,4,4,0,-1,0,1,1,3,2,-1,3,4,-1,0,1,1,2,14,2,3,5,-1,0,1,-1,-1,-1,1,1,1
KR_6751401692,440,1,47,4,7,1,6,5,1,3,2,1,2,1,2,7,5,2,2,0,3,5,4,-2,7,5,-1,0,1,1,-1,1,-1,6,1
KR_6615593533,420,-2,-20,-20,2,-1,1,2,-1,5,6,2,3,1,2,4,2,0,0,0,0,10,10,2,4,6,-5,0,0,1,-1,0,-1,5,1
KR_6760313964,420,6,96,9,17,3,4,1,8,9,1,-1,1,2,4,4,0,3,3,0,0,21,-8,1,5,6,3,0,2,1,1,1,1,2,1
KR_6656309169,420,0,45,-20,-1,-1,0,1,-5,2,7,1,3,2,4,6,2,0,0,0,0,5,-4,1,5,6,1,0,0,1,-1,0,1,2,1
KR_6748948883,420,-2,7,8,-6,2,2,0,-1,2,3,-6,0,6,-3,0,3,2,2,0,-1,-3,42,2,1,3,-26,0,0,-1,1,1,-1,6,1
KR_6726534164,420,2,37,20,-4,3,5,2,-1,1,2,-3,3,6,-3,1,4,0,1,1,0,-10,-55,-3,7,4,4,0,2,-1,1,1,1,1,1
KR_6659385951,420,-2,10,-20,-4,0,2,2,-4,1,5,-2,1,3,0,1,1,2,3,1,0,-3,17,1,4,5,-1,0,-1,-1,1,-1,-1,2,1
KR_6683785741,420,0,63,16,-7,2,3,1,-1,3,4,-3,1,4,-3,1,4,-2,0,2,0,-11,15,-2,7,5,-2,0,2,-1,1,1,-1,2,1
KR_6688088645,420,4,78,44,13,1,2,1,1,1,0,9,9,0,2,4,2,0,2,2,0,3,21,0,3,3,3,0,1,1,0,1,1,5,1
KR_6749541527,440,3,79,-5,6,1,3,2,7,7,0,-2,1,3,-2,1,3,2,2,0,0,6,-23,5,2,7,-1,0,0,1,-1,0,1,2,1
KR_6749807707,420,4,94,27,5,0,1,1,0,3,3,0,2,2,1,5,4,4,6,2,0,4,4,6,3,9,1,0,0,1,0,1,-1,3,1
KR_6767970083,420,-1,5,10,-1,-1,1,2,-5,1,6,4,4,0,0,2,2,1,1,0,0,-6,17,-1,7,6,5,0,0,-1,1,1,1,2,1
KR_6733009299,420,-3,41,0,-11,1,2,1,-4,1,5,-5,2,7,-2,0,2,-1,0,1,0,-10,-13,0,4,4,-4,0,2,-1,1,1,-1,2,1
KR_6713387597,420,4,2,37,15,-1,1,2,9,9,0,0,4,4,7,12,5,0,3,3,3,23,0,2,2,4,1,0,2,1,1,1,1,1,1
KR_6656856994,440,4,52,16,4,0,1,1,4,6,2,3,3,0,0,1,1,-3,0,3,1,6,-15,0,3,3,-1,0,0,1,0,1,1,2,1
KR_5883747205,420,2,7,-23,11,13,13,0,0,0,0,1,2,1,-1,1,2,-2,0,2,0,1,13,0,6,6,1,0,0,-1,1,1,1,4,1
KR_6677421346,420,7,107,34,17,12,12,0,2,2,0,2,3,1,-2,1,3,3,3,0,0,8,-1,1,4,5,3,0,4,1,1,1,1,4,1
KR_6684311945,420,6,29,8,5,5,5,0,-1,5,6,4,4,0,-2,1,3,-1,0,1,0,7,2,1,0,1,0,0,2,1,-1,1,1,6,1
KR_6764204749,420,-1,3,-11,2,-3,1,4,-3,0,3,1,3,2,6,8,2,1,2,1,0,6,53,3,3,6,3,0,0,1,-1,0,-1,6,1
KR_6762202713,420,3,49,19,2,2,3,1,9,10,1,-7,1,8,-5,1,6,3,3,0,0,2,-12,1,3,4,2,0,1,1,1,1,1,2,1
KR_6684152835,420,3,63,4,6,0,2,2,5,5,0,4,5,1,-2,1,3,-1,2,3,0,7,4,2,6,8,-3,0,0,1,-1,1,-1,1,1
KR_6721155841,440,4,93,28,7,3,3,0,0,2,2,0,0,0,6,9,3,-2,0,2,0,5,-9,-1,5,4,4,0,0,1,0,0,-1,6,1
KR_6761389505,420,-1,-6,17,-5,-3,0,3,1,2,1,0,0,0,1,1,0,-4,0,4,0,-3,8,3,3,6,-3,0,0,0,0,0,-1,0,1
KR_6716868523,420,5,125,0,7,1,3,2,0,4,4,-1,1,2,6,6,0,1,2,1,-2,0,7,4,3,7,-4,0,2,-1,1,1,-1,6,1
KR_6732962379,420,5,82,19,7,3,5,2,2,5,3,6,8,2,-2,1,3,-2,1,3,1,-1,8,3,2,5,-4,0,2,1,1,1,1,4,1
KR_6734067600,440,4,13,20,1,-1,0,1,-1,0,1,-1,1,2,5,6,1,-1,0,1,0,4,25,-1,4,3,-3,0,0,1,0,0,-1,5,1
KR_6767077252,420,2,10,0,7,0,1,1,6,7,1,2,4,2,0,2,2,-1,0,1,0,12,1,3,1,4,1,0,0,1,0,0,1,3,1
KR_6766528922,420,2,62,4,7,-1,4,5,0,1,1,1,4,3,7,8,1,0,1,1,-1,6,-7,-1,6,5,-1,0,1,1,1,1,-1,2,1
KR_6765163240,420,-4,-50,-16,-4,-5,1,6,0,5,5,-1,2,3,0,4,4,2,4,2,0,-9,117,-1,7,6,-3,0,1,-1,-1,1,1,6,1
KR_6763213045,420,4,66,-14,11,5,5,0,2,6,4,-2,1,3,4,6,2,2,3,1,0,9,-3,3,1,4,4,0,0,0,-1,0,-1,0,1
KR_6640525266,420,-2,-5,0,-1,1,2,1,-3,0,3,1,1,0,0,0,0,0,0,0,0,-2,-39,-2,5,3,14,0,0,-1,1,0,-1,3,1
KR_6743528772,420,0,-28,-4,1,0,2,2,0,0,0,5,6,1,-5,0,5,1,1,0,-1,-5,-4,2,3,5,-4,0,0,-1,-1,-1,-1,5,1
KR_6755381944,440,4,73,12,6,0,2,2,4,4,0,-3,3,6,-1,5,6,6,6,0,2,12,6,-1,3,2,0,0,0,1,1,0,1,6,1
KR_6681126634,420,0,3,-34,-5,-4,0,4,-5,2,7,1,2,1,-2,2,4,5,6,1,-2,-7,30,-1,6,5,5,0,1,1,-1,-1,-1,4,1
KR_6675951073,420,1,49,-16,7,1,1,0,1,2,1,3,6,3,0,6,6,2,2,0,-1,5,-27,0,7,7,9,0,0,-1,-1,1,-1,6,1
KR_6757832072,420,-1,2,13,-5,-3,0,3,1,4,3,-1,2,3,-2,0,2,0,0,0,0,-6,1,-3,6,3,6,0,0,1,-1,0,1,1,1
KR_6760814711,440,3,22,-4,14,0,1,1,8,8,0,3,5,2,1,3,2,2,2,0,1,16,-4,3,5,8,2,0,0,0,0,0,1,0,1
KR_6760506186,420,3,1,4,8,0,1,1,1,2,1,3,3,0,2,5,3,2,2,0,1,10,-318,2,3,5,0,0,0,1,0,0,1,5,1
KR_6766537430,420,1,60,-12,1,1,3,2,0,2,2,2,3,1,-1,0,1,-1,1,2,0,-3,7,-1,6,5,-6,0,0,1,-1,0,-1,6,1
KR_6737776810,420,3,61,-11,13,2,2,0,1,2,1,6,8,2,3,3,0,1,2,1,0,6,2,4,4,8,0,0,1,1,-1,1,1,2,1
KR_6752380576,420,8,139,8,19,5,5,0,-1,0,1,9,9,0,5,7,2,1,2,1,0,13,7,2,5,7,-2,0,4,-1,1,1,1,5,1
KR_6747014134,420,0,-25,32,-12,-3,1,4,-3,0,3,-3,3,6,-4,0,4,1,1,0,0,-10,2,-2,3,1,0,0,0,1,-1,0,-1,1,1
KR_6636207138,420,1,42,-12,-6,2,3,1,-9,4,13,1,3,2,2,5,3,-2,1,3,1,2,104,4,5,9,-3,0,-1,-1,1,-1,1,4,1
KR_6734948102,420,-1,17,28,-3,-3,0,3,0,3,3,2,3,1,-1,0,1,-1,1,2,0,-6,-16,-1,3,2,1,0,0,1,1,0,-1,3,1
KR_6593782717,420,1,7,-27,2,2,2,0,3,4,1,0,1,1,-1,2,3,-2,1,3,0,-1,-12,-3,4,1,2,0,0,1,-1,-1,1,6,1
KR_6765851496,420,1,48,-7,1,1,3,2,1,4,3,-2,0,2,2,2,0,-1,2,3,0,-4,12,-1,3,2,3,0,0,1,-1,1,1,3,1
KR_6759321120,420,0,-13,-16,-2,5,5,0,2,4,2,-3,3,6,-6,0,6,0,0,0,0,-9,-8,2,3,5,-2,0,1,-1,-1,1,-1,3,1
KR_6738037183,420,-3,-44,-12,-1,-6,0,6,1,3,2,5,7,2,0,1,1,-1,1,2,0,3,7,2,4,6,0,0,-1,1,1,-1,-1,2,1
KR_6767355676,440,0,41,-7,-1,2,2,0,-1,0,1,-1,1,2,-1,2,3,0,0,0,0,2,3,-2,7,5,-4,0,0,1,1,1,-1,1,1
KR_6761290969,420,1,-11,4,-2,-4,0,4,4,5,1,1,1,0,-1,2,3,-2,0,2,-1,8,68,-1,6,5,6,0,-1,1,1,-1,-1,3,1
KR_6648124808,420,3,78,16,-3,5,6,1,0,1,1,-5,1,6,-4,0,4,1,2,1,0,-1,-5,-1,3,2,3,0,1,-1,1,1,1,4,1
KR_6338199532,420,5,47,16,10,0,2,2,2,3,1,5,6,1,3,4,1,0,2,2,0,5,-3,1,2,3,-1,0,2,1,1,1,1,2,1
KR_6767692997,420,4,10,20,9,-3,2,5,1,2,1,0,1,1,11,11,0,0,0,0,0,14,2,0,2,2,1,0,-1,1,-1,-1,1,3,1
KR_6759232259,420,2,3,56,8,-2,0,2,-1,2,3,3,7,4,1,2,1,7,7,0,1,7,15,2,1,3,-4,0,0,1,-1,1,1,4,1
KR_6759847417,440,-1,14,5,3,1,3,2,0,1,1,2,3,1,1,1,0,-1,0,1,0,2,-1,-2,5,3,1,0,0,0,0,0,1,0,1
KR_6764250656,420,-1,-26,16,-4,1,3,2,0,5,5,-2,0,2,-1,3,4,-2,0,2,0,-3,-4,-3,4,1,1,0,1,-1,1,1,1,2,1
KR_6746158375,420,5,26,-13,5,3,4,1,0,1,1,0,0,0,2,3,1,0,0,0,0,4,14,6,3,9,-1,0,0,1,1,0,1,4,1
KR_6615186064,420,-2,-52,31,1,-4,1,5,3,6,3,2,2,0,0,1,1,0,0,0,-2,3,20,6,2,8,0,0,-1,1,1,-1,-1,2,1
KR_6751287036,420,0,77,12,6,0,1,1,7,8,1,-2,1,3,2,4,2,-1,1,2,0,2,0,2,2,4,-3,0,1,-1,-1,1,1,5,1
KR_6671248818,420,6,75,53,12,5,5,0,7,8,1,1,2,1,1,2,1,-2,1,3,1,6,-6,3,2,5,0,0,1,1,1,1,1,1,1
KR_6739939746,420,3,88,41,9,-2,0,2,3,6,3,0,2,2,5,5,0,3,4,1,0,14,8,0,3,3,1,0,3,1,1,1,1,6,1
KR_6761332529,440,4,67,1,10,1,2,1,-2,2,4,3,4,1,6,6,0,2,3,1,0,9,3,0,1,1,3,0,2,1,1,1,-1,4,1
KR_6757747881,420,4,122,4,17,5,7,2,1,2,1,-2,2,4,8,11,3,5,5,0,-1,2,-5,-7,10,3,-2,0,4,-1,1,1,-1,5,1
KR_6709572255,420,2,112,4,-1,-4,2,6,-3,1,4,5,8,3,1,2,1,0,0,0,0,-5,2,5,2,7,0,0,2,1,-1,1,-1,4,1
KR_6761147633,420,1,5,-22,0,-2,1,3,-2,2,4,1,2,1,4,4,0,-1,0,1,0,1,-4,1,5,6,2,0,1,-1,-1,1,-1,6,1
KR_6760364823,440,1,62,32,3,1,1,0,1,3,2,0,2,2,1,2,1,0,3,3,0,0,-5,-1,2,1,-2,0,1,-1,1,1,1,3,1
KR_6663913566,420,4,41,28,6,3,3,0,-2,1,3,2,2,0,4,7,3,-1,0,1,0,-4,7,0,6,6,1,0,1,1,1,1,-1,3,1
KR_6687125850,420,3,48,-20,9,0,1,1,1,1,0,5,6,1,1,3,2,2,3,1,0,17,-62,2,4,6,3,0,0,1,-1,0,1,6,1
KR_6758612674,420,3,33,1,10,3,4,1,-2,0,2,4,4,0,8,9,1,-3,0,3,1,6,7,0,2,2,-1,0,1,1,-1,1,1,3,1
KR_6767450150,420,1,66,3,4,0,4,4,1,1,0,0,3,3,-1,2,3,4,4,0,0,3,185,0,6,6,-4,0,1,-1,1,1,-1,5,1
KR_6682015247,420,-3,-58,-1,-6,-3,1,4,2,6,4,-4,2,6,0,2,2,-1,1,2,0,-2,0,1,7,8,0,0,0,-1,1,-1,1,4,1
KR_6631356587,420,0,33,36,0,-1,0,1,1,3,2,-1,2,3,2,7,5,-1,2,3,0,5,4,-1,6,5,2,0,1,1,0,1,1,1,1
KR_6749847589,420,-3,-37,12,-8,2,5,3,-3,4,7,-3,1,4,-1,2,3,-3,0,3,0,-10,20,1,4,5,0,0,-1,-1,-1,-1,-1,3,1
KR_6652339812,420,3,40,4,8,3,3,0,-2,1,3,4,6,2,4,4,0,-1,0,1,2,8,-176,2,3,5,0,0,1,1,-1,1,1,1,1
KR_6693375308,420,4,27,12,11,4,4,0,-1,3,4,4,5,1,5,6,1,-1,2,3,0,18,-59,2,5,7,8,0,0,1,-1,1,1,1,1
KR_6759158788,420,3,10,-9,10,0,3,3,8,9,1,2,2,0,1,1,0,-1,0,1,1,6,3,3,3,6,4,0,3,-1,1,1,1,2,1
KR_6679671250,420,1,71,-20,-1,3,3,0,-2,1,3,-1,1,2,0,3,3,-1,4,5,0,-1,-15,-2,4,2,-2,0,0,-1,1,-1,1,2,1
KR_6748227953,420,1,57,44,-2,2,2,0,-4,1,5,3,3,0,-3,4,7,0,1,1,0,2,12,7,3,10,-4,0,0,1,0,0,1,1,1
KR_6726038918,420,1,12,24,6,-1,1,2,1,2,1,6,6,0,0,4,4,0,1,1,0,4,11,6,3,9,-4,0,1,1,1,1,1,4,1
KR_6569125820,420,7,72,16,16,1,1,0,5,6,1,5,6,1,4,8,4,1,4,3,0,13,-123,-2,5,3,4,0,3,1,1,1,-1,5,1
KR_6709897612,420,7,65,6,8,4,6,2,4,7,3,-1,3,4,0,2,2,1,2,1,-2,1,-181,-3,7,4,-1,0,1,-1,-1,1,-1,1,1
KR_6760273026,420,-1,2,-35,-2,-1,0,1,-3,2,5,1,3,2,1,6,5,0,3,3,0,-1,2,0,8,8,6,0,0,1,-1,1,-1,1,1
KR_6664576207,420,1,16,12,8,3,3,0,2,3,1,-2,1,3,4,5,1,1,2,1,0,15,1,2,5,7,4,0,1,1,1,1,-1,1,1
KR_6542995869,420,3,5,0,1,-2,2,4,2,4,2,1,7,6,0,1,1,0,3,3,0,2,2,2,6,8,-7,0,-2,1,-1,-1,-1,6,1
KR_6661277458,420,0,52,8,1,3,3,0,1,3,2,-2,4,6,1,4,3,-2,2,4,-2,2,3,0,3,3,3,0,0,1,-1,0,-1,6,1
KR_6763633999,420,-3,-37,-4,-5,-2,1,3,-2,2,4,-1,2,3,1,1,0,-1,0,1,0,-4,6,-4,8,4,-2,0,2,-1,1,1,-1,2,1
KR_6757594550,440,0,-20,21,1,-2,2,4,-1,1,2,-2,1,3,4,4,0,2,2,0,0,4,43,0,4,4,-19,0,-1,0,0,-1,-1,0,1
KR_6748563573,420,2,-65,36,1,-6,0,6,0,2,2,2,3,1,4,5,1,1,1,0,-1,10,41,2,1,3,0,0,0,-1,-1,0,-1,6,1
KR_6665525633,440,-5,-26,-16,-5,-5,0,5,-4,1,5,-1,0,1,4,4,0,1,2,1,0,-4,-7,-5,9,4,1,0,0,-1,-1,0,-1,5,1
KR_6694052243,420,2,-10,32,4,-1,2,3,2,3,1,1,2,1,1,3,2,1,2,1,0,6,1,1,3,4,-3,0,-1,-1,0,-1,1,3,1
KR_6751100797,440,6,69,29,11,1,1,0,3,3,0,5,7,2,0,1,1,2,3,1,0,3,5,3,1,4,5,0,0,1,1,0,1,2,1
KR_6711025838,420,2,62,23,-1,-2,4,6,1,5,4,0,2,2,0,3,3,0,1,1,0,-2,-52,1,3,4,-18,0,1,-1,1,1,1,3,1
KR_6751240720,420,3,1,-7,9,3,4,1,2,5,3,3,3,0,1,4,3,0,1,1,0,23,13,1,4,5,-2,0,2,1,-1,1,1,3,1
KR_6758188205,420,1,-1,12,4,-2,1,3,4,4,0,-1,3,4,1,2,1,2,2,0,2,9,47,0,4,4,-17,0,-1,1,1,-1,1,6,1
KR_6739551462,420,-2,-24,-2,-5,-2,0,2,-4,3,7,-1,1,2,3,8,5,-1,0,1,1,-5,14,-5,7,2,-2,0,-1,1,-1,-1,1,6,1
KR_6761073417,420,2,28,-4,8,2,3,1,2,3,1,-1,2,3,5,8,3,0,1,1,0,2,-2,2,5,7,-4,0,2,-1,1,1,1,6,1
KR_6760462491,420,-1,33,-15,3,2,4,2,2,3,1,-1,0,1,-1,1,2,1,1,0,1,2,-2,-3,7,4,-1,0,0,1,1,1,1,2,1
KR_6765673775,420,0,23,-16,6,1,2,1,0,3,3,2,3,1,3,4,1,0,0,0,0,10,14,1,2,3,0,0,0,-1,1,0,1,4,1
KR_6749127341,420,1,2,-12,4,0,2,2,0,4,4,-2,0,2,5,5,0,1,1,0,0,6,-11,2,2,4,2,0,1,1,1,1,1,3,1
KR_6722218323,420,2,68,11,2,0,1,1,2,4,2,-2,2,4,-1,1,2,3,3,0,0,-1,5,-1,5,4,1,0,0,0,1,1,-1,0,1
KR_6767916120,420,2,16,16,-3,2,2,0,-4,0,4,1,2,1,-2,2,4,0,1,1,0,-6,-1,0,5,5,6,0,1,-1,1,1,-1,6,1
KR_6760660265,420,3,47,16,10,1,3,2,4,5,1,0,5,5,4,5,1,1,2,1,0,15,-7,-2,3,1,2,0,0,1,-1,0,-1,2,1
KR_6694956299,420,-3,-43,-36,4,-3,0,3,2,5,3,-2,2,4,6,7,1,1,2,1,0,10,7,0,4,4,-2,0,-2,0,-1,-1,1,0,1
KR_6748996688,420,0,22,-20,3,-1,3,4,1,6,5,5,6,1,-1,4,5,-1,0,1,3,-1,19,1,2,3,0,0,-1,-1,1,-1,1,3,1
KR_6613088742,420,6,46,51,16,7,7,0,2,6,4,1,2,1,3,5,2,3,4,1,2,9,-2,-4,7,3,3,0,1,1,-1,1,1,4,1
KR_6639963111,420,-1,31,-24,-1,0,1,1,-2,4,6,1,3,2,-2,1,3,2,2,0,1,-9,455,3,1,4,-24,0,0,1,-1,0,1,5,1
KR_6750531722,440,1,-12,16,6,3,4,1,-2,1,3,-1,3,4,4,9,5,2,4,2,0,-9,37,-3,5,2,-19,0,1,0,1,1,1,0,1
KR_6741358994,420,4,48,61,6,5,5,0,2,3,1,1,3,2,0,5,5,-2,0,2,2,3,6,-5,8,3,4,0,1,1,0,1,1,5,1
KR_6765093170,420,8,108,31,16,3,4,1,0,1,1,2,5,3,6,7,1,5,6,1,2,14,6,1,4,5,3,0,3,1,-1,1,1,5,1
KR_6741736532,420,2,5,-7,8,3,3,0,-3,2,5,4,4,0,2,2,0,2,2,0,0,12,0,7,2,9,4,0,-1,1,-1,-1,-1,2,1
KR_6655326410,420,0,-21,4,-1,-2,2,4,2,3,1,-1,0,1,1,4,3,-1,0,1,-1,1,444,4,3,7,4,0,0,-1,1,-1,-1,2,1
KR_6756502897,420,2,34,-4,3,0,1,1,-1,4,5,5,8,3,0,3,3,-1,0,1,0,6,-20,2,3,5,1,0,2,1,-1,1,1,6,1
KR_6719888246,420,4,88,-12,10,2,2,0,3,5,2,1,2,1,5,9,4,-1,0,1,0,1,-20,1,4,5,17,0,1,1,1,1,-1,5,1
KR_6745336076,440,-1,-39,-24,4,1,2,1,0,2,2,1,1,0,-3,0,3,5,6,1,1,8,8,3,1,4,-2,0,0,1,1,0,1,1,1
KR_6645470392,420,3,11,6,10,3,4,1,-3,3,6,8,9,1,3,5,2,-1,1,2,0,10,-65,0,4,4,-1,0,1,1,1,1,1,5,1
KR_6752004590,420,1,-4,-8,6,-1,2,3,2,4,2,-2,2,4,2,3,1,5,5,0,0,14,-10,5,3,8,2,0,0,1,1,1,-1,4,1
KR_6753231525,440,3,12,0,-2,-2,1,3,-5,2,7,2,2,0,2,5,3,1,4,3,0,1,9,0,2,2,3,0,-1,1,-1,-1,-1,2,1
KR_6756111663,420,1,88,62,5,1,2,1,2,5,3,-3,3,6,4,4,0,1,1,0,1,3,-104,-1,2,1,-1,0,4,-1,1,1,1,6,1
KR_6768198259,440,4,76,36,3,0,1,1,1,2,1,1,5,4,2,3,1,-1,0,1,0,4,16,-1,5,4,-3,0,1,1,1,1,1,5,1
KR_6763696476,420,1,19,17,7,2,2,0,3,4,1,0,6,6,0,2,2,2,3,1,0,-2,-10,0,5,5,4,0,0,1,-1,0,1,2,1
KR_6639133050,420,6,88,35,8,3,5,2,0,3,3,2,7,5,3,3,0,0,0,0,0,3,4,2,1,3,0,0,2,1,1,1,-1,6,1
KR_6725003116,420,9,73,43,18,-1,0,1,7,8,1,6,7,1,4,7,3,2,2,0,0,14,-45,-3,6,3,0,0,3,1,1,1,-1,1,1
KR_6728822645,420,-1,-35,3,0,0,0,0,-2,4,6,3,5,2,3,5,2,-4,0,4,0,8,-10,-7,9,2,1,0,-1,-1,-1,-1,-1,3,1
KR_6724204275,420,1,-20,24,2,-2,0,2,-1,1,2,1,3,2,0,2,2,4,5,1,0,-5,-69,-2,6,4,-4,0,-1,1,-1,-1,-1,4,1
KR_6413056349,420,4,108,-7,8,4,4,0,0,4,4,5,5,0,-1,1,2,0,1,1,0,-1,189,-3,5,2,7,0,1,1,1,1,1,6,1
KR_6727609986,420,-1,22,0,0,-1,0,1,-4,0,4,4,4,0,0,6,6,1,1,0,0,-3,35,-2,3,1,0,0,1,1,1,1,1,3,1
KR_6743563052,420,6,69,10,12,3,4,1,5,5,0,1,2,1,1,1,0,2,3,1,0,5,-53,5,3,8,-3,0,0,1,1,1,1,5,1
KR_6660052138,440,4,158,1,12,6,7,1,7,7,0,-1,2,3,-1,1,2,1,3,2,1,9,14,1,2,3,5,0,2,1,1,1,1,1,1
KR_6764781399,420,2,-20,-8,8,2,3,1,-1,1,2,1,1,0,5,5,0,1,3,2,0,10,22,-2,5,3,3,0,0,1,-1,1,1,1,1
KR_6652827448,420,3,55,28,0,-2,0,2,-2,1,3,-2,1,3,5,5,0,1,2,1,0,2,-1,-2,4,2,1,0,1,1,1,1,1,4,1
KR_6745933340,420,0,81,-16,-1,2,3,1,3,4,1,-4,2,6,-2,2,4,0,1,1,0,-3,80,0,6,6,1,0,0,1,1,0,-1,2,1
KR_6742622816,420,2,50,-12,5,1,1,0,8,11,3,-7,1,8,3,5,2,0,2,2,1,18,-108,-4,6,2,1,0,2,-1,1,1,1,6,1
KR_6640059041,420,-1,-17,-24,1,-3,2,5,-1,1,2,1,3,2,4,5,1,0,1,1,0,-1,-296,-3,8,5,-1,0,0,1,-1,0,-1,3,1
KR_6739317362,420,0,-8,-28,2,0,1,1,0,1,1,-2,2,4,5,6,1,-1,0,1,0,-1,-36,3,1,4,22,0,0,1,0,-1,1,3,1
KR_6738249691,420,1,-9,-12,2,-1,1,2,2,3,1,3,6,3,-2,1,3,0,1,1,0,0,12,3,3,6,-2,0,0,1,-1,0,1,3,1
KR_6619470700,420,0,-1,-17,-5,-2,0,2,-2,0,2,-5,0,5,2,5,3,2,2,0,1,-6,41,1,4,5,-12,0,0,0,-1,0,1,0,1
KR_6764913136,440,0,54,24,-2,4,4,0,0,3,3,-1,3,4,-2,1,3,-3,1,4,0,-4,-12,3,1,4,-1,0,0,-1,1,1,1,3,1
KR_6755031649,420,0,-29,4,-3,-4,2,6,1,3,2,2,4,2,0,2,2,-2,0,2,0,5,-12,4,0,4,-3,0,-1,-1,1,1,1,2,1
KR_6738633805,440,5,62,-5,13,2,4,2,2,2,0,3,4,1,5,6,1,1,2,1,0,5,-7,4,0,4,1,0,2,1,1,1,1,3,1
KR_6723745883,420,3,34,4,3,-8,0,8,1,3,2,1,1,0,11,11,0,-2,0,2,1,11,-5,-2,5,3,7,0,0,1,-1,0,-1,6,1
KR_6749065916,420,1,66,0,5,1,3,2,3,5,2,0,4,4,2,5,3,-1,0,1,1,-3,1,-1,3,2,-1,0,0,1,0,0,1,3,1
KR_6682693054,420,1,-10,-25,7,3,3,0,2,3,1,2,2,0,1,2,1,-1,0,1,0,13,11,-3,3,0,1,0,1,-1,1,1,-1,4,1
KR_6743628119,420,4,55,3,9,0,0,0,5,6,1,-3,2,5,3,3,0,4,4,0,0,10,19,2,3,5,-2,0,2,1,0,1,-1,4,1
KR_6564331329,420,-1,33,6,-10,-3,1,4,5,5,0,-6,1,7,-2,5,7,-4,0,4,0,-6,0,4,2,6,-1,0,2,-1,-1,1,-1,1,1
KR_6749585581,420,4,42,41,9,-1,0,1,6,8,2,0,3,3,4,5,1,0,2,2,0,10,-3,0,4,4,1,0,0,1,1,1,1,5,1
KR_6650413955,420,-2,-31,-12,-9,-7,0,7,0,2,2,-1,0,1,-1,2,3,0,2,2,0,-3,-9,-2,6,4,2,0,-1,1,-1,-1,1,2,1
KR_6644591534,420,-4,-75,16,-3,-5,1,6,-2,1,3,0,4,4,1,4,3,3,4,1,1,4,-10,5,0,5,-1,0,-1,1,1,-1,1,1,1
KR_6724065701,420,1,51,-8,4,3,3,0,-2,2,4,1,4,3,2,4,2,0,2,2,0,-6,-1,-3,5,2,4,0,1,1,1,1,1,1,1
KR_6722332087,440,-1,59,-28,-1,0,2,2,0,4,4,4,4,0,-4,2,6,-1,2,3,0,6,12,3,2,5,0,0,0,-1,-1,-1,1,5,1
KR_6761134627,420,1,36,-33,6,-1,1,2,3,5,2,0,1,1,7,8,1,-3,0,3,0,8,-1,5,4,9,1,0,0,1,1,0,1,5,1
KR_6760751957,420,1,-5,2,5,5,6,1,0,0,0,-1,2,3,0,1,1,1,3,2,0,0,29,-1,3,2,0,0,0,-1,0,0,1,4,1
KR_6710646219,420,6,198,15,9,7,8,1,1,2,1,-1,1,2,0,3,3,2,2,0,0,2,-34,5,0,5,-1,0,4,1,1,1,1,4,1
KR_6670691131,420,1,20,0,4,1,3,2,1,3,2,-4,1,5,4,6,2,2,4,2,0,4,-93,2,4,6,-2,0,1,1,1,1,-1,6,1
KR_6764924111,420,0,2,-4,-4,-4,0,4,-1,2,3,0,1,1,1,4,3,0,2,2,0,3,-1,-3,8,5,0,0,1,1,1,1,1,6,1
KR_6744089226,440,7,67,48,21,5,6,1,5,5,0,-2,1,3,10,13,3,3,3,0,0,23,7,1,2,3,0,0,4,1,1,1,1,6,1
KR_6673910775,420,4,76,16,7,4,5,1,4,6,2,-2,1,3,-1,2,3,2,2,0,1,11,2,4,1,5,-1,0,1,1,1,1,1,2,1
KR_6671221029,420,4,-25,13,8,-1,2,3,0,0,0,2,4,2,4,4,0,3,3,0,0,6,45,6,2,8,-3,0,1,1,0,1,1,3,1
KR_6616547329,420,1,3,12,5,-2,1,3,0,6,6,2,5,3,5,5,0,0,3,3,0,-4,285,2,1,3,0,0,1,1,-1,1,1,5,1
KR_6701841251,420,4,80,22,11,2,3,1,4,5,1,1,1,0,2,4,2,2,2,0,0,17,-15,6,1,7,1,0,3,1,0,1,1,4,1
KR_6569913128,420,0,20,8,0,2,4,2,-4,2,6,1,4,3,-1,0,1,2,3,1,0,-6,14,1,3,4,-5,0,0,1,-1,-1,1,3,1
KR_6732919744,420,1,-23,8,2,6,7,1,-2,1,3,-5,2,7,-1,4,5,4,4,0,0,0,14,-1,3,2,3,0,-1,-1,-1,1,-1,6,1
KR_6758098180,420,-1,4,-32,3,2,3,1,-2,0,2,0,3,3,-1,3,4,4,4,0,1,1,-14,-2,4,2,7,0,0,1,-1,1,1,5,1
KR_6764699080,440,1,43,-36,1,2,2,0,-1,1,2,-2,1,3,0,5,5,2,3,1,1,2,2,0,4,4,2,0,0,1,-1,0,1,5,1
KR_6692608945,420,2,80,-7,7,3,4,1,-1,3,4,5,7,2,1,4,3,-1,2,3,0,-2,3,-5,7,2,0,0,1,1,1,1,1,5,1
KR_6759597005,420,3,1,0,6,2,3,1,-3,4,7,1,4,3,5,6,1,1,1,0,0,12,19,-1,5,4,0,0,1,-1,1,1,1,3,1
KR_6754153627,420,0,-35,-19,4,2,3,1,-2,1,3,2,3,1,3,4,1,-1,2,3,0,-1,3,3,1,4,1,0,0,1,1,1,-1,4,1
KR_6744494900,420,3,19,36,6,-1,1,2,2,2,0,4,5,1,1,8,7,0,1,1,0,4,1,2,2,4,1,0,-1,1,-1,-1,1,6,1
KR_6764693596,420,1,62,5,0,1,4,3,1,5,4,-1,1,2,1,2,1,-2,1,3,0,-3,7,4,4,8,0,0,0,-1,0,0,-1,3,1
KR_6758189824,440,2,25,23,6,4,6,2,2,3,1,2,5,3,-2,0,2,0,0,0,0,14,50,-2,5,3,-28,0,2,-1,1,1,1,4,1
KR_6759067706,420,2,6,13,8,3,4,1,2,3,1,2,3,1,2,4,2,-1,1,2,1,3,-51,3,0,3,21,0,0,1,-1,1,1,5,1
KR_6661402611,420,1,-14,4,-4,0,2,2,2,2,0,-3,1,4,-3,1,4,0,0,0,0,-6,29,-10,11,1,-10,0,0,0,1,0,1,0,1
KR_6740920680,420,3,-24,42,12,5,6,1,3,6,3,6,6,0,-2,1,3,0,0,0,0,13,114,4,1,5,0,0,0,1,-1,1,1,6,1
KR_6740100559,420,2,-20,1,6,0,1,1,0,3,3,3,5,2,4,5,1,-1,1,2,1,7,9,0,3,3,0,0,2,1,1,1,1,5,1
KR_6763650900,440,-1,-53,-12,1,2,4,2,-1,2,3,3,3,0,-1,2,3,-2,1,3,0,2,0,-1,8,7,-1,0,0,1,-1,-1,1,1,1
KR_6740547993,420,1,64,44,3,-2,2,4,2,4,2,1,7,6,2,5,3,0,0,0,0,2,-2,0,5,5,0,0,0,1,1,0,1,6,1
KR_6629182043,420,1,-17,28,-2,-6,0,6,0,4,4,-3,1,4,7,8,1,0,0,0,0,6,-5,0,3,3,1,0,0,1,0,-1,-1,1,1
KR_6762075301,420,1,3,-4,7,1,3,2,1,3,2,1,1,0,4,4,0,0,0,0,-1,2,13,2,1,3,-1,0,0,1,1,0,-1,6,1
KR_6624319070,440,-1,4,-29,-7,-3,2,5,-3,2,5,5,10,5,-3,1,4,-3,0,3,0,-13,-8,-1,6,5,0,0,1,-1,1,1,1,2,1
KR_6724772304,420,3,-23,8,10,3,4,1,5,7,2,2,5,3,0,2,2,0,2,2,0,13,78,0,4,4,-3,0,1,1,1,-1,1,2,1
KR_6723548743,420,-4,-41,-17,-12,0,2,2,-7,1,8,-1,1,2,-3,2,5,-1,0,1,0,-11,4,2,5,7,-1,0,-1,-1,-1,-1,-1,6,1
KR_6761385040,420,0,83,-64,6,0,2,2,2,4,2,-5,1,6,9,9,0,0,0,0,0,12,1,-1,3,2,1,0,0,1,1,1,1,2,1
KR_6767080745,420,7,102,33,9,2,3,1,6,6,0,3,3,0,0,2,2,-2,0,2,0,3,9,1,1,2,0,0,1,-1,1,1,-1,4,1
KR_6679269096,420,3,50,12,5,0,2,2,2,5,3,0,2,2,3,3,0,0,0,0,-1,4,-5,-1,4,3,4,0,0,1,0,0,-1,4,1
KR_6766984661,420,-3,-26,-7,-3,3,5,2,-4,1,5,-4,2,6,4,5,1,-2,0,2,-1,-2,-1,-1,3,2,-2,0,-1,-1,1,-1,-1,6,1
KR_6707634692,420,-1,3,-27,3,-2,2,4,0,2,2,1,2,1,4,6,2,0,1,1,0,6,-47,1,4,5,21,0,-1,-1,-1,-1,1,3,1
KR_6767430225,420,3,-6,28,4,-1,1,2,4,4,0,-3,5,8,6,8,2,-2,2,4,0,11,-8,-3,5,2,1,0,-1,1,1,1,1,2,1
KR_6760585376,420,4,29,4,10,-1,2,3,4,4,0,4,4,0,2,2,0,1,2,1,1,9,-9,3,1,4,-2,0,1,1,-1,1,1,3,1
KR_6740566253,420,-1,-20,-4,-3,-1,0,1,-3,3,6,-3,1,4,1,2,1,3,3,0,0,0,-6,1,4,5,-3,0,0,-1,-1,0,1,4,1
KR_6762126849,420,-1,-24,8,0,-1,2,3,3,4,1,3,4,1,-6,0,6,1,2,1,1,5,-34,2,6,8,16,0,0,-1,1,0,1,4,1
KR_6750741367,440,1,41,8,5,0,2,2,0,1,1,1,2,1,3,6,3,1,2,1,0,11,23,-4,6,2,5,0,1,1,1,1,1,5,1
KR_6762745456,420,2,1,19,7,1,2,1,-2,4,6,3,3,0,5,5,0,0,0,0,0,10,3,4,3,7,-4,0,0,1,-1,0,1,4,1
KR_6738355063,440,0,-29,-7,1,-2,1,3,-1,2,3,1,1,0,3,4,1,0,2,2,0,1,140,2,3,5,-16,0,0,0,1,0,1,0,1
KR_6722747575,440,2,-1,38,5,-1,1,2,-2,0,2,3,4,1,5,5,0,0,1,1,0,7,22,5,2,7,-5,0,0,1,0,-1,1,1,1
KR_6727171133,440,7,66,17,16,0,1,1,6,6,0,7,8,1,1,3,2,2,5,3,0,30,2,-4,5,1,3,0,1,1,-1,1,-1,2,1
KR_6755281917,440,6,59,-20,20,4,4,0,3,4,1,-1,4,5,13,16,3,1,2,1,-3,4,16,-2,7,5,4,0,1,0,0,1,-1,0,1
KR_6703691113,420,0,-72,-4,6,0,2,2,5,6,1,-3,6,9,6,11,5,-2,1,3,1,1,-24,-3,5,2,2,0,1,1,0,1,-1,3,1
KR_6764113123,420,0,50,12,-2,-5,1,6,0,1,1,1,5,4,1,2,1,1,2,1,0,-1,1,0,0,0,0,0,0,-1,0,1,1,1,1
KR_6752837404,440,11,169,-9,-3,3,3,0,2,8,6,-1,1,2,-7,2,9,0,0,0,-1,-8,-3,-2,4,2,3,0,4,1,1,1,-1,3,1
KR_6534940204,440,4,58,48,3,2,6,4,0,1,1,3,3,0,0,2,2,-2,3,5,0,-7,21,-5,6,1,3,0,2,1,1,1,1,2,1
KR_6756935407,420,3,75,16,-2,-3,2,5,-4,2,6,2,2,0,5,7,2,-2,2,4,0,-7,-14,1,7,8,-2,0,-1,0,1,-1,-1,0,1
KR_6619650084,420,1,24,3,1,2,2,0,1,3,2,2,4,2,-1,0,1,-3,1,4,0,-5,19,-4,8,4,5,0,0,0,1,0,-1,0,1
KR_6654109770,420,1,-18,18,1,-3,1,4,0,2,2,2,6,4,1,1,0,1,1,0,0,-1,122,2,2,4,-3,0,0,1,1,1,-1,4,1
KR_6759100657,420,-1,-35,12,1,-1,2,3,2,5,3,2,4,2,0,2,2,-2,1,3,0,11,-14,-6,9,3,1,0,-1,1,0,-1,-1,5,1
KR_6684443821,420,2,19,48,-1,-1,0,1,6,7,1,1,5,4,-5,0,5,-2,2,4,0,-6,-3,-2,5,3,0,0,0,1,-1,1,1,3,1
KR_6655016830,420,0,65,-12,7,3,4,1,-3,1,4,-1,1,2,7,8,1,1,2,1,-1,4,-2,-1,4,3,-1,0,0,1,1,1,-1,4,1
KR_6687437540,420,2,-10,-8,1,1,1,0,-2,1,3,1,3,2,4,6,2,-3,0,3,0,-3,-5,0,3,3,0,0,0,1,1,0,1,5,1
KR_6619999180,420,0,-32,32,-1,-2,0,2,-3,2,5,2,5,3,1,2,1,1,3,2,-1,-1,107,3,5,8,1,0,-1,1,1,-1,-1,6,1
KR_6562039849,420,4,57,2,2,-3,1,4,7,8,1,-2,1,3,2,4,2,-2,1,3,0,0,-25,-3,9,6,3,0,1,1,1,1,-1,4,1
KR_6640904764,420,4,70,24,10,1,1,0,5,8,3,0,2,2,4,7,3,0,3,3,1,11,3,2,3,5,1,0,0,1,-1,0,1,1,1
KR_6727110328,420,1,-36,12,2,2,2,0,-2,2,4,-4,0,4,2,3,1,4,4,0,0,2,-23,0,2,2,4,0,0,-1,1,0,-1,1,1
KR_6653669946,440,-1,41,-4,3,2,3,1,2,4,2,-2,1,3,3,3,0,-2,1,3,0,-2,1,2,1,3,-1,0,-1,-1,-1,1,1,1,1
KR_6743843370,420,3,76,-15,8,2,3,1,-1,4,5,3,5,2,3,6,3,1,2,1,0,5,14,0,4,4,-3,0,2,1,-1,1,-1,5,1
KR_6739635986,420,0,-1,-8,2,-1,0,1,2,7,5,-1,1,2,3,3,0,-1,0,1,0,9,-3,3,3,6,-1,0,-1,1,1,-1,-1,3,1
KR_6706736032,420,4,13,27,12,2,2,0,2,3,1,1,1,0,6,7,1,1,2,1,0,8,-5,-2,4,2,1,0,1,-1,1,1,1,2,1
KR_6758473685,420,8,22,19,11,-1,3,4,2,3,1,9,10,1,2,3,1,-1,0,1,-2,2,5,2,5,7,3,0,4,1,1,1,1,5,1
KR_6765428487,420,-2,39,-12,-2,3,4,1,-8,2,10,2,5,3,1,3,2,0,3,3,1,-4,2,0,2,2,2,0,0,-1,1,1,1,6,1
KR_6724273248,420,0,31,23,-6,3,4,1,0,5,5,2,4,2,-4,1,5,-7,1,8,-3,-18,-21,-4,7,3,3,0,-1,-1,-1,-1,-1,2,1
KR_6644824892,420,7,17,28,19,3,4,1,4,7,3,5,5,0,5,5,0,2,3,1,0,15,6,6,3,9,3,0,3,1,0,1,1,6,1
KR_6702991192,420,-2,14,-27,2,3,4,1,-2,2,4,3,4,1,-2,1,3,0,1,1,0,0,0,3,2,5,-3,0,0,-1,1,0,1,3,1
KR_6682395479,440,0,68,-4,-1,-1,1,2,3,5,2,-8,1,9,5,7,2,0,0,0,0,1,4,-1,5,4,-1,0,1,-1,1,1,-1,6,1
KR_6755377826,420,0,14,-33,-1,2,3,1,2,4,2,1,2,1,-2,1,3,-4,1,5,0,-2,3,-2,3,1,0,0,0,1,0,0,-1,4,1
KR_6705465676,440,0,61,-9,-3,2,2,0,-1,1,2,-3,1,4,-1,2,3,0,0,0,0,-7,-2,1,2,3,-2,0,1,-1,1,1,1,4,1
KR_6762220145,420,7,22,-4,17,-3,1,4,0,2,2,6,7,1,13,13,0,1,1,0,-1,18,10,6,1,7,-1,0,1,1,-1,1,-1,4,1
KR_6624716072,420,5,-20,8,13,2,3,1,1,3,2,3,4,1,4,5,1,3,5,2,0,12,-2,-2,4,2,2,0,1,-1,1,1,1,4,1
KR_6755690693,440,5,91,-8,12,7,7,0,5,5,0,0,3,3,-1,5,6,1,1,0,0,7,4,1,4,5,5,0,4,1,1,1,-1,4,1
KR_6725228654,420,4,92,44,12,0,3,3,4,5,1,1,1,0,6,6,0,1,1,0,1,12,8,-2,4,2,-1,0,3,1,1,1,1,5,1
KR_6711500795,440,2,21,-5,7,-2,0,2,2,2,0,-1,1,2,3,3,0,5,7,2,0,5,-3,-4,6,2,3,0,-1,-1,1,-1,-1,4,1
KR_6724726067,420,3,2,12,4,2,4,2,-3,2,5,1,1,0,4,5,1,0,0,0,0,7,-116,3,3,6,-4,0,0,-1,-1,0,1,1,1
KR_6759982014,420,3,-42,16,6,-5,1,6,2,3,1,5,6,1,3,9,6,1,2,1,1,16,11,0,6,6,-4,0,0,1,-1,-1,1,3,1
KR_6508765259,420,2,31,4,7,-3,0,3,-1,1,2,4,4,0,4,6,2,3,3,0,0,8,28,-2,7,5,-22,0,0,1,-1,0,1,4,1
KR_6734511437,420,6,96,24,10,3,4,1,4,4,0,2,2,0,1,2,1,0,2,2,0,9,108,4,1,5,1,0,3,1,1,1,1,5,1
KR_6733166746,420,6,68,12,13,4,6,2,-1,1,2,6,6,0,3,3,0,1,1,0,0,8,3,0,3,3,0,0,2,1,1,1,-1,2,1
KR_6731282918,420,2,2,-15,1,3,3,0,0,2,2,-7,0,7,2,5,3,3,4,1,0,4,24,6,3,9,-4,0,0,-1,1,1,1,6,1
KR_6754127401,440,-1,-55,4,6,0,1,1,-2,2,4,1,3,2,4,5,1,3,3,0,0,8,-6,-1,6,5,1,0,1,-1,1,1,1,1,1
KR_6649940425,420,-2,0,4,-1,-1,0,1,-2,5,7,-1,1,2,2,3,1,1,2,1,1,5,312,0,3,3,1,0,0,1,1,0,1,3,1
KR_6751155908,420,-1,-18,-12,-4,0,1,1,-2,3,5,1,4,3,-2,0,2,-1,0,1,0,-10,7,1,2,3,-2,0,-1,-1,-1,-1,-1,2,1
KR_6768369647,420,-1,20,-8,3,2,3,1,3,5,2,-1,1,2,1,4,3,-2,1,3,1,-6,-5,-4,5,1,2,0,0,1,1,0,1,1,1
KR_6715430380,420,-1,-8,-1,2,-2,2,4,0,3,3,0,5,5,3,4,1,1,1,0,1,9,16,3,0,3,3,0,0,1,1,1,1,3,1
KR_6693403130,420,-1,-7,-8,-2,1,2,1,-5,1,6,-1,2,3,2,4,2,1,2,1,0,-9,-56,-3,5,2,37,0,0,-1,-1,0,1,1,1
KR_6762271027,440,2,-4,5,10,3,3,0,2,2,0,2,3,1,2,4,2,1,1,0,0,8,14,-1,4,3,2,0,0,1,1,0,1,3,1
KR_6631252070,420,2,50,4,5,2,3,1,-1,2,3,1,4,3,0,4,4,3,3,0,0,5,6,4,4,8,1,0,0,-1,-1,0,1,2,1
KR_6765790703,440,3,37,-39,5,2,3,1,-3,0,3,2,5,3,1,1,0,3,3,0,0,-3,-1,-3,6,3,0,0,1,-1,1,1,1,5,1
KR_6743626303,420,0,29,-4,1,-2,1,3,-2,1,3,1,2,1,3,3,0,1,2,1,0,1,-8,-2,3,1,-3,0,1,-1,-1,1,-1,5,1
KR_6737839283,420,-1,-24,-32,-4,0,1,1,-8,1,9,-1,3,4,3,4,1,2,3,1,0,-4,7,3,1,4,0,0,0,1,-1,-1,1,1,1
KR_6737769212,440,7,64,8,18,-2,2,4,1,2,1,12,12,0,5,5,0,2,2,0,-1,21,-6,-1,3,2,2,0,1,0,1,1,-1,0,1
KR_6765504598,420,0,32,3,0,2,3,1,-1,1,2,0,4,4,-1,0,1,0,2,2,0,-3,-135,-3,6,3,2,0,1,1,1,1,-1,6,1
KR_6715262485,420,-2,-70,-22,-2,-1,3,4,-1,1,2,-2,0,2,-2,3,5,4,6,2,0,0,-38,2,6,8,32,0,0,1,-1,0,1,2,1
KR_6741351764,420,4,26,39,13,0,2,2,4,5,1,2,2,0,6,6,0,1,1,0,0,13,-2,-1,6,5,3,0,2,1,1,1,1,5,1
KR_6762923882,420,-1,-4,20,5,-2,0,2,1,4,3,-1,2,3,6,6,0,1,1,0,0,11,-6,-2,5,3,0,0,1,1,1,1,1,4,1
KR_6732460278,420,6,32,19,16,0,0,0,1,4,3,5,7,2,7,8,1,3,4,1,0,13,-27,4,3,7,-1,0,2,0,1,1,1,0,1
KR_6765332164,420,-1,-26,12,-11,-8,1,9,-5,2,7,3,4,1,-2,1,3,1,3,2,0,-7,0,-3,7,4,0,0,-2,-1,-1,-1,-1,1,1
KR_6662602588,420,1,-12,24,-3,1,1,0,-6,2,8,1,3,2,-1,0,1,2,2,0,0,-6,3,2,3,5,-1,0,0,1,1,-1,1,1,1
KR_6765331563,420,0,-23,-9,2,2,3,1,-5,2,7,5,6,1,-1,1,2,1,3,2,0,5,-40,-1,4,3,22,0,0,1,1,0,-1,2,1
KR_6737297867,420,2,-71,-4,-2,-1,3,4,2,4,2,-8,1,9,2,8,6,3,3,0,0,-1,-71,0,7,7,-2,0,-1,-1,1,-1,1,4,1
KR_6761082485,440,0,18,4,4,0,2,2,-4,3,7,2,2,0,4,5,1,2,4,2,-1,5,-36,-4,5,1,-3,0,0,-1,-1,1,-1,1,1
KR_6764969803,420,2,20,-8,1,-1,2,3,-2,3,5,2,2,0,2,2,0,0,2,2,0,3,-13,0,2,2,-5,0,0,1,-1,0,-1,1,1
KR_6648069122,420,2,56,40,8,-1,0,1,8,8,0,-3,1,4,2,3,1,2,4,2,0,17,2,2,6,8,2,0,1,1,0,1,1,5,1
KR_6725738555,420,3,56,-8,8,2,5,3,3,4,1,-1,0,1,4,4,0,0,0,0,0,8,10,8,1,9,2,0,2,1,1,1,1,4,1
KR_6652402863,420,1,-23,20,5,2,3,1,-4,1,5,2,5,3,1,4,3,4,4,0,1,-4,14,1,6,7,-1,0,-1,-1,-1,-1,1,5,1
KR_6727861389,420,-1,34,28,-2,-4,1,5,4,4,0,2,3,1,-3,0,3,-1,0,1,0,2,38,2,3,5,-24,0,1,1,0,1,-1,5,1
KR_6767655210,420,4,46,43,4,1,2,1,0,3,3,8,9,1,-4,1,5,-1,0,1,0,-3,6,1,3,4,-2,0,0,-1,1,1,-1,1,1
KR_6567834625,420,1,42,-9,-6,-1,1,2,0,4,4,-3,0,3,-2,0,2,0,0,0,0,-8,8,0,8,8,-1,0,0,-1,0,1,1,4,1
KR_6764726615,420,1,55,-17,7,6,7,1,-4,1,5,3,4,1,1,2,1,1,1,0,0,6,39,3,6,9,-22,0,2,1,1,1,1,2,1
KR_6759334608,420,3,-15,-16,9,5,5,0,-1,0,1,1,3,2,6,8,2,-2,2,4,0,9,2,3,3,6,-2,0,0,-1,-1,0,1,4,1
KR_6765974880,440,3,-26,-4,4,2,3,1,3,5,2,1,2,1,-1,3,4,-1,0,1,0,1,0,-2,4,2,6,0,0,-1,1,1,1,3,1
KR_6739149983,420,3,3,40,-1,0,1,1,5,5,0,-2,0,2,-3,5,8,-1,0,1,1,1,3,-1,5,4,6,0,0,-1,-1,0,1,4,1
KR_6762051774,420,0,22,16,-2,1,3,2,-2,1,3,1,3,2,-1,1,2,-1,2,3,0,-3,0,-1,3,2,3,0,0,1,1,0,-1,2,1
KR_6732378167,420,2,102,-3,3,2,3,1,1,1,0,1,2,1,0,0,0,-1,0,1,0,-4,51,3,2,5,-24,0,1,0,1,1,-1,0,1
KR_6482507587,420,2,22,-4,2,2,3,1,2,5,3,1,3,2,-4,2,6,1,2,1,0,-8,2,0,4,4,0,0,3,1,1,1,-1,6,1
KR_6742209146,420,4,58,4,13,1,2,1,-3,0,3,1,1,0,14,14,0,0,0,0,0,9,6,1,5,6,-4,0,1,-1,-1,1,1,1,1
KR_6763674903,420,5,60,-20,13,2,5,3,4,8,4,5,5,0,0,1,1,2,3,1,0,9,17,5,1,6,-3,0,2,1,1,1,1,2,1
KR_6687303205,420,2,67,29,-1,-2,1,3,-1,0,1,1,3,2,-1,2,3,2,2,0,0,-4,42,0,4,4,-31,0,1,1,0,1,1,2,1
KR_6750726887,420,5,74,5,7,2,2,0,-3,2,5,3,4,1,3,5,2,2,4,2,-2,-2,-6,4,2,6,2,0,1,1,1,1,-1,4,1
KR_6767228691,440,1,96,-12,-1,-3,3,6,4,6,2,1,3,2,-3,1,4,0,0,0,1,-3,-47,-1,5,4,-2,0,1,-1,0,1,1,3,1
KR_6765014539,420,1,38,-8,5,3,5,2,0,2,2,1,2,1,2,2,0,-1,0,1,0,2,-48,-5,6,1,28,0,1,-1,-1,1,1,5,1
KR_6767473975,420,1,-30,16,3,-2,0,2,4,7,3,1,6,5,-3,3,6,3,4,1,0,3,6,5,3,8,-1,0,1,1,-1,1,-1,5,1
KR_6761436450,440,0,-13,12,0,-1,0,1,0,4,4,2,2,0,0,2,2,-1,1,2,0,2,2,-1,8,7,0,0,1,-1,-1,1,-1,6,1
KR_6642142309,420,0,47,-12,0,1,1,0,1,4,3,2,2,0,-4,0,4,0,0,0,0,2,-8,-4,5,1,3,0,0,1,-1,0,-1,5,1
KR_6602490319,420,3,1,8,9,1,1,0,4,5,1,3,6,3,3,4,1,-2,0,2,0,10,2,5,2,7,2,0,0,1,-1,0,-1,6,1
KR_6624590805,420,5,63,4,11,8,9,1,1,4,3,-2,0,2,4,10,6,0,1,1,1,12,2,1,2,3,1,0,2,1,1,1,1,1,1
KR_6713290578,420,-1,31,-15,-2,0,3,3,2,4,2,-4,1,5,-2,3,5,2,2,0,1,-3,7,2,2,4,-2,0,0,1,1,1,1,2,1
KR_6759087798,440,-2,27,4,-1,1,2,1,-1,0,1,-2,3,5,0,3,3,1,1,0,0,-1,21,4,0,4,5,0,1,1,1,1,-1,2,1
KR_6685013516,420,3,97,-8,12,2,2,0,0,2,2,4,5,1,1,3,2,5,8,3,1,14,4,4,0,4,3,0,1,-1,1,1,1,3,1
KR_6750870184,420,2,54,24,6,-1,1,2,3,4,1,6,8,2,0,5,5,-2,0,2,0,0,-71,2,1,3,-4,0,0,1,1,1,1,2,1
KR_6763398719,440,10,143,60,26,7,8,1,7,9,2,2,3,1,7,8,1,3,3,0,3,36,-2,-1,3,2,4,0,2,1,1,1,1,3,1
KR_6763895973,420,3,10,-19,8,-2,2,4,7,7,0,1,4,3,1,3,2,1,1,0,0,11,-3,-2,5,3,1,0,2,1,-1,1,1,5,1
KR_6694201995,420,0,47,-2,0,4,4,0,-3,0,3,-3,1,4,0,1,1,2,3,1,1,-5,-5,-6,9,3,1,0,0,-1,0,0,1,1,1
KR_6762707277,420,2,25,24,1,2,3,1,0,4,4,1,2,1,0,2,2,-2,1,3,3,7,-4,1,3,4,1,0,2,-1,1,1,1,4,1
KR_6753994126,420,3,34,21,2,-3,1,4,4,7,3,2,7,5,-4,3,7,3,3,0,-1,4,-5,-6,8,2,1,0,2,-1,1,1,-1,1,1
KR_6619422151,420,-3,-50,12,-4,-7,1,8,0,3,3,4,5,1,-1,0,1,0,1,1,2,1,-12,-2,4,2,4,0,-1,-1,1,-1,1,6,1
KR_6745100980,420,4,-24,39,0,-2,2,4,1,3,2,1,3,2,1,4,3,-1,0,1,-1,0,12,-3,5,2,1,0,0,1,1,0,-1,3,1
KR_6753011712,440,-3,37,-42,-12,0,1,1,-4,1,5,-5,2,7,-2,4,6,-1,2,3,1,-10,-3,0,2,2,2,0,-2,-1,-1,-1,1,3,1
KR_6761532814,420,0,14,4,-2,2,2,0,-2,0,2,-3,0,3,1,1,0,0,0,0,0,-3,120,3,5,8,-4,0,1,-1,-1,1,-1,5,1
KR_6761055620,420,0,69,-9,1,1,1,0,-3,5,8,-2,3,5,5,6,1,0,1,1,3,6,32,-1,7,6,-18,0,1,-1,-1,1,1,6,1
KR_6617859337,420,5,50,53,8,1,2,1,0,3,3,-2,1,3,7,7,0,2,2,0,0,2,2,5,2,7,-3,0,1,1,1,1,-1,6,1
KR_6748029574,420,2,68,28,6,8,8,0,2,5,3,1,4,3,-6,1,7,1,1,0,1,-3,141,1,5,6,-2,0,1,1,1,1,1,3,1
KR_6751989928,420,0,67,-16,1,-2,2,4,-2,2,4,0,3,3,3,6,3,2,2,0,1,4,-9,-5,8,3,4,0,-1,1,-1,-1,1,3,1
KR_6739780114,420,3,78,24,5,2,3,1,2,5,3,-2,2,4,-1,1,2,4,4,0,0,5,-7,1,5,6,-3,0,2,-1,1,-1,1,5,1
KR_6758705894,420,1,0,-12,4,2,3,1,4,6,2,1,2,1,-2,0,2,-1,0,1,0,13,-5,0,5,5,0,0,-1,1,1,-1,-1,2,1
KR_6647488979,420,5,50,44,12,-4,1,5,1,2,1,3,4,1,10,11,1,2,2,0,0,13,9,2,6,8,3,0,2,1,1,-1,1,3,1
KR_6766043901,420,4,69,47,10,2,3,1,2,2,0,0,0,0,6,6,0,0,0,0,0,11,-12,5,3,8,6,0,1,1,0,1,1,1,1
KR_6663914130,420,0,38,4,-3,1,2,1,-4,2,6,-2,1,3,4,4,0,-2,0,2,0,0,-31,3,2,5,28,0,1,1,-1,1,-1,4,1
KR_6548202319,420,0,33,-56,3,-2,0,2,-4,0,4,6,6,0,3,5,2,0,0,0,-1,1,0,0,7,7,5,0,2,0,0,1,-1,0,1
KR_6759462930,420,-3,-40,-20,-7,-3,0,3,1,2,1,-4,0,4,0,2,2,-1,1,2,0,-2,-24,-1,2,1,0,0,-1,-1,1,-1,-1,5,1
KR_6761007677,420,3,51,17,2,0,2,2,2,3,1,-1,3,4,0,2,2,1,2,1,0,-2,142,2,2,4,3,0,1,1,1,1,-1,1,1
KR_6684585644,420,3,39,-34,9,5,6,1,1,1,0,0,1,1,-1,2,3,4,4,0,0,8,15,-1,2,1,-2,0,2,-1,1,1,1,1,1
KR_6733272036,420,0,-24,3,0,-1,0,1,-1,2,3,3,3,0,1,1,0,-2,0,2,0,5,38,1,4,5,0,0,-1,1,1,1,1,6,1
KR_6751939884,420,3,28,14,4,1,1,0,1,3,2,0,2,2,1,2,1,1,1,0,0,3,-33,-2,5,3,3,0,0,-1,1,0,1,5,1
KR_6654462966,420,0,-15,-3,0,1,1,0,3,5,2,-4,1,5,0,3,3,0,1,1,-2,-8,-5,-1,5,4,8,0,0,0,1,0,-1,0,1
KR_6730809953,420,3,34,0,-1,0,3,3,-1,5,6,-3,1,4,1,4,3,2,2,0,0,-1,4,9,0,9,-3,0,0,1,0,0,-1,4,1
KR_6710346022,420,4,75,29,5,3,4,1,2,3,1,0,1,1,-1,1,2,1,1,0,0,7,8,-2,4,2,2,0,4,1,1,1,1,3,1
KR_6648593662,420,2,72,4,4,0,1,1,0,3,3,-2,0,2,5,8,3,1,2,1,0,7,10,2,4,6,1,0,1,-1,-1,-1,1,4,1
KR_6642252336,420,3,100,40,-3,-1,0,1,0,1,1,2,3,1,-4,0,4,0,0,0,0,-8,-4,-4,7,3,3,0,0,1,1,0,-1,5,1
KR_6692211468,420,5,42,15,11,5,6,1,-1,4,5,1,2,1,5,6,1,1,4,3,1,15,6,2,5,7,3,0,1,-1,-1,1,1,5,1
KR_6765643602,440,6,1,28,12,1,2,1,2,3,1,-4,3,7,10,10,0,3,5,2,0,14,7,0,1,1,1,1,3,1,1,1,1,2,1
KR_6764593744,420,-2,41,-10,4,-2,1,3,2,3,1,2,2,0,2,3,1,0,1,1,0,5,5,0,3,3,2,0,0,0,-1,0,1,0,1
KR_6642663012,420,5,49,27,12,1,2,1,5,7,2,4,7,3,2,4,2,0,0,0,0,18,-3,1,3,4,-1,0,2,1,1,1,1,1,1
KR_6768248888,440,3,-31,-9,11,4,5,1,3,4,1,3,4,1,-1,1,2,2,2,0,0,7,-13,1,3,4,-1,0,0,1,1,0,-1,4,1
KR_6707573269,420,-2,6,-7,-4,-3,1,4,4,5,1,-3,0,3,-1,2,3,-1,0,1,1,-2,7,-1,5,4,-1,0,0,-1,-1,-1,1,5,1
KR_6679299501,420,4,63,12,5,4,5,1,1,3,2,4,6,2,-4,2,6,0,0,0,0,8,11,5,6,11,2,0,0,-1,0,1,-1,2,1
KR_6709297192,420,4,42,0,7,-1,0,1,3,6,3,3,4,1,2,5,3,0,1,1,0,7,-8,-3,5,2,-1,0,1,-1,-1,1,1,3,1
KR_6744828822,420,1,8,29,13,4,5,1,2,4,2,2,5,3,5,6,1,0,0,0,0,10,306,2,4,6,-1,0,1,1,1,1,1,2,1
KR_6725032294,440,7,112,60,19,5,5,0,5,5,0,8,10,2,3,5,2,-2,0,2,0,4,6,1,3,4,-3,0,2,1,1,1,1,4,1
KR_6763775308,420,0,-24,-7,-2,-2,1,3,3,7,4,-4,2,6,1,2,1,0,0,0,0,5,9,5,1,6,-2,0,-1,1,1,-1,-1,4,1
KR_6665914994,420,0,43,-8,3,-2,1,3,2,2,0,4,6,2,-1,4,5,0,1,1,0,4,-37,-1,6,5,0,0,1,1,-1,-1,1,2,1
KR_6667638464,420,3,13,18,6,-2,0,2,7,8,1,-2,3,5,0,0,0,3,3,0,0,7,7,5,3,8,-2,0,1,-1,1,1,-1,3,1
KR_6759915508,420,4,43,18,8,0,1,1,3,4,1,2,2,0,2,2,0,1,1,0,0,9,82,-3,4,1,2,0,0,-1,0,1,-1,3,1
KR_6467695622,420,2,51,-1,2,-1,3,4,1,2,1,-3,1,4,4,4,0,1,1,0,1,9,-46,-3,5,2,12,0,0,1,-1,-1,1,4,1
KR_6662044711,420,4,69,40,3,2,2,0,-1,4,5,-1,0,1,3,4,1,0,0,0,0,1,-8,-4,6,2,5,0,0,-1,1,-1,1,5,1
KR_6713973756,420,-2,-48,-9,2,-7,0,7,-1,2,3,15,15,0,-5,2,7,0,2,2,3,1,3,-4,9,5,-2,0,-2,-1,1,-1,-1,2,1
KR_6761576225,420,1,18,2,-1,2,3,1,-4,2,6,-3,1,4,4,6,2,0,1,1,0,-2,-258,0,3,3,1,0,0,-1,-1,0,-1,6,1
KR_6761442697,420,7,166,-2,9,4,4,0,0,2,2,-1,3,4,8,8,0,-2,1,3,0,8,44,-1,4,3,-14,0,1,-1,-1,1,-1,5,1
KR_6760062549,420,-2,27,19,-4,-2,1,3,-2,0,2,-3,0,3,3,3,0,0,0,0,0,0,5,0,4,4,0,0,2,1,1,1,-1,4,1
KR_6622659144,420,5,56,11,14,4,4,0,1,5,4,1,1,0,6,7,1,2,2,0,3,17,1,0,1,1,3,0,3,1,1,1,1,4,1
KR_6763002423,420,-1,-6,-24,4,-1,3,4,2,3,1,-2,0,2,5,7,2,0,0,0,-1,6,-2,-5,8,3,8,0,-1,1,-1,-1,-1,3,1
KR_6760501133,420,-2,-30,16,-2,-1,2,3,2,2,0,3,3,0,-5,1,6,-1,0,1,1,-3,-51,-3,5,2,24,0,-1,1,-1,-1,1,3,1
KR_6760776191,420,-2,-17,20,-5,0,2,2,1,1,0,-5,0,5,-2,3,5,1,2,1,0,-4,27,-3,4,1,-5,0,0,-1,-1,-1,1,5,1
KR_6624662254,420,7,75,11,16,1,5,4,1,1,0,1,3,2,15,15,0,-2,1,3,0,6,2,2,2,4,0,0,2,1,1,1,1,1,1
KR_6755953462,420,3,-5,33,8,1,2,1,-2,0,2,2,4,2,6,8,2,1,2,1,0,7,5,1,7,8,0,0,2,1,1,1,1,3,1
KR_6762839516,420,3,4,48,2,1,2,1,1,5,4,2,3,1,2,2,0,-4,0,4,0,-1,-28,1,5,6,23,0,-1,1,-1,-1,-1,5,1
KR_6615731185,420,-1,-39,9,3,3,3,0,-1,2,3,0,3,3,0,0,0,1,1,0,0,2,32,3,2,5,-15,0,-1,0,1,-1,1,0,1
KR_6731905722,420,0,-37,16,2,3,4,1,1,3,2,0,6,6,-2,4,6,0,1,1,0,8,-13,-1,10,9,6,0,1,-1,1,1,1,4,1
KR_6755238331,420,5,89,20,10,1,1,0,7,7,0,-1,4,5,4,5,1,-1,2,3,0,1,-157,5,3,8,1,0,1,1,0,1,1,4,1
KR_6687934077,420,6,66,3,11,-1,1,2,4,6,2,2,2,0,7,8,1,-1,1,2,0,13,52,6,4,10,2,0,2,1,-1,1,1,3,1
KR_6762575254,420,5,55,8,13,-2,1,3,2,6,4,4,7,3,4,4,0,5,7,2,1,16,2,5,0,5,0,0,2,1,1,1,1,2,1
KR_6755915778,420,0,-10,-32,-1,2,3,1,0,3,3,0,1,1,-2,3,5,-1,1,2,-1,-3,-127,-4,8,4,0,0,1,-1,1,1,-1,4,1
KR_6767205194,440,3,-4,17,11,4,6,2,7,7,0,-3,2,5,4,5,1,-1,1,2,0,3,-7,-1,2,1,3,0,2,0,0,1,1,0,1
KR_6732773248,420,1,22,-8,4,2,2,0,2,2,0,2,4,2,-2,2,4,0,0,0,1,5,-76,-1,6,5,38,0,0,1,-1,-1,1,4,1
KR_6630471503,420,6,25,32,10,2,4,2,4,7,3,-5,1,6,8,8,0,1,1,0,2,11,-23,5,1,6,0,0,2,1,1,1,1,4,1
KR_6646299036,420,3,-24,2,1,1,2,1,3,5,2,2,5,3,-5,2,7,0,1,1,0,4,0,-1,3,2,0,0,0,-1,1,-1,1,5,1
KR_6767064632,420,2,-53,-12,6,0,3,3,-1,0,1,5,8,3,1,5,4,1,2,1,-1,14,-2,1,2,3,-1,0,-1,1,1,1,-1,3,1
KR_6693704842,420,4,91,8,12,5,5,0,-3,0,3,3,3,0,6,8,2,1,1,0,1,10,-109,1,3,4,5,0,2,1,1,1,1,3,1
KR_6682284392,420,0,8,-36,-1,3,4,1,-4,4,8,0,2,2,2,4,2,-2,0,2,0,-9,2,-2,5,3,1,0,0,-1,-1,1,1,6,1
KR_6655190463,420,0,-27,1,1,5,5,0,-2,2,4,-2,0,2,2,4,2,-2,2,4,0,10,329,2,4,6,5,0,1,1,1,1,1,3,1
KR_6607647068,420,4,47,51,7,-1,2,3,1,3,2,5,8,3,-2,4,6,4,5,1,-2,4,-8,-6,9,3,3,0,1,1,1,-1,-1,6,1
KR_6760336134,420,1,36,-12,12,2,2,0,1,4,3,7,9,2,1,4,3,1,1,0,0,4,-21,5,2,7,-3,0,1,0,1,1,1,0,1
KR_6719820852,420,7,170,20,3,3,3,0,-1,1,2,0,0,0,1,1,0,0,0,0,0,2,9,1,2,3,3,0,2,1,-1,1,1,6,1
KR_6706841456,420,1,-69,8,4,5,5,0,-1,2,3,1,3,2,-3,2,5,2,3,1,0,4,12,1,3,4,-8,0,0,1,1,0,-1,2,1
KR_6725655484,420,2,5,-12,3,-2,0,2,5,7,2,0,3,3,-2,2,4,2,2,0,1,9,-1,3,4,7,-1,0,0,-1,-1,0,1,3,1
KR_6768374313,420,-2,-35,-14,2,-1,4,5,0,1,1,3,4,1,-1,1,2,1,2,1,-1,3,-7,-4,5,1,5,0,0,1,-1,-1,1,6,1
KR_6643226735,420,-3,48,-2,-6,0,1,1,0,1,1,-3,0,3,-3,0,3,0,0,0,0,-4,-16,-1,5,4,0,0,0,-1,1,1,1,5,1
KR_6684480354,420,3,27,51,8,-1,3,4,2,2,0,4,4,0,5,5,0,-2,2,4,0,4,14,-2,4,2,2,0,0,1,-1,-1,1,4,1
KR_6712278065,440,2,-16,12,8,-1,0,1,3,4,1,2,3,1,5,5,0,-1,0,1,0,13,-11,-2,4,2,-1,0,0,-1,-1,0,1,4,1
KR_6752476477,440,1,31,9,3,-1,1,2,-1,3,4,1,1,0,1,3,2,3,3,0,0,1,-6,0,6,6,4,0,0,1,1,0,-1,2,1
KR_6758739084,420,5,68,9,10,4,5,1,0,3,3,3,3,0,4,5,1,-1,2,3,0,7,-7,-1,3,2,2,0,0,1,1,0,-1,5,1
KR_6645122879,420,0,-29,-16,6,2,2,0,2,3,1,1,4,3,1,4,3,0,0,0,0,9,2,1,5,6,0,0,0,0,1,1,1,0,1
KR_6607470833,420,0,-40,6,3,-5,1,6,4,4,0,2,3,1,1,1,0,1,1,0,0,5,4,3,3,6,1,0,2,1,1,1,1,3,1
KR_6561299873,420,2,43,-7,4,1,2,1,-2,1,3,0,2,2,7,7,0,-2,0,2,1,5,-12,3,3,6,1,0,1,1,-1,1,1,4,1
KR_6655631945,420,1,55,-20,1,2,2,0,1,1,0,0,2,2,-1,2,3,-1,2,3,0,2,0,4,5,9,3,0,0,-1,1,1,1,5,1
KR_6738188184,420,2,60,4,5,-1,2,3,-3,2,5,1,1,0,8,8,0,0,0,0,1,4,13,3,4,7,5,0,0,-1,1,1,1,1,1
KR_6763056228,420,-1,-5,12,4,6,7,1,-2,1,3,-2,1,3,1,2,1,1,1,0,-1,-3,-5,-2,5,3,-1,0,0,0,0,1,-1,0,1
KR_6765380553,420,-1,71,-4,2,-3,0,3,1,4,3,0,1,1,4,7,3,0,0,0,0,6,5,4,3,7,-4,0,1,1,-1,1,-1,5,1
KR_6747322185,440,0,-29,16,0,0,0,0,4,4,0,-2,2,4,-2,0,2,0,0,0,1,-5,6,4,1,5,-2,0,0,1,-1,1,1,1,1
KR_6729493659,440,2,86,4,4,0,3,3,-1,1,2,3,3,0,0,0,0,2,8,6,1,1,-6,-2,5,3,2,0,0,-1,-1,1,-1,1,1
KR_6594721806,420,0,57,14,0,0,3,3,-3,0,3,4,5,1,-1,3,4,0,1,1,0,0,13,0,5,5,2,0,0,-1,1,0,1,1,1
KR_6724980513,420,0,-8,10,8,0,1,1,6,6,0,-3,1,4,6,6,0,-1,3,4,2,14,-4,0,5,5,1,0,0,1,1,1,1,2,1
KR_6762729701,420,2,73,4,9,-1,2,3,-1,1,2,6,6,0,5,5,0,0,1,1,0,10,-11,-3,5,2,4,0,1,0,1,1,1,0,1
KR_6716389190,420,-4,-67,-4,-7,-1,4,5,-1,4,5,-1,2,3,-2,0,2,-2,0,2,0,-4,4,-2,4,2,-4,0,0,-1,1,-1,1,4,1
KR_6619412974,440,-3,-32,7,-8,1,2,1,-1,3,4,-1,3,4,-8,1,9,1,1,0,0,-16,-2,-1,4,3,-2,0,-1,-1,-1,-1,1,2,1
KR_6616495077,440,3,17,16,10,-3,1,4,4,5,1,3,3,0,6,6,0,0,0,0,0,12,1,-1,7,6,1,0,0,1,1,-1,1,3,1
KR_6752130480,420,0,60,9,3,-2,2,4,0,4,4,-2,3,5,4,5,1,3,3,0,0,11,-41,-4,7,3,23,0,0,-1,1,0,1,5,1
KR_6743409349,420,2,61,0,2,0,1,1,-1,2,3,-1,4,5,2,3,1,2,2,0,0,-3,310,3,1,4,-3,0,1,1,-1,1,1,6,1
KR_6601308550,420,5,32,32,13,1,2,1,4,5,1,0,3,3,4,7,3,4,6,2,0,9,5,1,1,2,1,0,1,1,1,1,1,3,1
KR_6619736864,420,2,-17,0,9,-1,0,1,1,4,3,-1,1,2,7,7,0,3,3,0,0,13,1,0,3,3,0,0,0,1,-1,1,1,5,1
KR_6762448616,440,2,23,16,1,2,4,2,1,4,3,-2,2,4,0,4,4,0,1,1,0,0,-4,5,1,6,3,0,1,-1,-1,1,-1,5,1
KR_6651733159,420,0,35,-3,3,3,3,0,-1,3,4,-1,2,3,1,3,2,1,3,2,0,0,-221,3,2,5,2,0,-1,1,-1,-1,1,5,1
KR_6764829619,420,6,37,-4,18,8,9,1,4,4,0,-2,0,2,8,8,0,0,1,1,1,20,-2,-1,2,1,2,0,2,1,1,1,1,5,1
KR_6714623701,420,4,18,20,8,0,1,1,4,6,2,3,4,1,3,4,1,-2,0,2,0,0,-5,4,4,8,3,0,0,1,-1,0,-1,2,1
KR_6688254354,420,2,6,15,4,0,1,1,0,5,5,3,3,0,0,1,1,1,4,3,0,2,15,-5,7,2,0,0,0,1,-1,0,1,1,1
KR_6522237919,420,2,36,27,4,1,4,3,0,3,3,1,3,2,-1,2,3,3,3,0,0,10,3,3,2,5,4,0,1,1,1,1,-1,1,1
KR_6649951560,420,2,25,20,2,4,7,3,-3,1,4,0,2,2,0,3,3,1,1,0,0,0,3,0,5,5,-4,0,0,-1,-1,-1,-1,5,1
KR_6757920439,420,1,6,-10,6,0,0,0,-1,3,4,-1,1,2,4,5,1,4,4,0,0,8,12,2,4,6,-2,0,0,1,-1,0,1,1,1
KR_6759638659,420,4,73,48,-3,0,1,1,-3,2,5,4,6,2,-1,3,4,-3,0,3,0,-21,-28,-5,6,1,5,0,-1,-1,1,1,1,2,1
KR_6732120985,420,7,88,-3,25,1,3,2,8,9,1,8,9,1,6,6,0,2,2,0,2,29,23,3,4,7,0,1,5,1,1,1,1,2,1
KR_6760058043,440,5,17,-4,8,0,1,1,1,1,0,2,3,1,3,3,0,2,2,0,0,12,7,0,5,5,6,0,0,1,-1,1,1,4,1
KR_6747765330,420,4,64,2,10,0,2,2,4,6,2,8,11,3,0,1,1,-2,1,3,-1,2,6,0,2,2,1,0,1,1,1,1,-1,5,1
KR_6762614710,420,0,-33,-24,-4,-1,4,5,-1,2,3,-6,1,7,2,4,2,2,3,1,1,-2,-32,-8,8,0,4,0,0,-1,-1,0,1,6,1
KR_6765883526,420,-1,-15,26,1,2,3,1,0,1,1,-1,0,1,1,4,3,-1,0,1,0,2,6,2,4,6,0,0,0,0,1,0,1,0,1
KR_6624541802,420,1,3,-17,5,-1,1,2,5,6,1,-2,1,3,1,2,1,2,3,1,1,3,3,-2,5,3,0,0,2,1,1,1,1,3,1
KR_6767215408,440,0,56,20,-2,0,0,0,2,2,0,-2,3,5,-2,0,2,0,0,0,0,-4,-4,0,3,3,-3,0,1,0,1,1,-1,0,1
KR_6671325407,420,3,98,4,1,3,4,1,-2,1,3,1,2,1,2,4,2,-3,2,5,0,1,-2,-2,5,3,3,0,0,-1,-1,1,1,3,1
KR_6767147081,420,5,76,11,11,4,5,1,-3,0,3,3,4,1,7,9,2,0,0,0,0,1,2,-2,5,3,-1,0,1,-1,1,1,1,1,1
KR_6763731863,420,0,81,-12,-1,-4,0,4,-5,1,6,4,5,1,4,6,2,0,0,0,1,-8,2,-2,5,3,-3,0,0,-1,-1,0,1,5,1
KR_6573225668,420,4,30,5,7,0,1,1,5,6,1,-2,1,3,1,4,3,3,3,0,0,6,-241,-1,4,3,2,0,1,-1,1,1,-1,5,1
KR_6682741869,420,1,58,20,2,-1,0,1,3,4,1,0,2,2,1,2,1,-1,0,1,1,-4,6,-2,3,1,1,0,-2,1,1,-1,1,2,1
KR_6734918627,420,3,33,36,10,-1,2,3,-4,1,5,7,8,1,6,7,1,2,2,0,1,7,-6,-2,5,3,3,0,2,1,-1,1,1,2,1
KR_6691763905,420,-2,-36,15,-6,-1,0,1,-1,1,2,-3,0,3,-1,2,3,0,0,0,0,-4,-6,-2,4,2,-3,0,0,1,0,0,-1,4,1
KR_6636266398,420,0,63,-21,0,7,8,1,-4,0,4,-3,2,5,7,7,0,-7,0,7,1,-5,-2,3,2,5,0,0,0,0,0,0,1,0,1
KR_6759858014,440,3,-6,9,5,6,7,1,-1,3,4,2,3,1,2,2,0,-4,0,4,0,12,-9,-6,9,3,5,0,1,1,1,1,-1,1,1
KR_6750724998,420,2,35,12,5,1,2,1,0,1,1,1,5,4,7,7,0,-4,0,4,1,5,0,-2,7,5,-2,0,-1,-1,-1,-1,1,1,1
KR_6761607261,420,2,89,24,8,4,6,2,4,7,3,-1,0,1,1,2,1,0,0,0,0,6,4,-1,6,5,-1,0,1,1,-1,1,1,1,1
KR_6765278233,420,1,93,14,0,0,0,0,3,3,0,-4,1,5,-1,0,1,2,2,0,0,7,-23,0,4,4,-6,0,1,-1,0,1,-1,5,1
KR_6670941907,420,4,16,36,9,5,5,0,4,5,1,0,4,4,1,3,2,-1,1,2,-1,0,3,-1,5,4,10,0,1,1,1,1,-1,2,1
KR_6733314099,420,2,39,-12,3,1,2,1,-3,1,4,6,6,0,-1,4,5,0,4,4,-1,-2,32,-4,6,2,3,0,0,0,0,0,-1,0,1
KR_6751781272,420,-3,-5,2,-10,0,0,0,-5,1,6,-4,0,4,0,1,1,-1,0,1,0,-2,5,1,1,2,-4,0,-1,1,-1,-1,-1,4,1
KR_6749547587,420,-2,52,-20,-9,0,1,1,-2,1,3,1,2,1,-7,0,7,-1,1,2,-1,-11,29,1,3,4,-2,0,1,-1,1,1,-1,2,1
KR_6762783669,420,0,17,-4,-4,-5,0,5,2,6,4,-2,2,4,-1,3,4,2,2,0,-2,-6,-1,-3,4,1,1,0,1,1,-1,1,-1,6,1
KR_6674164685,420,-1,-71,8,-5,-4,2,6,2,5,3,-6,3,9,2,4,2,1,1,0,-2,-2,-213,0,5,5,-3,0,-2,1,-1,-1,-1,5,1
KR_6758860299,420,1,-11,-19,2,2,2,0,3,6,3,-4,4,8,-1,3,4,2,2,0,0,7,-25,4,3,7,1,0,-1,-1,1,1,1,3,1
KR_6766909298,420,4,139,48,8,-1,1,2,1,3,2,3,4,1,3,3,0,2,2,0,0,8,27,-2,3,1,1,0,3,1,1,1,1,5,1
KR_6724056410,420,2,-30,52,3,3,4,1,6,6,0,0,2,2,-2,2,4,-4,0,4,0,-8,-1,2,1,3,-4,0,1,1,1,1,-1,5,1
KR_6763255173,420,-3,-59,4,-8,-4,0,4,-5,2,7,0,1,1,3,4,1,-2,0,2,0,-8,3,1,1,2,-1,0,-2,-1,-1,-1,-1,5,1
KR_6600430716,420,0,-60,16,-8,0,1,1,-5,1,6,0,0,0,-1,1,2,-2,1,3,-1,-13,-1,1,5,6,3,0,1,-1,1,1,-1,4,1
KR_6717105496,420,6,103,27,13,0,4,4,4,5,1,4,5,1,5,7,2,0,0,0,1,10,-45,-1,3,2,-2,0,2,-1,1,1,1,2,1
KR_6724637607,420,-1,-27,-21,-3,-2,3,5,2,6,4,0,3,3,-2,4,6,-1,0,1,0,-7,1,4,0,4,-3,0,-1,-1,1,-1,-1,2,1
KR_6680175410,420,1,16,-8,4,4,5,1,-3,0,3,-1,4,5,2,4,2,2,4,2,0,-2,1,-6,10,4,3,0,0,-1,1,0,-1,1,1
KR_6678164930,420,5,121,40,10,1,1,0,6,7,1,1,3,2,0,2,2,2,3,1,2,-1,-7,5,2,7,0,0,1,-1,1,1,1,2,1
KR_6759716094,420,6,81,14,3,7,7,0,-6,0,6,-2,0,2,4,5,1,0,1,1,0,4,7,6,3,9,0,1,4,-1,1,1,-1,2,1
KR_6760372260,420,-3,3,16,-3,-5,1,6,1,4,3,-2,4,6,4,5,1,-1,1,2,0,-2,-2,-1,4,3,3,0,1,1,1,1,-1,2,1
KR_6750532478,420,6,130,16,8,3,4,1,-1,1,2,2,3,1,2,7,5,2,4,2,0,4,-11,-4,8,4,3,0,1,1,-1,1,1,4,1
KR_6762364853,420,2,60,22,2,-2,1,3,-1,3,4,-3,1,4,4,4,0,4,4,0,0,1,44,-1,5,4,-18,0,-1,1,-1,-1,1,5,1
KR_6743408244,420,1,50,-15,7,3,3,0,-4,3,7,1,2,1,5,6,1,2,3,1,0,4,0,1,2,3,-1,0,1,1,1,1,1,4,1
KR_6760503111,420,-1,-44,-24,4,-1,2,3,-1,0,1,-1,3,4,6,6,0,1,1,0,0,14,-141,-2,4,2,-6,0,-1,-1,1,-1,-1,4,1
KR_6747804895,420,4,1,5,0,1,4,3,-1,3,4,2,2,0,-2,2,4,0,0,0,-1,-5,-149,2,2,4,-4,0,1,1,-1,1,-1,2,1
KR_6756328940,420,0,25,12,1,0,2,2,1,1,0,1,3,2,0,3,3,-1,1,2,0,-1,-4,3,5,8,-2,0,-1,-1,-1,-1,-1,2,1
KR_6759562631,420,1,5,-12,6,-1,0,1,6,7,1,-2,0,2,3,3,0,0,1,1,0,11,2,6,2,8,-1,0,1,1,1,1,1,3,1
KR_6768479936,420,2,70,41,0,2,3,1,1,2,1,-1,0,1,1,3,2,-3,0,3,0,-5,-6,6,1,7,1,0,1,1,1,1,-1,5,1
KR_6715401412,420,2,28,-20,4,0,0,0,-2,0,2,4,5,1,2,3,1,0,2,2,1,2,120,-6,7,1,3,0,0,-1,-1,1,1,6,1
KR_6648125871,420,4,110,16,11,3,5,2,2,5,3,0,1,1,3,5,2,3,4,1,0,9,26,1,5,6,0,0,2,1,1,1,1,3,1
KR_6711327385,420,1,-24,-16,6,-2,0,2,-1,1,2,0,5,5,6,7,1,3,3,0,0,11,70,-3,7,4,-4,0,-1,-1,-1,-1,1,5,1
KR_6750556705,440,5,75,28,9,1,3,2,1,1,0,7,7,0,1,4,3,-1,0,1,1,1,3,4,3,7,3,0,2,-1,0,1,1,2,1
KR_6734866230,420,4,56,-22,10,5,6,1,3,4,1,1,2,1,0,1,1,1,4,3,1,8,10,3,6,9,-2,0,1,-1,-1,1,1,3,1
KR_6465825660,420,3,27,23,8,5,5,0,2,4,2,2,4,2,-3,0,3,2,3,1,0,-1,4,3,1,4,-3,0,1,1,1,1,1,4,1
KR_6762400222,420,7,82,26,18,2,3,1,5,5,0,3,4,1,3,4,1,5,5,0,0,10,12,-1,4,3,-4,0,0,1,0,1,1,5,1
KR_6754338418,420,3,34,7,20,1,2,1,1,2,1,0,0,0,12,16,4,6,8,2,1,15,2,0,1,1,1,0,1,1,1,1,1,1,1
KR_6680806312,420,2,-23,15,3,2,2,0,-2,2,4,3,4,1,0,3,3,0,1,1,0,8,-1,-5,6,1,0,0,0,-1,0,0,1,3,1
KR_6482324656,420,2,21,32,-1,1,3,2,1,3,2,-1,1,2,-2,1,3,0,0,0,0,-1,5,-2,6,4,1,0,-1,-1,1,-1,-1,4,1
KR_6641593651,420,2,-7,30,-4,1,2,1,-1,1,2,2,2,0,-4,0,4,-2,0,2,0,-9,3,-3,4,1,-2,0,1,-1,1,1,-1,5,1
KR_6627753713,420,1,66,-4,5,0,1,1,1,2,1,3,4,1,1,2,1,0,0,0,0,2,4,-1,3,2,0,0,0,-1,-1,1,1,3,1
KR_6759252170,420,-3,10,-32,0,4,4,0,0,0,0,-1,1,2,-5,1,6,2,3,1,1,3,9,1,3,4,-4,0,1,-1,1,1,1,3,1
KR_6629115549,420,0,-41,16,3,2,2,0,1,2,1,1,2,1,-3,5,8,2,2,0,0,-7,-10,-3,4,1,2,0,0,1,-1,0,-1,1,1
KR_6642443599,420,1,3,-16,1,1,4,3,0,4,4,-1,0,1,1,2,1,0,0,0,1,2,-6,4,3,7,-3,0,0,-1,1,0,1,4,1
KR_6760418615,420,-1,35,-17,-5,2,3,1,-7,0,7,0,3,3,-1,1,2,1,1,0,0,-11,-1,-1,5,4,0,0,0,-1,1,0,1,4,1
KR_6732599270,440,3,40,8,5,1,1,0,-1,1,2,3,3,0,0,1,1,2,3,1,-1,9,13,5,0,5,0,0,0,-1,0,0,-1,6,1
KR_6641178532,420,3,89,-24,1,3,4,1,-4,0,4,2,4,2,0,4,4,0,1,1,0,1,16,3,2,5,-2,0,2,-1,1,1,1,2,1
KR_6765072825,420,5,107,4,9,1,2,1,3,4,1,4,4,0,2,2,0,-1,0,1,0,8,130,2,1,3,3,0,1,1,1,1,1,1,1
KR_6762537825,440,4,20,32,8,4,5,1,-2,2,4,7,7,0,-1,2,3,0,2,2,0,5,-204,2,1,3,2,0,1,1,1,1,1,4,1
KR_6756886971,420,-1,38,43,0,2,2,0,1,4,3,-4,1,5,1,2,1,0,0,0,0,-5,101,2,3,5,-4,0,-2,-1,1,-1,-1,3,1
KR_6627933555,420,1,76,-52,5,0,1,1,2,2,0,2,5,3,0,0,0,1,4,3,0,2,3,0,3,3,0,0,1,1,-1,1,1,4,1
KR_6717612227,420,3,71,39,8,3,4,1,0,4,4,0,2,2,1,4,3,4,5,1,0,3,21,3,4,7,-2,0,1,1,1,1,1,4,1
KR_6723745500,420,1,19,16,-1,1,1,0,-2,4,6,0,1,1,2,2,0,-2,1,3,0,-2,32,0,6,6,-3,0,2,-1,1,1,-1,4,1
KR_6765719109,420,5,43,48,11,2,4,2,4,5,1,4,6,2,1,2,1,0,0,0,0,13,-5,2,2,4,2,0,2,1,1,1,1,2,1
KR_6731605490,420,2,53,17,4,4,4,0,1,2,1,4,6,2,-4,0,4,-1,0,1,0,0,19,-1,4,3,-1,0,1,-1,1,1,1,2,1
KR_6710785111,420,-1,-68,-3,-4,-4,1,5,0,3,3,-1,1,2,0,4,4,1,2,1,0,2,22,5,4,9,-2,0,0,-1,1,-1,-1,6,1
KR_6660302495,440,1,23,-12,5,-2,0,2,4,7,3,2,3,1,1,6,5,0,1,1,0,4,-44,0,2,2,27,0,0,0,0,0,-1,0,1
KR_6607419841,420,7,113,6,11,1,2,1,9,11,2,-3,2,5,4,5,1,0,0,0,0,11,-240,-3,6,3,4,0,0,1,1,1,1,3,1
KR_6199590044,420,4,51,12,2,4,5,1,-3,1,4,1,6,5,1,3,2,-1,0,1,0,-6,-188,-4,6,2,-3,0,0,0,1,1,1,0,1
KR_6725854489,420,4,-31,1,7,2,2,0,2,4,2,-1,0,1,-3,2,5,7,7,0,0,16,126,-6,7,1,7,0,1,1,-1,1,-1,3,1
KR_6619546701,420,0,-50,-5,0,0,0,0,0,3,3,0,2,2,0,0,0,0,0,0,0,0,129,0,3,3,-2,0,1,0,1,1,1,0,1
KR_6755606571,420,3,23,-52,13,2,3,1,0,3,3,2,5,3,4,4,0,5,5,0,1,8,-2,-2,4,2,3,0,1,0,1,1,1,0,1
KR_6766756350,420,0,-52,5,1,1,2,1,-1,0,1,-2,2,4,3,3,0,0,1,1,0,-4,-14,-2,3,1,6,0,1,-1,1,1,1,1,1
KR_6764108005,420,-2,-2,12,-2,-3,0,3,-3,0,3,5,5,0,1,4,3,-2,0,2,0,0,1,-1,4,3,0,0,-1,1,-1,-1,-1,6,1
KR_6674002389,420,0,56,26,2,-1,1,2,6,6,0,0,1,1,-2,0,2,-1,0,1,0,5,2,3,2,5,-2,0,1,-1,1,1,1,3,1
KR_6746341372,420,3,48,4,10,3,3,0,-1,2,3,3,5,2,6,8,2,-1,1,2,0,9,3,2,1,3,-3,0,1,-1,1,1,1,3,1
KR_6768180253,420,3,34,-12,10,5,5,0,-4,0,4,5,5,0,2,2,0,2,2,0,0,7,-15,2,4,6,-5,0,0,1,1,0,1,5,1
KR_6743611153,420,0,-25,12,2,0,0,0,-1,0,1,1,3,2,1,2,1,1,1,0,0,4,-24,2,2,4,6,0,0,-1,1,1,1,5,1
KR_6757476570,420,1,19,8,6,0,2,2,1,4,3,6,7,1,0,3,3,-1,0,1,0,7,-10,-2,4,2,4,0,-1,0,1,1,1,0,1
KR_6758991225,420,2,13,-4,3,0,4,4,0,0,0,1,5,4,-1,1,2,3,4,1,0,6,-2,-3,4,1,4,0,0,1,0,0,1,3,1
KR_6767384440,420,5,42,68,17,8,9,1,6,6,0,4,4,0,-2,2,4,1,4,3,3,19,-261,2,2,4,-2,0,2,1,1,1,1,4,1
KR_6760681122,440,2,-15,-18,4,-2,1,3,-2,2,4,2,3,1,7,8,1,-1,0,1,0,11,20,3,2,5,3,0,-1,1,-1,-1,1,3,1
KR_6636682535,420,0,-10,-4,1,-1,3,4,2,4,2,0,3,3,0,4,4,0,1,1,1,6,-88,4,6,10,1,0,0,1,-1,-1,1,5,1
KR_6764901566,420,-3,-26,23,-7,-2,2,4,-1,1,2,-2,2,4,-2,4,6,0,1,1,0,-6,14,4,2,6,0,0,0,0,-1,1,1,0,1
KR_6198131875,420,3,40,5,-3,-3,1,4,-2,5,7,3,4,1,1,2,1,-2,4,6,-1,-4,0,3,2,5,4,0,0,1,-1,1,-1,4,1
KR_6695458291,420,2,47,-36,5,2,2,0,5,8,3,-3,0,3,-1,1,2,2,2,0,0,2,0,-2,3,1,0,0,0,1,-1,0,1,1,1
KR_6685418528,420,3,7,11,5,-2,1,3,4,6,2,-3,0,3,3,3,0,3,4,1,0,4,6,-4,7,3,-1,0,0,1,1,1,1,4,1
KR_6685618436,420,6,44,11,5,2,5,3,1,4,3,5,5,0,-4,2,6,1,1,0,0,-2,-294,6,4,10,-4,0,0,1,-1,0,1,2,1
KR_6717609823,420,3,60,-3,2,3,4,1,-3,4,7,1,3,2,3,4,1,-2,0,2,1,0,-1,1,3,4,2,0,0,1,-1,1,1,1,1
KR_6682675397,420,0,-13,-8,1,-3,0,3,4,4,0,-3,4,7,3,3,0,0,0,0,0,10,-18,5,3,8,0,0,0,1,0,0,1,1,1
KR_6197877288,440,2,3,-3,6,-2,1,3,1,3,2,0,2,2,8,9,1,-1,1,2,1,8,229,-4,8,4,-2,0,2,1,1,1,1,3,1
KR_6766124368,420,-1,26,17,-2,0,3,3,1,5,4,-1,5,6,-3,2,5,1,1,0,-1,-6,29,-1,5,4,-6,0,1,-1,0,1,-1,1,1
KR_6762103381,420,-1,-2,-28,3,-2,0,2,-2,1,3,1,1,0,5,6,1,1,1,0,0,0,-11,0,3,3,2,0,1,1,-1,1,1,1,1
KR_6693873889,420,4,23,36,15,3,4,1,3,4,1,1,2,1,5,6,1,3,3,0,0,17,2,2,5,7,1,0,2,1,1,1,1,6,1
KR_6713229295,420,3,-20,16,5,1,2,1,3,3,0,3,4,1,-4,2,6,2,4,2,0,2,-5,-2,4,2,0,0,1,-1,1,1,-1,3,1
KR_6754342170,420,-1,-37,-8,-5,-2,3,5,3,6,3,0,2,2,-3,2,5,-3,2,5,0,-5,-13,-6,6,0,4,0,-1,-1,-1,-1,-1,4,1
KR_6765817032,420,3,-17,-39,4,-2,2,4,-3,1,4,2,3,1,3,8,5,4,4,0,2,7,30,-2,4,2,-1,0,1,0,-1,-1,1,0,1
KR_6638479484,420,-2,-8,0,0,-3,0,3,9,9,0,-1,4,5,-2,0,2,-3,0,3,0,-4,14,3,4,7,2,0,1,1,1,1,1,4,1
KR_6764829976,420,1,59,-31,13,4,5,1,0,1,1,4,4,0,3,6,3,2,2,0,2,13,-3,2,4,6,4,0,0,0,0,0,1,0,1
KR_6652481917,420,-1,40,-12,2,3,3,0,0,2,2,4,6,2,-2,2,4,-3,1,4,-1,0,3,1,5,6,-1,0,1,1,-1,1,-1,3,1
KR_6765528237,420,-2,-15,-10,2,-5,0,5,-1,3,4,3,3,0,4,5,1,1,1,0,0,8,-112,0,2,2,-5,0,0,-1,1,0,1,5,1
KR_6593910412,420,0,114,0,-4,-4,1,5,-1,1,2,2,3,1,-2,3,5,1,1,0,0,1,-11,-6,10,4,5,0,1,-1,-1,1,-1,6,1
KR_6692031444,420,-2,-24,-12,-4,-3,1,4,-2,1,3,2,3,1,1,3,2,-2,2,4,0,0,-30,0,8,8,20,0,-1,1,0,-1,-1,4,1
KR_6723303805,420,1,10,-20,-2,0,0,0,-3,2,5,-1,0,1,3,7,4,-1,2,3,-1,-1,1,0,2,2,-4,0,0,1,-1,1,-1,6,1
KR_6746727805,420,-1,-47,-35,-3,-3,1,4,0,2,2,-1,2,3,0,0,0,1,1,0,1,-2,-239,1,2,3,-32,0,0,-1,-1,0,1,6,1
KR_6751712380,420,1,16,-1,-4,1,2,1,-3,2,5,1,4,3,-2,1,3,-1,0,1,-1,-5,-8,0,4,4,-3,0,1,-1,1,1,-1,1,1
KR_6764479914,420,1,57,27,3,1,2,1,3,4,1,-1,3,4,0,0,0,0,0,0,1,-1,20,-1,6,5,1,0,1,1,1,1,1,3,1
KR_6480249611,420,0,6,32,7,4,5,1,4,5,1,-1,2,3,1,2,1,-1,0,1,0,4,-5,1,1,2,-4,0,0,-1,1,0,-1,3,1
KR_6762660191,420,4,8,43,5,0,3,3,8,8,0,-2,1,3,1,3,2,-2,0,2,0,-1,-22,3,5,8,-2,0,1,0,1,1,1,0,1
KR_6756091554,420,2,64,24,2,-1,0,1,-1,1,2,1,4,3,3,3,0,0,1,1,0,3,-7,-3,5,2,5,0,0,1,-1,-1,1,3,1
KR_6646967135,420,-7,-7,-8,-13,-1,0,1,-1,1,2,-6,0,6,-4,1,5,-1,0,1,0,-9,-8,2,3,5,-2,0,-1,-1,1,-1,-1,2,1
KR_6708573415,420,2,-32,20,4,1,2,1,4,5,1,6,9,3,-8,2,10,1,1,0,0,0,-5,0,3,3,-2,0,1,1,1,1,-1,3,1
KR_6756328605,420,0,6,-4,2,-1,1,2,1,3,2,4,6,2,0,2,2,-2,0,2,0,2,52,5,0,5,-23,0,1,-1,-1,1,1,4,1
KR_6765922117,440,6,108,3,13,3,3,0,8,9,1,-2,1,3,-2,1,3,6,6,0,0,15,3,0,4,4,0,0,1,1,1,1,1,3,1
KR_6588888647,420,1,59,20,5,-1,2,3,-2,1,3,1,2,1,4,4,0,3,4,1,0,5,5,5,1,6,4,0,1,1,-1,1,1,2,1
KR_6736397149,420,4,113,24,8,4,4,0,3,5,2,3,7,4,-2,1,3,0,0,0,0,11,-1,0,3,3,1,0,2,1,1,1,1,5,1
KR_6614369156,420,1,-28,28,1,-1,1,2,-1,5,6,2,4,2,0,1,1,1,2,1,0,-2,-1,1,6,7,0,0,1,1,1,1,-1,4,1
KR_6508638874,420,7,80,56,16,7,7,0,0,1,1,2,2,0,5,6,1,2,3,1,0,8,-6,4,1,5,-4,0,2,1,1,1,1,6,1
KR_6733374827,420,3,-5,-8,16,5,6,1,8,9,1,2,4,2,-1,2,3,2,3,1,0,13,23,3,2,5,4,0,1,-1,1,1,1,6,1
KR_6762400855,420,3,54,-12,11,3,4,1,6,6,0,2,4,2,1,3,2,-1,2,3,0,11,-107,2,1,3,-1,0,0,1,0,0,1,3,1
KR_6719498663,420,-5,-68,-32,0,-1,0,1,0,2,2,-2,1,3,1,2,1,2,4,2,0,1,-3,1,6,7,-7,0,0,-1,-1,0,1,6,1
KR_6768355223,420,2,54,-6,1,-3,1,4,-1,3,4,4,5,1,2,3,1,-1,1,2,0,-2,387,1,0,1,-1,0,2,1,-1,1,-1,5,1
KR_6765374075,420,-3,-97,-29,-4,-3,2,5,2,4,2,-1,0,1,-3,4,7,1,1,0,0,4,105,1,4,5,-1,0,-1,0,0,-1,1,0,1
KR_6591021375,420,-1,-31,12,-2,0,3,3,-1,2,3,-2,1,3,0,3,3,1,1,0,1,2,8,-7,10,3,4,0,0,-1,-1,-1,1,1,1
KR_6767989059,420,0,-20,12,1,-4,1,5,-2,2,4,6,6,0,-1,2,3,2,2,0,0,0,-6,-1,6,5,4,0,0,1,1,-1,1,6,1
KR_6627678320,420,1,-47,28,7,4,6,2,-1,2,3,-1,2,3,1,3,2,4,5,1,0,4,11,4,4,8,1,0,1,1,1,1,1,4,1
KR_6764829612,420,4,145,29,13,5,6,1,3,4,1,3,7,4,0,2,2,2,2,0,0,5,-44,-4,8,4,11,0,3,1,-1,1,1,3,1
KR_6602519327,420,-1,-1,36,3,-2,0,2,0,4,4,7,8,1,1,1,0,-3,0,3,0,4,5,0,3,3,0,0,0,1,1,1,-1,1,1
KR_6760395057,420,2,-23,12,-2,0,2,2,-1,2,3,-3,0,3,1,2,1,1,1,0,0,-3,17,-1,5,4,4,0,0,-1,-1,0,-1,4,1
KR_6752574512,420,3,12,24,3,1,2,1,-1,2,3,2,3,1,1,1,0,0,0,0,0,5,-4,-1,3,2,-2,0,0,-1,1,1,-1,1,1
KR_6756657858,420,0,-7,-35,1,4,5,1,-2,1,3,1,1,0,-2,1,3,0,1,1,1,4,5,-1,3,2,2,0,0,1,-1,0,1,3,1
KR_6629486791,420,5,62,4,11,-1,2,3,10,12,2,0,1,1,2,4,2,0,1,1,0,12,-271,3,3,6,-1,0,1,-1,1,1,1,4,1
KR_6712963321,420,0,36,-5,-1,-2,0,2,-1,0,1,4,5,1,-2,2,4,0,2,2,-1,1,45,1,2,3,-18,0,0,1,-1,0,-1,4,1
KR_6746621906,420,1,-38,4,2,4,4,0,0,2,2,-1,0,1,0,2,2,-1,0,1,0,-3,-34,0,5,5,14,0,0,-1,1,0,-1,5,1
KR_6754500857,420,6,17,49,8,-1,3,4,8,9,1,6,7,1,-2,0,2,-3,0,3,0,4,-3,0,4,4,-4,0,0,1,1,1,1,6,1
KR_6762379170,420,2,52,27,9,6,6,0,0,2,2,2,6,4,2,7,5,-1,3,4,1,-2,-2,-2,6,4,1,0,1,1,1,1,1,3,1
KR_6646709745,440,14,164,28,20,4,4,0,4,5,1,6,9,3,7,7,0,-1,0,1,0,22,2,-1,2,1,2,0,2,1,0,1,1,6,1
KR_6597448314,420,3,17,32,2,0,1,1,2,5,3,2,2,0,-4,0,4,2,2,0,0,-1,0,2,4,6,-1,0,0,-1,-1,0,1,4,1
KR_6747614125,420,-3,-64,0,-7,-3,0,3,-2,3,5,3,5,2,-5,0,5,0,0,0,0,-5,-2,-1,4,3,3,0,0,0,0,0,1,0,1
KR_6762757107,420,3,1,31,-1,1,2,1,-3,1,4,2,3,1,0,1,1,-1,0,1,-1,-4,168,2,1,3,-23,0,2,-1,1,1,-1,2,1
KR_6754561371,440,3,93,-12,6,1,2,1,9,10,1,3,3,0,-7,2,9,0,1,1,0,10,-7,-2,5,3,2,0,1,-1,-1,1,-1,4,1
KR_6758472071,420,8,75,56,13,-1,1,2,4,5,1,8,8,0,0,2,2,2,3,1,0,5,8,2,5,7,-1,0,1,1,-1,1,-1,4,1
KR_6696319064,440,-1,14,-15,-7,-1,2,3,0,2,2,-3,1,4,-1,2,3,-2,0,2,0,-7,53,-1,6,5,-27,0,0,1,1,0,1,5,1
KR_6719184200,420,6,58,30,15,4,6,2,6,8,2,3,3,0,4,4,0,-2,1,3,0,9,5,7,2,9,-3,0,1,1,-1,1,1,4,1
KR_6635067463,420,6,8,37,6,1,3,2,5,8,3,-1,1,2,1,2,1,0,2,2,1,13,5,5,2,7,-5,0,2,-1,1,1,1,2,1
KR_6514949786,420,-4,-29,16,-5,-5,0,5,4,8,4,-2,1,3,0,0,0,-2,1,3,0,-1,13,3,3,6,-5,0,-2,-1,-1,-1,1,6,1
KR_6741386814,420,3,-5,6,9,4,5,1,0,5,5,3,4,1,4,5,1,-2,0,2,0,11,-5,-2,5,3,2,0,2,1,1,1,-1,2,1
KR_6732903409,420,3,35,18,4,-3,0,3,3,6,3,0,1,1,5,5,0,-1,1,2,0,4,11,1,3,4,-1,0,1,1,-1,1,-1,5,1
KR_6637959383,420,-1,-14,-12,1,-3,2,5,4,6,2,-3,0,3,1,2,1,2,2,0,0,9,0,4,3,7,0,0,-1,1,-1,-1,-1,6,1
KR_6759344519,420,4,66,6,7,-1,2,3,2,4,2,-1,3,4,4,5,1,3,3,0,0,8,-59,4,2,6,1,0,0,1,1,1,-1,3,1
KR_6747382801,420,0,-17,-17,-1,1,1,0,4,4,0,2,3,1,-5,2,7,-3,0,3,0,-2,-1,1,1,2,0,0,0,0,1,1,1,0,1
KR_6767421430,420,3,43,23,18,-1,1,2,5,6,1,9,9,0,5,6,1,0,2,2,0,15,-4,-1,5,4,1,0,1,1,-1,-1,1,6,1
KR_6736728728,420,-1,-56,-4,-1,2,4,2,1,2,1,0,2,2,-3,1,4,-1,0,1,0,-1,-10,1,2,3,-2,0,-2,-1,1,-1,-1,3,1
KR_6632374653,420,5,91,12,8,-1,2,3,4,7,3,-1,0,1,5,6,1,1,1,0,0,10,222,-3,7,4,-1,0,0,1,-1,1,1,5,1
KR_6750817930,440,1,72,20,-4,2,4,2,-2,1,3,0,2,2,-5,2,7,1,2,1,0,-10,-4,-2,6,4,3,0,1,1,1,1,-1,4,1
KR_6759577665,420,1,9,-7,5,-5,1,6,3,4,1,6,6,0,1,3,2,0,1,1,0,13,4,1,2,3,3,0,1,1,-1,1,-1,5,1
KR_6765623206,440,3,-16,11,5,3,3,0,3,3,0,-2,0,2,-1,1,2,2,2,0,0,1,-10,-1,4,3,2,0,0,1,-1,0,1,4,1
KR_6760507500,420,3,23,-4,6,0,4,4,-2,0,2,-1,2,3,7,7,0,2,2,0,-1,10,18,0,5,5,-1,0,2,-1,-1,1,-1,3,1
KR_6765908329,420,1,29,32,7,3,3,0,3,6,3,2,2,0,-2,3,5,1,1,0,2,13,-38,-1,6,5,44,0,0,1,1,0,1,2,1
KR_6595109571,420,-2,-98,-8,7,-1,1,2,-2,3,5,4,5,1,6,7,1,0,1,1,0,7,-93,2,8,10,2,0,1,1,1,1,1,5,1
KR_6747216248,420,4,47,12,7,0,2,2,4,7,3,-3,0,3,2,5,3,4,8,4,0,8,4,3,1,4,6,0,1,-1,1,1,-1,6,1
KR_6727147911,420,1,110,6,6,0,1,1,3,5,2,5,7,2,-1,1,2,-1,0,1,0,6,-13,2,2,4,3,0,0,1,-1,0,1,3,1
KR_6762488666,440,3,38,22,9,3,7,4,0,3,3,-1,5,6,6,8,2,1,2,1,1,3,16,3,2,5,-2,0,1,1,1,1,1,3,1
KR_6734765042,420,0,15,4,8,-3,2,5,0,0,0,-1,2,3,11,11,0,1,3,2,1,7,-1,1,4,5,2,0,1,1,1,1,1,5,1
KR_6483780415,420,-2,-16,17,-1,-2,0,2,1,3,2,2,4,2,0,1,1,-2,2,4,0,6,2,-2,8,6,4,0,0,1,1,-1,-1,6,1
KR_6646082793,420,1,-3,-10,0,0,1,1,3,5,2,-1,1,2,-3,2,5,1,3,2,0,-5,10,2,3,5,1,0,0,-1,1,0,-1,2,1
KR_6764461857,420,0,6,-14,3,0,1,1,-1,0,1,2,4,2,2,4,2,0,0,0,0,5,-22,5,1,6,1,0,0,1,1,1,1,5,1
KR_6757713564,420,-2,-40,16,1,-2,1,3,0,2,2,0,2,2,4,6,2,-1,2,3,0,-1,4,2,2,4,2,0,0,1,-1,0,1,4,1
KR_6629353151,420,4,44,24,12,0,2,2,7,7,0,2,3,1,4,5,1,-1,0,1,0,14,-394,4,1,5,2,0,1,1,0,1,1,5,1
KR_6760267589,420,0,-44,4,2,1,2,1,-2,0,2,3,3,0,-1,1,2,1,1,0,0,7,-3,4,3,7,0,0,0,1,0,0,1,4,1
KR_6495791013,420,0,-58,-2,-6,-5,0,5,-2,2,4,4,5,1,-2,4,6,-1,1,2,2,2,8,3,5,8,-4,0,0,1,1,0,1,2,1
KR_6739345373,440,5,11,24,4,1,2,1,0,3,3,8,10,2,0,4,4,-5,1,6,0,-2,105,-3,3,0,2,0,1,1,-1,1,-1,4,1
KR_6766121744,420,2,38,-12,3,-4,1,5,-3,1,4,3,5,2,7,8,1,0,2,2,0,11,9,8,4,12,1,0,1,1,-1,1,1,1,1
KR_6663453505,420,-1,29,-15,5,-3,2,5,-2,4,6,5,6,1,4,4,0,1,3,2,0,8,-5,1,3,4,-2,0,-1,1,0,1,1,4,1
KR_6765812952,440,1,7,-4,-1,-3,1,4,-3,4,7,6,8,2,-3,1,4,2,2,0,0,-1,-46,0,2,2,1,0,-1,0,-1,-1,-1,0,1
KR_6702343301,420,2,76,-7,0,-2,2,4,0,2,2,-6,3,9,5,7,2,3,3,0,0,-1,34,1,4,5,-21,0,2,1,-1,1,1,1,1
KR_6730923879,420,5,39,15,6,1,4,3,-1,2,3,3,5,2,4,4,0,-1,1,2,0,4,6,3,2,5,-1,0,2,1,-1,1,-1,1,1
KR_6759968035,420,4,22,24,10,4,5,1,4,4,0,1,1,0,-1,2,3,2,2,0,0,11,5,0,4,4,-1,0,1,1,1,1,1,6,1
KR_6760728220,440,3,73,12,7,1,1,0,3,6,3,1,2,1,0,3,3,2,2,0,0,5,3,0,2,2,1,0,0,1,0,0,-1,2,1
KR_6727385107,420,-3,-13,-4,-2,-1,2,3,-2,3,5,-3,1,4,0,2,2,4,5,1,-1,1,6,2,3,5,1,0,-2,1,-1,-1,-1,3,1
KR_6637879761,420,2,10,4,8,2,3,1,-1,4,5,2,6,4,5,6,1,0,2,2,0,8,-8,-4,6,2,1,0,0,-1,1,0,-1,1,1
KR_6725002947,420,1,8,13,7,0,3,3,4,6,2,3,4,1,-2,2,4,2,2,0,1,7,-6,4,3,7,0,0,1,0,1,1,1,0,1
KR_6761948489,420,4,11,13,9,0,1,1,2,3,1,3,5,2,3,3,0,1,1,0,0,8,-162,5,1,6,1,0,1,1,1,1,1,3,1
KR_6743622766,420,2,33,-2,1,5,5,0,1,3,2,-3,1,4,-1,2,3,-1,1,2,0,0,-109,0,6,6,-2,0,0,-1,1,1,1,6,1
KR_6682575453,440,3,110,5,9,6,6,0,1,3,2,3,5,2,0,4,4,-1,6,7,1,-1,4,9,0,9,-2,0,2,1,1,1,1,1,1
KR_6723675723,420,1,3,-8,-6,0,1,1,-2,1,3,-2,1,3,0,2,2,-2,0,2,0,-6,6,3,2,5,0,0,-1,1,-1,-1,-1,4,1
KR_6661502664,420,0,18,12,6,1,1,0,3,5,2,-1,1,2,3,3,0,0,3,3,0,5,-401,2,4,6,16,0,0,1,1,0,-1,6,1
KR_6628644375,420,1,32,-21,1,1,3,2,-3,1,4,-1,2,3,3,5,2,1,1,0,0,6,9,-1,5,4,3,0,2,-1,1,1,1,4,1
KR_6706226770,440,1,-9,13,8,0,4,4,5,5,0,-1,2,3,5,6,1,-1,1,2,0,5,-4,-1,4,3,1,0,0,-1,1,1,1,2,1
KR_6446367932,420,4,59,1,9,2,4,2,-3,1,4,7,7,0,4,5,1,-1,0,1,1,12,-36,3,1,4,13,0,1,-1,-1,1,1,3,1
KR_6740138490,440,-2,-19,-20,-1,-4,0,4,1,2,1,-1,2,3,1,2,1,2,2,0,0,-3,-5,2,2,4,-3,0,-1,1,-1,1,1,4,1
KR_6717507985,420,4,38,28,6,0,4,4,-4,0,4,5,5,0,4,5,1,1,1,0,1,5,-154,-4,5,1,-1,0,2,0,-1,1,1,0,1
KR_6736690813,420,1,2,12,4,0,2,2,-1,1,2,1,3,2,3,4,1,1,1,0,0,2,48,3,7,10,-26,0,1,1,1,1,1,2,1
KR_6741519583,420,0,18,-24,4,-2,1,3,0,2,2,-1,0,1,1,3,2,6,6,0,1,6,4,-4,4,0,-1,0,0,0,-1,1,1,0,1
KR_6754121717,440,9,97,-24,22,10,11,1,2,4,2,-1,4,5,11,15,4,0,1,1,-1,25,-21,5,6,11,2,0,2,1,0,1,1,1,1
KR_6646527835,420,2,-25,5,4,0,2,2,4,5,1,-1,2,3,3,6,3,-2,1,3,0,2,0,0,6,6,0,0,0,1,-1,0,-1,6,1
KR_6706562553,420,3,10,16,0,4,5,1,-1,0,1,3,5,2,-6,1,7,0,0,0,1,-3,-56,0,3,3,-2,0,0,-1,-1,0,1,1,1
KR_6649064268,420,8,132,34,17,11,11,0,4,7,3,1,1,0,0,2,2,1,1,0,-1,7,-8,-1,2,1,0,1,5,1,1,1,-1,6,1
KR_6752228561,420,2,34,-7,-6,2,6,4,0,2,2,-6,1,7,-1,2,3,-1,1,2,-1,-11,-40,6,2,8,11,0,1,1,1,1,1,5,1
KR_6762504459,420,0,51,-14,-4,3,3,0,1,3,2,-2,1,3,-5,1,6,-1,1,2,0,-13,34,1,3,4,-16,0,1,-1,1,1,-1,4,1
KR_6722353466,420,3,26,16,8,1,1,0,0,1,1,4,5,1,4,5,1,-1,1,2,1,12,6,2,2,4,-2,0,1,1,1,1,1,5,1
KR_6730489261,440,3,62,-1,9,0,2,2,3,4,1,8,8,0,-2,3,5,0,0,0,0,9,7,0,6,6,-2,0,1,1,1,1,1,6,1
KR_6760480341,420,4,88,-3,9,7,8,1,2,3,1,-1,1,2,3,4,1,-2,0,2,-1,6,3,1,4,5,0,0,2,-1,1,1,-1,4,1
KR_6734132410,440,-1,-30,5,-1,1,4,3,-2,0,2,1,2,1,-5,0,5,4,6,2,-1,-12,0,-1,4,3,0,0,0,-1,1,-1,-1,1,1
KR_6727808748,420,5,140,36,1,3,3,0,1,4,3,1,4,3,-4,1,5,0,3,3,0,-7,-3,-2,6,4,2,0,0,1,-1,1,1,3,1
KR_6760183849,420,0,-18,-24,3,-2,0,2,3,5,2,4,4,0,0,1,1,-2,0,2,0,12,85,-2,5,3,2,0,0,1,-1,0,-1,2,1
KR_6734149945,420,8,79,35,17,1,3,2,9,10,1,5,7,2,1,6,5,1,1,0,0,11,-7,6,4,10,8,0,1,0,-1,1,-1,0,1
KR_6757852713,440,1,2,-24,7,2,5,3,4,8,4,2,3,1,-2,4,6,1,1,0,1,13,1,0,5,5,-3,0,-1,1,1,-1,1,3,1
KR_6628564419,420,0,-4,3,0,-2,1,3,-5,2,7,-1,1,2,4,4,0,4,4,0,0,-1,-7,1,4,5,-1,0,0,1,0,-1,1,4,1
KR_6750003195,420,-1,-33,0,-3,-5,0,5,-4,1,5,3,6,3,2,2,0,1,1,0,0,-2,-3,0,5,5,1,0,1,1,1,1,1,4,1
KR_6703532684,420,5,39,-4,10,0,1,1,2,3,1,2,3,1,6,7,1,0,1,1,1,13,8,1,4,5,1,0,1,-1,1,1,1,5,1
KR_6766880192,420,-3,-29,14,-5,1,2,1,2,2,0,-3,1,4,-2,0,2,-3,0,3,0,-8,-40,0,5,5,15,0,-1,-1,1,1,1,6,1
KR_6749991552,420,3,39,28,5,2,4,2,1,1,0,0,4,4,2,4,2,0,0,0,0,0,-208,0,3,3,1,0,0,1,-1,0,-1,3,1
KR_6763203022,420,2,30,-10,8,-2,0,2,5,5,0,0,4,4,5,5,0,0,0,0,0,10,3,0,6,6,1,0,1,-1,-1,1,1,4,1
KR_6766860877,420,2,-42,-19,11,-1,0,1,2,3,1,7,7,0,3,5,2,0,0,0,1,15,28,1,4,5,-5,0,0,-1,1,1,1,1,1
KR_6755840975,420,5,68,-20,11,1,3,2,0,1,1,3,7,4,4,5,1,3,3,0,0,16,2,0,4,4,4,0,0,1,-1,0,-1,4,1
KR_6758987453,420,5,38,20,6,2,2,0,-1,1,2,2,6,4,6,9,3,-3,0,3,0,7,-8,4,4,8,0,0,2,1,1,1,-1,2,1
KR_6725124758,420,2,45,18,5,2,3,1,-1,1,2,-2,1,3,5,5,0,1,1,0,0,5,6,-1,3,2,1,0,1,0,-1,1,-1,0,1
KR_6610090530,420,5,60,44,5,2,2,0,-3,3,6,0,4,4,5,7,2,1,1,0,0,-3,94,1,4,5,1,0,1,1,0,1,1,5,1
KR_6547729496,420,0,88,-20,1,0,0,0,-3,1,4,-1,0,1,5,5,0,0,1,1,1,2,42,-3,7,4,-22,0,0,1,-1,1,1,3,1
KR_6704687555,420,1,-14,23,-2,4,4,0,0,2,2,-3,0,3,-3,0,3,0,0,0,-1,-4,-8,-1,6,5,-2,0,0,-1,1,1,-1,4,1
KR_6767440989,420,3,99,15,0,1,3,2,1,2,1,-4,1,5,4,6,2,-2,0,2,0,1,-8,-1,4,3,2,0,0,0,-1,0,-1,0,1
KR_6766495007,420,7,69,28,20,6,6,0,0,4,4,3,3,0,6,9,3,5,5,0,0,18,-11,-6,8,2,0,0,2,1,-1,1,1,6,1
KR_6767526473,420,1,48,10,7,1,3,2,0,1,1,9,12,3,-2,2,4,-1,0,1,2,9,-11,-8,11,3,20,0,0,1,1,-1,1,3,1
KR_6757604814,420,1,-51,9,5,5,5,0,1,5,4,1,2,1,0,2,2,-2,0,2,0,-2,-4,-3,5,2,-2,0,1,-1,1,1,1,6,1
KR_6646023588,420,6,106,0,13,1,1,0,4,5,1,5,7,2,2,2,0,1,1,0,0,12,-8,1,3,4,1,0,2,1,-1,1,1,1,1
KR_6742070913,420,0,-10,-12,-1,-2,1,3,0,1,1,0,2,2,1,4,3,0,3,3,0,1,-12,1,5,6,-1,0,0,-1,1,0,-1,2,1
KR_6754791090,420,1,81,-9,7,2,4,2,-3,3,6,3,3,0,3,4,1,2,2,0,0,0,10,4,0,4,1,0,1,1,-1,1,-1,1,1
KR_6764799253,420,2,-24,11,-1,3,3,0,-4,1,5,-3,3,6,0,2,2,3,3,0,0,-2,-4,-2,7,5,6,0,0,1,0,0,1,2,1
KR_6720782310,440,1,-57,5,-1,-2,1,3,2,5,3,0,1,1,-3,1,4,2,2,0,0,-7,-8,-3,5,2,0,0,0,-1,1,1,-1,4,1
KR_6738360959,420,4,95,-5,6,1,3,2,-1,0,1,1,3,2,4,4,0,1,2,1,0,4,-12,-2,4,2,4,0,1,1,1,1,1,3,1
KR_6608735625,420,-1,27,1,6,-3,1,4,7,8,1,3,5,2,-1,3,4,0,2,2,0,7,21,3,7,10,-6,0,0,-1,1,1,1,3,1
KR_6752717813,440,4,91,26,7,5,7,2,1,4,3,0,4,4,0,4,4,1,1,0,0,1,-5,0,3,3,-5,0,1,1,1,1,1,5,1
KR_6759430356,420,0,47,-12,-5,-2,1,3,0,4,4,1,2,1,-7,0,7,3,4,1,0,-9,-63,-3,4,1,-1,0,0,1,-1,0,1,3,1
KR_6762969536,440,3,-16,16,5,1,2,1,-1,1,2,4,5,1,-1,2,3,2,2,0,0,11,37,0,5,5,6,0,0,1,0,1,1,1,1
KR_6723155231,440,-3,-81,-12,1,-6,1,7,-1,1,2,-2,3,5,6,10,4,4,4,0,0,3,7,4,1,5,-1,0,0,1,1,0,1,2,1
KR_6718227019,420,1,-15,-20,3,2,2,0,-2,1,3,0,2,2,2,2,0,1,1,0,0,-2,17,0,4,4,0,0,0,-1,1,1,1,5,1
KR_6751869682,420,1,-20,0,6,1,2,1,2,3,1,6,7,1,-3,2,5,0,3,3,0,-2,362,1,7,8,2,0,1,1,1,1,1,1,1
KR_6762749486,420,-1,40,-20,1,0,0,0,-1,1,2,6,6,0,-3,3,6,-1,0,1,2,6,-16,2,3,5,3,0,0,1,-1,-1,1,2,1
KR_6760501653,420,4,54,20,6,-1,0,1,6,9,3,5,7,2,-3,1,4,-1,1,2,2,9,15,4,5,9,1,0,0,1,0,0,1,1,1
KR_6713762438,440,3,36,25,14,0,0,0,2,2,0,0,2,2,12,12,0,0,1,1,0,16,30,1,3,4,-29,0,1,1,1,1,1,4,1
KR_6573247994,420,2,29,-15,8,4,4,0,2,3,1,-4,1,5,8,10,2,-2,1,3,0,7,-148,0,6,6,3,0,2,1,1,-1,1,2,1
KR_6761886236,420,1,56,-8,-5,-3,0,3,4,5,1,0,6,6,-4,2,6,-2,0,2,-1,-14,3,2,4,6,-6,0,0,0,1,0,-1,0,1
KR_6731349990,420,1,38,17,5,-1,3,4,1,4,3,-1,2,3,3,5,2,3,3,0,0,11,-1,3,2,5,1,0,-1,1,-1,-1,1,5,1
KR_6758912158,420,1,5,-9,3,1,1,0,2,4,2,-1,2,3,1,2,1,0,0,0,0,-3,-5,0,2,2,1,0,0,-1,1,1,1,3,1
KR_6728150684,420,4,66,-20,5,-6,0,6,5,6,1,-2,2,4,9,10,1,-1,0,1,0,16,222,0,5,5,1,0,0,1,-1,-1,1,4,1
KR_6758676534,440,3,19,-1,6,-1,3,4,-3,3,6,5,7,2,2,4,2,3,3,0,0,2,9,0,6,6,-1,0,0,-1,1,1,-1,6,1
KR_6736801448,440,7,113,36,16,6,6,0,5,5,0,0,1,1,2,4,2,3,5,2,1,8,1,1,4,5,3,0,2,1,1,1,1,1,1
KR_6748688179,420,3,55,-4,-1,-1,0,1,1,2,1,0,5,5,-5,3,8,4,4,0,1,1,-2,2,0,2,0,0,1,-1,1,1,1,5,1
KR_6557707723,420,-1,-14,16,-4,-2,3,5,1,4,3,0,1,1,-3,1,4,0,1,1,0,-6,-1,-1,5,4,3,0,-2,-1,-1,-1,1,5,1
KR_6646473124,420,0,5,-8,4,5,5,0,1,1,0,3,4,1,-4,2,6,-1,1,2,0,5,-1,3,3,6,-2,0,0,1,1,1,1,2,1
KR_6577799508,420,-4,-131,-22,-11,-10,0,10,0,4,4,0,2,2,-2,0,2,1,1,0,0,1,-4,4,2,6,-1,0,-2,1,-1,-1,-1,3,1
KR_6659162473,440,-2,8,8,-4,2,4,2,0,2,2,-9,1,10,4,5,1,-1,0,1,0,-1,58,-3,3,0,-18,0,0,-1,-1,0,1,3,1
KR_6649480060,420,3,4,-1,8,2,3,1,-1,2,3,3,3,0,1,2,1,3,3,0,0,9,3,-3,6,3,1,0,1,1,-1,1,1,1,1
KR_6759904449,440,2,41,43,2,1,2,1,-1,0,1,0,2,2,-1,2,3,3,4,1,0,5,2,2,1,3,-2,0,1,-1,1,1,-1,1,1
KR_6703315514,440,0,-23,44,1,-1,0,1,0,1,1,5,5,0,-4,0,4,1,5,4,0,-4,-2,-1,2,1,-1,0,0,1,0,0,-1,4,1
KR_6767262339,420,3,45,0,0,0,1,1,0,1,1,-1,1,2,1,2,1,0,1,1,0,1,-2,-3,5,2,3,0,0,1,-1,0,-1,4,1
KR_6758165965,420,3,26,4,11,2,5,3,-3,0,3,12,13,1,-1,2,3,1,2,1,-1,-4,-2,-1,4,3,4,0,1,0,1,1,-1,0,1
KR_6767387200,420,3,22,-8,8,3,3,0,-1,1,2,2,4,2,2,4,2,2,2,0,1,12,8,3,2,5,1,0,1,-1,1,1,1,4,1
KR_6714639814,420,4,38,16,11,4,5,1,4,4,0,1,4,3,2,4,2,0,0,0,0,8,-26,2,3,5,-3,0,0,1,-1,1,1,6,1
KR_6762398579,420,3,-9,-20,9,0,0,0,0,1,1,5,5,0,2,6,4,2,2,0,0,4,0,-3,5,2,1,0,0,1,-1,1,1,1,1
KR_6681455897,420,5,35,40,14,1,3,2,4,6,2,5,5,0,4,4,0,0,1,1,0,7,-13,-5,8,3,6,0,1,1,1,1,1,2,1
KR_6758241388,420,0,-15,-26,7,3,3,0,1,3,2,3,6,3,0,1,1,0,2,2,0,8,20,7,3,10,-4,0,1,1,1,1,1,4,1
KR_6746739453,420,2,-45,8,8,4,5,1,0,2,2,4,4,0,2,3,1,-2,2,4,0,2,-36,3,2,5,-1,0,1,1,1,1,1,2,1
KR_6702830859,420,4,112,8,5,-2,2,4,5,6,1,1,5,4,1,4,3,0,1,1,1,7,240,-3,7,4,3,0,1,1,1,1,1,6,1
KR_6768011512,420,1,-13,12,1,5,5,0,-3,1,4,1,2,1,-6,1,7,4,4,0,0,-6,2,3,4,7,-2,0,0,-1,1,1,1,4,1
KR_6757240605,420,4,106,32,9,1,1,0,4,5,1,0,3,3,2,2,0,2,2,0,0,10,3,-3,4,1,3,0,1,1,0,1,-1,3,1
KR_6658347609,420,0,37,-12,-2,0,1,1,4,7,3,0,2,2,-5,0,5,-1,1,2,0,-9,30,-5,6,1,1,0,0,1,-1,1,1,6,1
KR_6650191275,420,4,93,32,3,2,3,1,1,3,2,0,4,4,2,2,0,-2,1,3,-1,4,57,0,3,3,-27,0,1,1,-1,1,-1,2,1
KR_6594431243,420,4,-25,22,9,1,2,1,6,8,2,2,4,2,0,4,4,0,0,0,0,17,42,0,8,8,2,0,2,1,1,1,-1,5,1
KR_6619613698,420,4,8,32,5,1,3,2,1,2,1,-1,1,2,-1,1,2,5,6,1,0,6,0,0,4,4,7,0,0,-1,-1,-1,-1,5,1
KR_6768066672,420,3,84,-8,11,2,2,0,5,7,2,1,2,1,2,3,1,1,1,0,0,8,-118,-3,4,1,2,0,2,-1,1,1,1,2,1
KR_6738283973,440,0,-4,14,2,0,2,2,5,5,0,-3,1,4,3,4,1,-3,0,3,1,5,-1,0,4,4,4,0,1,1,1,1,1,1,1
KR_6745286491,420,6,56,16,5,4,5,1,4,6,2,1,3,2,-1,2,3,-3,0,3,0,3,3,1,8,9,0,0,0,1,1,1,-1,5,1
KR_6743527996,420,3,4,28,2,-1,0,1,0,2,2,0,2,2,3,7,4,0,1,1,0,2,22,2,0,2,-2,0,0,1,1,1,-1,6,1
KR_6762305289,420,-1,-13,-4,-2,-2,0,2,-4,4,8,-1,0,1,4,5,1,1,2,1,0,-5,-2,-2,3,1,-1,0,0,0,1,0,-1,0,1
KR_6765576579,420,-4,-39,-16,-9,-3,0,3,0,2,2,-5,0,5,-1,3,4,0,0,0,0,-12,33,-4,5,1,-16,0,-1,1,-1,-1,-1,3,1
KR_6755284959,420,4,118,20,9,5,5,0,1,2,1,-2,0,2,3,3,0,2,2,0,0,4,5,-1,2,1,0,0,4,1,1,1,1,1,1
KR_6685016656,420,-1,19,20,6,4,4,0,4,5,1,-3,1,4,1,4,3,0,1,1,0,1,4,6,2,8,-2,0,1,1,1,1,1,1,1
KR_6671328568,420,-3,2,31,-3,-3,2,5,-1,3,4,2,4,2,-2,1,3,1,1,0,1,7,-1,-3,4,1,1,0,0,-1,1,-1,1,3,1
KR_6648530374,420,2,-42,-11,13,4,5,1,0,4,4,3,5,2,3,7,4,3,3,0,2,22,16,-1,5,4,-3,0,0,1,-1,1,-1,3,1
KR_6615660664,420,1,-19,26,3,1,1,0,3,5,2,2,3,1,-2,0,2,-1,0,1,0,1,32,0,4,4,0,0,-1,0,0,-1,1,0,1
KR_6463228554,420,2,1,43,8,3,5,2,5,5,0,5,8,3,-4,1,5,-1,0,1,0,8,-2,5,1,6,4,0,0,1,1,1,1,3,1
KR_6449224178,420,3,43,4,0,-3,0,3,2,6,4,3,3,0,-1,2,3,-1,1,2,0,3,-5,5,2,7,3,0,2,1,1,1,1,1,1
KR_6558814607,420,1,41,-40,-3,-3,3,6,0,2,2,3,4,1,-2,1,3,-1,0,1,0,0,-10,-3,5,2,1,0,-1,1,-1,-1,-1,6,1
KR_6715400137,420,2,97,15,1,1,2,1,2,3,1,-2,2,4,1,1,0,-1,0,1,0,2,-5,1,3,4,2,0,0,1,-1,0,-1,1,1
KR_6754949494,420,4,57,35,13,2,2,0,1,3,2,10,10,0,-2,0,2,2,2,0,0,11,-10,-4,6,2,3,0,1,1,1,1,-1,5,1
KR_6662546082,420,4,83,-1,8,0,0,0,2,3,1,4,6,2,3,5,2,-1,1,2,0,9,-6,3,3,6,2,0,3,1,1,1,1,6,1
KR_6762714337,440,-2,-22,-8,-5,-1,1,2,-1,2,3,1,1,0,-3,2,5,-1,2,3,0,-8,4,-1,3,2,0,0,-1,1,-1,-1,-1,3,1
KR_6754660546,420,9,169,38,22,-1,2,3,2,3,1,9,10,1,11,11,0,1,1,0,-1,22,-3,-2,6,4,1,1,4,1,1,1,-1,1,1
KR_6706625856,420,2,-69,46,8,4,4,0,6,7,1,1,3,2,-4,1,5,1,3,2,0,2,-4,-1,3,2,-2,0,0,1,1,1,1,4,1
KR_6717153118,420,5,30,0,5,1,2,1,2,3,1,0,2,2,2,3,1,0,1,1,0,6,-3,2,3,5,-1,0,0,1,0,0,1,6,1
KR_6757920120,420,4,82,6,2,2,3,1,1,1,0,-3,1,4,1,1,0,1,1,0,0,3,9,4,0,4,0,0,2,1,-1,1,-1,2,1
KR_6764075546,420,7,118,12,14,1,1,0,1,2,1,2,4,2,1,3,2,9,9,0,0,15,48,3,3,6,-23,0,1,-1,1,1,1,2,1
KR_6750561820,420,2,93,24,4,1,1,0,-2,1,3,-1,2,3,3,3,0,3,3,0,0,0,4,-2,5,3,5,0,0,1,1,1,1,5,1
KR_6758188650,420,3,19,24,1,-1,1,2,-1,2,3,1,1,0,1,4,3,1,2,1,0,2,138,2,5,7,-5,0,1,-1,1,1,-1,4,1
KR_6763220514,420,4,85,18,7,0,1,1,1,3,2,2,3,1,3,6,3,1,1,0,0,2,48,5,1,6,-20,0,4,-1,1,1,1,5,1
KR_6721288500,420,2,-81,78,1,0,2,2,3,4,1,0,2,2,-1,2,3,-1,0,1,0,-2,303,-5,5,0,1,0,-2,1,1,-1,-1,2,1
KR_6766949153,420,3,-38,1,9,0,3,3,2,7,5,5,5,0,1,4,3,1,1,0,0,12,5,2,7,9,-3,0,1,0,1,1,1,0,1
KR_6645047612,420,1,-10,-16,8,1,2,1,4,4,0,-2,2,4,4,7,3,1,1,0,2,20,-7,2,3,5,0,0,0,1,-1,-1,1,3,1
KR_6757379605,440,4,55,17,15,12,13,1,2,4,2,2,2,0,-4,1,5,3,4,1,0,4,2,3,2,5,1,0,-1,1,0,1,1,4,1
KR_6727452698,420,2,83,0,6,2,2,0,-1,1,2,5,7,2,0,2,2,0,0,0,0,5,-1,0,4,4,3,0,1,1,1,1,1,1,1
KR_6767249650,420,-1,57,19,-3,2,4,2,1,5,4,-1,1,2,1,3,2,-6,0,6,0,-11,14,6,3,9,-2,0,2,-1,1,1,-1,4,1
KR_6752215414,420,3,-28,4,3,-2,2,4,0,4,4,-1,1,2,1,2,1,5,6,1,0,3,-4,-1,7,6,-2,0,0,-1,-1,-1,-1,4,1
KR_6716328733,420,-1,-36,-4,7,1,1,0,5,6,1,3,7,4,0,1,1,-2,0,2,0,-7,-23,-2,5,3,16,0,1,1,1,1,1,6,1
KR_6198183108,420,1,23,21,3,4,4,0,-3,0,3,0,1,1,2,2,0,0,0,0,0,-3,4,-1,5,4,-3,0,1,1,1,1,1,3,1
KR_6740381424,420,-2,-32,-19,-8,1,3,2,-3,1,4,-5,0,5,-1,3,4,0,2,2,0,0,-4,-8,9,1,7,0,-1,1,-1,-1,-1,6,1
KR_6638511175,420,4,15,20,4,0,0,0,2,4,2,4,4,0,-2,0,2,0,0,0,0,0,6,-2,5,3,1,0,0,-1,1,1,-1,2,1
KR_6656640680,420,-1,-72,-2,0,0,1,1,0,2,2,3,3,0,-2,0,2,-1,0,1,0,2,-11,-3,6,3,-1,0,0,0,-1,0,1,0,1
KR_6759872361,420,1,-7,7,1,1,1,0,0,2,2,0,3,3,-1,0,1,1,2,1,0,-9,112,-4,7,3,-1,0,0,-1,1,0,1,4,1
KR_6706377955,420,1,-29,26,3,0,1,1,1,3,2,1,3,2,-1,2,3,2,5,3,1,3,-1,0,3,3,2,0,-1,1,1,-1,1,5,1
KR_6761280238,420,-2,14,-37,-1,3,4,1,0,6,6,0,6,6,-1,2,3,-3,0,3,0,-13,295,-2,4,2,0,0,0,-1,1,0,-1,5,1
KR_6214574990,420,-2,-7,0,0,6,6,0,-1,0,1,0,2,2,-4,1,5,-1,1,2,0,-3,-3,1,4,5,1,0,-1,1,1,-1,-1,1,1
KR_6739982268,420,6,61,37,14,8,8,0,1,3,2,3,3,0,3,4,1,-1,1,2,0,3,-6,1,4,5,1,0,4,1,1,1,1,3,1
KR_6683853292,420,5,89,40,11,3,3,0,4,4,0,1,3,2,2,3,1,1,2,1,0,4,12,-2,5,3,2,0,0,-1,0,1,1,6,1
KR_6712207054,440,0,34,4,4,-2,1,3,6,8,2,-4,1,5,4,10,6,0,2,2,1,5,-50,-1,6,5,17,0,1,1,1,1,1,6,1
KR_6763960597,420,-1,46,-8,-5,-3,0,3,-2,1,3,-2,1,3,-2,1,3,4,4,0,0,-6,-1,2,2,4,1,0,0,1,-1,0,-1,6,1
KR_6702942677,440,6,170,-8,10,3,7,4,3,4,1,-2,4,6,6,6,0,0,0,0,0,6,5,5,2,7,1,0,2,1,1,1,1,2,1
KR_6714885287,420,0,48,-5,-1,2,5,3,-2,0,2,0,2,2,1,1,0,-2,0,2,0,-4,-211,6,1,7,-3,0,2,0,1,1,1,0,1
KR_6738909380,420,4,-4,40,4,1,2,1,3,5,2,1,2,1,0,3,3,-1,2,3,1,3,-29,-2,6,4,5,0,0,0,0,1,1,0,1
KR_6768409772,420,0,21,-15,5,0,3,3,-2,1,3,1,3,2,11,11,0,-5,1,6,1,7,3,0,2,2,5,0,1,1,1,1,1,2,1
KR_6699780205,420,6,123,60,13,3,4,1,2,3,1,8,10,2,-1,0,1,1,1,0,0,12,-5,1,4,5,3,0,0,1,0,1,1,3,1
KR_6767798296,420,5,54,0,13,1,2,1,4,5,1,2,3,1,6,8,2,0,1,1,0,9,1,-2,4,2,4,0,2,1,-1,1,1,1,1
KR_6724036076,420,-1,-28,4,3,-4,0,4,-2,0,2,3,5,2,5,7,2,1,2,1,1,13,-28,-2,3,1,2,0,0,1,-1,1,1,5,1
KR_6766554375,440,2,-12,24,4,-7,0,7,7,7,0,4,4,0,0,3,3,0,0,0,0,3,0,0,2,2,-1,0,1,1,0,1,1,4,1
KR_6759483575,420,-1,-25,-2,-3,-4,1,5,4,5,1,-1,2,3,-1,4,5,-1,0,1,-3,1,-12,1,4,5,6,0,-1,-1,1,-1,1,1,1
KR_6567558640,420,0,41,-10,7,2,2,0,1,1,0,2,3,1,-1,2,3,3,4,1,1,7,-3,1,3,4,-3,0,0,-1,-1,1,1,1,1
KR_6761316795,440,7,92,4,9,3,3,0,2,2,0,1,1,0,2,3,1,1,2,1,0,8,0,2,4,6,-3,0,3,1,1,1,-1,1,1
KR_6767019487,440,0,-14,16,-3,1,1,0,-1,2,3,-3,0,3,0,1,1,0,0,0,0,-4,6,-2,4,2,4,0,-1,1,0,-1,-1,1,1
KR_6767542106,420,2,13,16,9,2,2,0,3,3,0,0,2,2,1,4,3,3,3,0,0,12,140,-2,6,4,0,0,1,-1,1,1,1,4,1
KR_6752904516,420,-2,-49,-48,-4,1,1,0,3,6,3,1,1,0,-5,1,6,-4,0,4,0,-5,102,2,5,7,-3,0,-1,-1,1,-1,-1,6,1
KR_6621418050,420,-1,28,-4,-1,-3,0,3,2,6,4,0,2,2,1,5,4,-1,3,4,0,-4,-14,-2,5,3,7,0,0,1,1,0,-1,3,1
KR_6753392678,420,5,64,-43,8,3,4,1,3,3,0,0,1,1,1,3,2,1,1,0,0,8,-18,-4,8,4,2,0,1,1,-1,1,1,6,1
KR_6763904370,440,6,88,20,13,0,1,1,3,3,0,6,6,0,0,2,2,4,4,0,0,11,11,4,0,4,-2,0,4,0,1,1,1,0,1
KR_6704513376,420,2,69,-36,4,3,3,0,4,6,2,3,6,3,-4,0,4,-2,0,2,0,0,4,-4,6,2,1,0,-1,-1,-1,-1,-1,6,1
KR_6757426133,420,3,45,24,0,2,2,0,-2,1,3,-3,1,4,3,8,5,0,1,1,0,3,-93,-2,3,1,-2,0,1,-1,1,1,1,2,1
KR_6669325534,420,3,55,15,15,3,3,0,6,7,1,5,7,2,1,3,2,0,1,1,0,6,-17,-1,3,2,1,0,0,1,1,0,1,2,1
KR_6626543832,420,3,80,0,-1,4,4,0,1,4,3,0,2,2,-9,1,10,3,3,0,1,-2,12,5,2,7,-2,0,1,1,1,1,1,4,1
KR_6740129262,440,3,-19,16,1,1,1,0,2,4,2,1,1,0,-3,1,4,0,1,1,-2,9,57,-6,7,1,2,0,0,1,0,0,-1,6,1
KR_6757938103,420,3,59,-12,10,4,4,0,7,9,2,0,2,2,2,4,2,-3,1,4,0,5,13,4,3,7,-8,0,1,1,1,1,1,6,1
KR_6750478494,420,4,29,4,7,1,1,0,1,3,2,7,8,1,0,3,3,-2,2,4,-1,1,4,-1,7,6,5,0,1,1,-1,1,-1,2,1
KR_6700599562,420,5,91,21,7,2,2,0,2,4,2,0,1,1,2,3,1,1,1,0,0,8,-2,0,4,4,3,0,2,1,1,1,1,6,1
KR_6704743557,440,9,76,53,19,3,6,3,3,4,1,6,9,3,4,6,2,3,4,1,0,17,1,3,3,6,1,0,4,1,1,1,1,3,1
KR_6580063307,420,3,49,24,2,1,1,0,0,3,3,1,2,1,0,3,3,0,1,1,0,0,-44,1,6,7,22,0,2,1,1,1,1,5,1
KR_6756797391,420,5,98,45,7,3,3,0,0,2,2,1,3,2,2,3,1,1,1,0,0,11,-5,0,3,3,2,0,1,1,1,1,-1,3,1
KR_6475891076,420,-3,9,-20,2,-3,0,3,3,5,2,0,0,0,2,5,3,0,0,0,1,8,-9,-3,11,8,2,0,0,1,0,0,1,3,1
KR_6766059861,420,2,69,12,1,-1,4,5,-1,2,3,2,2,0,0,2,2,1,2,1,0,-6,0,0,5,5,-3,0,1,1,-1,1,-1,6,1
KR_6749743210,420,1,17,-2,-4,-4,1,5,1,2,1,-2,1,3,1,5,4,0,2,2,-3,-4,19,4,2,6,-2,0,0,0,1,0,-1,0,1
KR_6760808614,420,-1,38,-24,0,0,1,1,-1,1,2,2,4,2,0,2,2,-1,1,2,0,0,-3,-2,6,4,-3,0,0,1,-1,1,1,1,1
KR_6757773321,420,-3,9,-20,-3,-1,1,2,1,1,0,-3,1,4,-1,1,2,1,1,0,0,2,-38,-3,6,3,17,0,0,-1,1,0,1,6,1
KR_6656495890,420,-1,-33,-8,-6,-8,0,8,-1,2,3,1,5,4,0,5,5,2,2,0,0,6,22,-2,6,4,-2,0,-1,-1,-1,-1,-1,2,1
KR_6558901390,420,3,-25,37,0,0,1,1,-3,3,6,5,6,1,0,1,1,-2,0,2,0,3,5,5,1,6,-2,0,0,1,-1,0,-1,4,1
KR_6755458255,420,1,45,-20,5,1,3,2,-1,1,2,3,3,0,2,5,3,0,1,1,0,0,-5,-2,5,3,1,0,0,-1,1,0,1,3,1
KR_6757640952,420,2,-1,16,11,-1,3,4,2,5,3,5,7,2,4,4,0,1,2,1,-2,7,8,4,0,4,-4,0,1,-1,1,1,-1,3,1
KR_6622737586,420,4,22,40,3,0,2,2,3,4,1,2,2,0,0,5,5,-2,0,2,-1,5,18,7,3,10,-2,0,0,1,1,0,-1,3,1
KR_6732870861,420,3,70,30,12,-1,0,1,5,6,1,2,4,2,2,3,1,4,4,0,0,11,31,-1,7,6,1,0,-1,-1,1,-1,1,5,1
KR_6685772961,420,-1,64,-46,-5,-2,0,2,-2,0,2,-4,0,4,1,3,2,2,2,0,-2,-4,9,3,2,5,0,0,0,-1,1,0,-1,6,1
KR_6762073536,420,6,34,33,5,4,4,0,3,3,0,-1,0,1,-3,1,4,2,2,0,0,2,7,8,3,11,-4,0,1,1,1,-1,-1,2,1
KR_6759882996,420,1,-16,-8,6,1,2,1,2,3,1,-3,1,4,5,8,3,1,1,0,0,12,-43,-1,6,5,17,0,-1,1,0,-1,1,1,1
KR_6760548915,420,-2,-24,-20,-9,-3,2,5,-2,2,4,0,1,1,-1,0,1,-3,1,4,-1,-3,-23,-1,6,5,0,0,0,0,-1,0,-1,0,1
KR_6732413207,420,0,36,-40,4,-3,0,3,-1,2,3,4,5,1,4,5,1,0,1,1,0,8,-120,-3,8,5,0,0,-1,-1,-1,-1,1,6,1
KR_6610219515,420,2,40,12,8,0,1,1,-7,1,8,7,7,0,10,12,2,-2,1,3,0,6,-90,4,2,6,0,0,1,1,-1,1,1,3,1
KR_6699758156,420,-3,62,47,-3,2,3,1,0,4,4,-3,0,3,-4,1,5,2,2,0,0,-6,87,-5,6,1,4,0,3,-1,1,1,-1,3,1
KR_6748925067,420,2,-49,64,5,-1,0,1,3,3,0,4,6,2,-1,1,2,0,1,1,0,7,2,2,6,8,-1,0,0,1,0,0,1,3,1
KR_6671246665,420,1,38,20,6,-1,4,5,3,5,2,3,6,3,2,4,2,-1,1,2,1,4,-4,-2,6,4,3,0,0,1,-1,-1,1,3,1
KR_6750774619,420,-1,-44,4,4,-3,0,3,3,4,1,0,2,2,5,7,2,-1,2,3,0,15,1,-1,5,4,5,0,-1,1,-1,-1,1,4,1
KR_6738239094,420,1,-34,-23,7,1,3,2,1,1,0,-2,0,2,2,4,2,5,6,1,0,5,-28,1,5,6,6,0,-1,1,-1,-1,1,2,1
KR_6743468221,420,0,76,-24,-7,-1,1,2,-2,3,5,-7,1,8,5,7,2,-2,0,2,0,4,-8,-1,6,5,4,0,1,1,-1,1,-1,1,1
KR_6764963632,420,5,-27,24,9,5,6,1,4,6,2,-1,0,1,-1,3,4,2,2,0,0,12,6,5,2,7,-2,0,0,1,1,1,-1,3,1
KR_6762113828,420,0,-6,28,2,2,5,3,-1,4,5,0,0,0,1,3,2,0,1,1,0,0,130,0,4,4,-1,0,0,-1,1,1,1,6,1
KR_6707093263,420,3,61,-9,4,1,2,1,-1,1,2,-1,2,3,4,4,0,1,2,1,0,8,11,3,4,7,0,0,3,1,1,1,1,1,1
KR_6763092951,420,-1,17,-37,4,-1,2,3,3,3,0,1,3,2,3,5,2,-2,1,3,0,12,-3,3,6,9,4,0,0,0,-1,1,1,0,1
KR_6759194134,420,4,29,16,14,3,3,0,3,6,3,5,7,2,0,2,2,3,3,0,0,8,-4,0,4,4,-2,0,1,1,1,1,1,4,1
KR_6739001569,420,6,118,16,18,4,4,0,4,4,0,3,4,1,8,9,1,-1,0,1,0,11,7,4,3,7,3,0,1,1,1,1,1,4,1
KR_6752973170,420,4,85,27,11,-2,0,2,2,3,1,6,6,0,5,7,2,0,1,1,0,16,18,5,1,6,-2,0,2,1,1,1,1,2,1
KR_6641158843,420,4,81,4,9,0,2,2,5,5,0,5,5,0,-1,3,4,0,0,0,0,4,6,1,3,4,6,0,2,1,-1,1,1,3,1
KR_6745178266,420,3,74,28,2,3,3,0,2,3,1,-3,2,5,-1,1,2,1,3,2,0,-3,-7,-1,6,5,5,0,1,1,1,1,1,1,1
KR_6763200728,420,1,14,36,-3,-4,0,4,0,1,1,1,3,2,1,2,1,-1,0,1,0,0,53,3,2,5,-27,0,1,1,-1,1,-1,4,1
KR_6691709198,440,-1,8,-2,-11,-3,1,4,0,3,3,1,5,4,-9,2,11,0,1,1,-2,-14,2,1,2,3,-2,0,0,-1,1,-1,-1,6,1
KR_6767749188,420,1,-7,-3,8,-2,1,3,3,5,2,4,6,2,1,4,3,2,2,0,-1,10,-102,1,2,3,-3,0,-1,1,-1,-1,-1,6,1
KR_6741937739,420,6,38,-6,11,-3,2,5,8,8,0,5,5,0,4,5,1,-3,5,8,3,16,11,0,3,3,2,0,0,-1,1,-1,1,3,1
KR_6691674074,440,-2,-29,-20,2,2,4,2,2,4,2,-5,3,8,5,8,3,-2,0,2,0,0,-2,2,3,5,2,0,-1,-1,1,1,1,2,1
KR_6752073913,440,3,112,-20,9,2,2,0,-4,2,6,2,3,1,6,7,1,3,3,0,0,7,5,1,4,5,4,0,0,1,-1,0,-1,4,1
KR_6759658150,420,5,91,16,15,6,6,0,2,3,1,1,3,2,3,4,1,3,4,1,1,20,11,8,0,8,0,0,3,1,0,1,-1,2,1
KR_6753947535,420,5,9,28,8,4,4,0,3,4,1,-3,1,4,4,5,1,0,4,4,0,6,-1,-1,5,4,2,0,1,0,1,1,1,0,1
KR_6727194352,440,5,19,9,9,2,2,0,0,2,2,1,1,0,4,6,2,2,2,0,0,6,8,4,4,8,3,0,0,1,1,0,1,4,1
KR_6742561613,440,3,-4,42,11,0,0,0,-1,4,5,6,7,1,3,8,5,3,5,2,-1,9,9,3,3,6,1,0,0,1,1,1,-1,2,1
KR_6758810896,420,1,12,9,2,-4,0,4,3,4,1,4,4,0,-4,2,6,3,3,0,0,4,14,5,1,6,0,0,1,1,-1,1,-1,4,1
KR_6550165533,420,3,76,-8,14,-1,1,2,-3,1,4,2,2,0,15,17,2,1,1,0,1,14,-42,3,4,7,25,0,-1,-1,-1,1,1,1,1
KR_6763199497,420,-1,-54,-10,-2,1,2,1,-2,1,3,2,3,1,-3,2,5,0,1,1,-1,2,8,-2,6,4,0,0,1,0,1,1,-1,0,1
KR_6494604549,420,2,42,-16,7,2,2,0,1,4,3,1,1,0,4,4,0,-1,1,2,0,4,-105,1,1,2,1,0,1,1,-1,1,1,1,1
KR_6764299383,420,4,99,24,5,0,2,2,4,5,1,0,2,2,-1,2,3,2,2,0,2,5,44,4,3,7,-14,0,2,1,1,1,1,1,1
KR_6759803545,420,5,27,12,8,3,5,2,0,3,3,5,5,0,0,2,2,0,0,0,1,9,6,1,3,4,-1,0,1,1,1,1,1,6,1
KR_6750932884,420,-3,-28,-24,-5,1,2,1,-2,1,3,3,4,1,-5,0,5,-2,1,3,0,-9,-21,1,4,5,0,0,-1,0,-1,-1,-1,0,1
KR_6762674336,440,4,37,13,15,3,3,0,4,6,2,5,5,0,3,3,0,0,0,0,0,13,86,5,2,7,-8,0,2,1,1,1,1,2,1
KR_6721607127,420,1,30,-16,2,2,3,1,-1,2,3,-2,3,5,2,4,2,1,1,0,0,4,24,-5,7,2,0,0,0,1,-1,0,1,4,1
KR_6737330355,420,3,75,9,13,6,7,1,8,8,0,-3,1,4,0,0,0,2,2,0,0,10,2,1,3,4,2,0,1,1,1,1,1,3,1
KR_6464751446,420,1,49,16,-2,-1,1,2,1,2,1,-2,1,3,-2,3,5,2,3,1,0,3,59,-4,7,3,-1,0,-1,1,-1,-1,-1,3,1
KR_6765300059,420,3,63,-13,10,3,4,1,-2,4,6,1,3,2,1,4,3,7,9,2,1,8,-10,-2,2,0,1,0,0,0,0,1,1,0,1
KR_6758140091,420,4,89,-5,1,0,2,2,-6,0,6,-2,0,2,7,8,1,2,2,0,0,5,-4,-5,10,5,2,0,0,-1,-1,1,-1,5,1
KR_6761982156,420,1,-19,40,5,0,1,1,7,7,0,1,5,4,-5,1,6,2,3,1,0,6,39,-1,2,1,-23,0,0,1,1,0,1,5,1
KR_6744568519,420,5,5,60,10,-1,3,4,4,5,1,3,4,1,2,2,0,2,2,0,0,14,62,3,2,5,4,0,1,1,1,1,1,3,1
KR_6738681437,420,3,77,-5,5,5,5,0,-4,3,7,-1,2,3,1,4,3,4,4,0,0,-1,15,-3,5,2,2,0,1,-1,-1,1,1,1,1
KR_6725984325,420,-1,-12,-43,-5,0,1,1,-1,2,3,-5,1,6,3,5,2,-2,1,3,0,-2,1,2,2,4,2,0,0,1,-1,1,-1,5,1
KR_6698219355,420,6,89,39,13,-4,1,5,4,5,1,5,7,2,4,5,1,4,5,1,1,14,12,-2,5,3,0,0,1,0,1,1,-1,0,1
KR_6764298931,420,3,59,27,7,0,0,0,2,2,0,7,9,2,-2,1,3,0,0,0,0,3,1,1,4,5,3,0,1,1,1,1,1,4,1
KR_6738985501,420,4,43,20,10,0,2,2,1,1,0,1,2,1,3,5,2,5,6,1,0,10,-6,0,2,2,5,0,0,1,0,-1,1,4,1
KR_6759929091,420,-3,-34,16,0,-2,2,4,-1,2,3,0,1,1,5,5,0,-2,0,2,0,2,5,5,3,8,1,0,0,-1,1,-1,1,6,1
KR_6760624553,420,1,46,8,3,0,1,1,2,4,2,-2,4,6,3,6,3,0,0,0,1,10,313,4,1,5,-2,0,1,-1,1,1,1,6,1
KR_6666796524,420,1,16,8,0,8,10,2,0,3,3,-1,1,2,-5,0,5,-2,0,2,2,-7,317,3,4,7,-1,0,1,0,1,1,1,0,1
KR_6210698297,420,7,-6,10,14,8,8,0,2,3,1,0,0,0,0,2,2,4,5,1,0,6,187,5,3,8,-2,0,3,-1,1,1,1,1,1
KR_5830496092,420,-2,-9,-7,-4,-2,0,2,-2,3,5,0,0,0,1,2,1,-1,0,1,0,-3,-10,-3,8,5,4,0,0,1,-1,0,1,5,1
KR_6724137366,420,2,35,8,10,1,2,1,-4,2,6,3,3,0,6,6,0,4,4,0,0,14,-11,0,4,4,-1,0,3,1,1,1,-1,5,1
KR_6763131983,420,5,91,-45,17,4,5,1,-1,1,2,2,4,2,4,4,0,8,8,0,0,10,10,4,2,6,4,0,2,1,1,1,1,2,1
KR_6733084463,420,-1,-29,-29,4,5,6,1,2,3,1,3,6,3,-2,1,3,-4,1,5,0,10,-126,-2,6,4,2,0,-1,-1,-1,-1,-1,3,1
KR_6752892373,420,-1,29,-4,-3,0,3,3,-1,2,3,1,2,1,2,4,2,-5,0,5,0,-4,-36,-4,5,1,7,0,-2,1,-1,-1,-1,4,1
KR_6767580886,420,2,45,12,8,-2,1,3,1,1,0,1,3,2,6,8,2,2,2,0,1,6,-31,-5,7,2,-3,0,0,1,0,1,1,1,1
KR_6682811478,440,6,-14,3,17,0,3,3,7,8,1,5,5,0,3,4,1,2,2,0,1,24,-133,2,3,5,0,0,0,1,1,1,1,3,1
KR_6757442203,420,-1,-9,-12,-7,-2,2,4,-4,1,5,-4,0,4,3,7,4,0,2,2,0,4,-12,-1,3,2,0,0,0,1,1,0,-1,5,1
KR_6743470913,420,-2,-5,-22,-3,0,0,0,0,2,2,0,4,4,-2,4,6,-1,1,2,0,4,-34,0,5,5,4,0,-2,1,0,-1,-1,3,1
KR_6767510470,440,2,31,2,7,2,3,1,0,1,1,6,7,1,2,4,2,-3,0,3,2,7,5,3,5,8,-4,0,0,1,0,1,-1,4,1
KR_6718394268,420,0,24,-1,-1,0,0,0,-2,0,2,-3,0,3,4,4,0,0,0,0,0,5,0,0,2,2,0,0,0,-1,-1,0,-1,5,1
KR_6717206932,420,4,-35,28,10,7,7,0,5,6,1,-4,2,6,1,1,0,1,1,0,1,17,-2,0,4,4,2,0,1,1,1,1,1,1,1
KR_6548254607,420,3,-18,14,13,-3,0,3,-2,1,3,11,12,1,5,5,0,2,2,0,0,5,10,5,0,5,-1,0,1,1,-1,-1,1,6,1
KR_6768321050,420,0,8,11,0,2,2,0,1,2,1,-5,2,7,1,3,2,1,1,0,0,3,-1,1,5,6,0,0,1,-1,1,1,-1,5,1
KR_6715491412,420,4,43,17,6,6,7,1,2,2,0,0,3,3,1,5,4,-3,0,3,0,5,-4,-4,8,4,3,0,0,-1,-1,1,-1,2,1
KR_6755402377,420,0,-45,36,-1,-4,0,4,5,5,0,-1,3,4,-1,1,2,0,0,0,0,5,3,1,2,3,-3,0,0,1,0,1,1,2,1
KR_6749353898,420,1,5,-8,4,1,2,1,1,6,5,-1,0,1,3,5,2,0,1,1,0,14,3,4,5,9,-3,0,0,1,-1,0,-1,1,1
KR_6756950574,420,-3,-22,-12,-7,-10,0,10,1,4,3,-1,2,3,1,2,1,2,3,1,1,1,5,2,1,3,1,0,0,1,-1,-1,1,3,1
KR_6713563366,420,0,26,18,-1,0,2,2,0,6,6,3,5,2,-3,2,5,-1,2,3,0,5,4,2,3,5,0,0,-1,-1,-1,-1,1,1,1
KR_6748904631,420,1,28,-4,4,0,0,0,2,4,2,5,5,0,-2,3,5,-1,0,1,1,-2,3,2,3,5,-2,0,1,1,-1,1,1,6,1
KR_6738350095,420,1,-26,24,-3,-3,1,4,2,3,1,-2,1,3,0,1,1,0,1,1,0,-2,114,-4,7,3,0,0,0,-1,-1,0,-1,2,1
KR_6745598917,420,9,52,32,14,6,7,1,3,3,0,2,2,0,0,2,2,3,4,1,0,8,19,-2,6,4,-2,0,3,0,1,1,1,0,1
KR_6716512151,440,3,66,22,7,0,1,1,6,7,1,0,3,3,2,5,3,-1,2,3,0,10,7,7,0,7,3,0,0,1,1,0,1,4,1
KR_6527041728,420,6,59,34,19,7,8,1,3,4,1,-2,2,4,9,9,0,2,3,1,0,16,9,0,2,2,0,0,1,1,1,1,1,6,1
KR_6753691739,420,0,-22,-15,-4,-4,0,4,0,4,4,-2,2,4,2,4,2,0,0,0,0,3,3,0,4,4,-7,0,0,-1,0,0,1,1,1
KR_6664198750,420,1,-38,20,7,2,2,0,1,2,1,1,2,1,1,3,2,2,3,1,0,6,4,0,5,5,-2,0,0,1,-1,0,1,3,1
KR_6730348858,420,2,58,34,10,3,5,2,5,5,0,2,5,3,-2,1,3,2,2,0,0,6,-12,0,3,3,0,0,0,1,1,1,1,4,1
KR_6764455706,420,4,-4,4,6,2,3,1,-3,2,5,1,1,0,4,4,0,2,2,0,0,13,-8,0,4,4,1,0,1,1,0,1,1,5,1
KR_6713406617,420,0,-32,-40,4,5,5,0,2,2,0,-5,1,6,2,4,2,0,1,1,2,14,4,0,4,4,-2,0,0,-1,1,1,1,4,1
KR_6465346321,420,4,17,51,4,1,1,0,0,1,1,-2,2,4,5,5,0,0,0,0,0,3,12,6,3,9,-2,0,0,1,-1,-1,-1,6,1
KR_6731926291,420,1,34,23,6,2,3,1,-5,0,5,8,9,1,2,5,3,-1,0,1,0,9,17,-4,9,5,4,0,1,1,1,1,1,1,1
KR_6765475076,420,-1,-66,-12,1,1,1,0,3,5,2,1,2,1,0,4,4,-4,1,5,0,6,-2,1,5,6,0,0,0,-1,1,0,1,1,1
KR_6713558058,420,2,27,24,-3,-3,1,4,2,2,0,-3,4,7,4,5,1,-3,1,4,0,0,17,0,6,6,-9,0,-1,1,-1,1,-1,3,1
KR_6767542271,420,0,11,-35,-6,-5,1,6,0,2,2,-4,1,5,2,2,0,1,1,0,0,-1,-12,-2,2,0,5,0,0,-1,-1,-1,-1,1,1
KR_6767865845,420,3,86,41,-4,-1,0,1,-3,2,5,0,0,0,0,2,2,0,1,1,0,-3,-118,-1,6,5,8,0,-1,-1,1,-1,-1,4,1
KR_6754528857,420,3,101,32,9,5,6,1,3,4,1,-2,2,4,3,3,0,0,0,0,0,8,0,3,2,5,-1,0,1,0,1,1,1,0,1
KR_6763025644,420,2,7,3,6,-1,1,2,1,1,0,3,9,6,4,8,4,-1,1,2,0,7,2,2,1,3,1,0,1,1,1,1,1,1,1
KR_6744247906,420,4,51,16,7,6,6,0,-1,1,2,5,5,0,-3,1,4,0,0,0,-1,0,-35,2,5,7,13,0,2,1,1,1,-1,6,1
KR_6619694689,420,2,13,14,15,0,1,1,-1,4,5,9,10,1,1,2,1,6,8,2,1,9,23,6,2,8,-4,0,2,1,1,1,1,2,1
KR_6761809520,440,2,14,4,13,-3,0,3,9,9,0,3,4,1,2,2,0,2,3,1,0,17,-2,-2,4,2,0,0,-2,1,1,-1,1,6,1
KR_6603176969,420,4,76,-4,9,2,3,1,5,7,2,1,2,1,-2,3,5,3,4,1,0,10,-10,-1,5,4,4,0,0,1,-1,-1,-1,2,1
KR_6765578959,420,3,-27,22,3,5,7,2,-3,2,5,1,6,5,0,3,3,0,0,0,-2,-3,-8,3,1,4,0,0,-1,0,1,1,-1,0,1
KR_6757958174,420,1,67,-22,-2,0,1,1,-5,1,6,1,6,5,0,1,1,2,3,1,0,-8,-15,-2,7,5,4,0,2,1,1,1,1,5,1
KR_6601347724,420,-2,9,24,-8,-2,2,4,1,3,2,-2,1,3,0,4,4,-5,3,8,1,-6,9,5,2,7,-6,0,0,-1,-1,0,1,1,1
KR_6759306976,440,2,47,8,6,0,0,0,2,3,1,0,1,1,1,1,0,3,5,2,0,11,-1,-1,6,5,-5,0,0,-1,-1,-1,1,2,1
KR_6732981299,420,5,0,22,7,0,1,1,3,4,1,3,4,1,2,4,2,-1,1,2,0,4,-1,-3,6,3,3,0,2,1,0,1,1,2,1
KR_6691877769,420,0,-21,36,-3,0,3,3,3,6,3,3,4,1,-7,0,7,-2,1,3,0,-4,-112,2,2,4,-2,0,0,0,-1,-1,-1,0,1
KR_6764685861,440,1,-9,17,0,-2,1,3,1,2,1,-1,2,3,3,3,0,-1,0,1,0,2,-193,2,4,6,-3,0,0,1,-1,-1,-1,1,1
KR_6767692944,420,8,96,19,21,0,4,4,14,15,1,3,5,2,5,8,3,-1,2,3,6,12,127,-4,5,1,3,0,1,1,-1,1,1,5,1
KR_6758323043,420,-2,15,17,-11,1,3,2,-1,0,1,-3,4,7,-4,2,6,-4,0,4,0,-18,-1,-3,5,2,-3,0,0,-1,-1,1,-1,6,1
KR_6755402094,420,-1,-99,3,1,1,2,1,-1,1,2,4,6,2,-1,2,3,-2,1,3,0,7,-36,0,5,5,0,0,-1,1,-1,1,-1,2,1
KR_6765463191,420,2,61,3,0,1,2,1,-1,2,3,-5,2,7,5,8,3,0,1,1,0,-3,13,2,3,5,0,0,1,-1,1,1,-1,4,1
KR_6741268838,420,6,33,4,9,3,4,1,-1,1,2,3,4,1,-1,1,2,5,5,0,0,8,30,1,3,4,1,0,1,-1,1,1,1,5,1
KR_6579542481,420,6,34,16,16,2,2,0,4,4,0,6,6,0,1,2,1,3,4,1,0,16,1,-2,5,3,5,0,2,1,1,1,1,5,1
KR_6681147012,440,0,-138,0,10,1,1,0,3,3,0,-2,1,3,9,10,1,-1,2,3,1,21,73,3,3,6,0,0,0,1,1,-1,-1,2,1
KR_6766004283,420,5,44,20,9,-2,0,2,-1,2,3,7,7,0,3,4,1,2,4,2,0,11,11,2,5,7,-2,0,-1,1,-1,1,1,6,1
KR_6749172542,440,0,22,-8,5,5,6,1,0,0,0,1,4,3,-1,2,3,0,1,1,1,7,-9,-1,4,3,3,0,0,1,-1,0,1,5,1
KR_6721495945,420,2,16,11,12,4,5,1,0,1,1,7,9,2,1,2,1,0,3,3,0,13,166,-1,3,2,3,0,2,-1,1,1,1,2,1
KR_6688296757,420,-2,-33,-4,2,1,2,1,0,4,4,-1,0,1,2,4,2,0,2,2,0,0,97,3,5,8,26,0,1,-1,-1,1,1,5,1
KR_6356007488,420,1,-37,8,-1,-1,2,3,3,6,3,0,2,2,0,5,5,-3,1,4,0,-7,0,0,0,0,3,0,-2,1,-1,-1,1,3,1
KR_6759498324,420,-6,-43,-16,-16,-1,3,4,2,5,3,-3,1,4,-13,1,14,-1,1,2,0,-12,20,-1,3,2,-1,0,-3,1,-1,-1,-1,4,1
KR_6621434932,420,0,3,41,3,1,1,0,0,1,1,2,3,1,0,3,3,0,0,0,0,2,3,2,3,5,-1,0,0,1,1,0,-1,5,1
KR_6722344888,440,3,11,5,-2,-3,2,5,4,8,4,0,2,2,-1,2,3,-2,1,3,-3,0,8,0,3,3,3,0,0,-1,-1,0,-1,2,1
KR_6687236389,420,2,37,24,-4,-2,2,4,-5,1,6,0,3,3,3,6,3,0,1,1,0,0,44,-3,8,5,-14,0,-1,1,-1,1,-1,3,1
KR_6602333376,420,2,79,24,4,6,7,1,1,3,2,2,4,2,-3,1,4,-2,0,2,0,-3,230,-1,4,3,3,0,2,-1,1,1,-1,3,1
KR_6762734931,420,5,-13,31,14,1,2,1,1,3,2,2,4,2,10,10,0,0,3,3,0,12,7,-1,4,3,-3,0,1,-1,-1,1,1,1,1
KR_6739001250,420,3,113,25,5,2,3,1,0,2,2,-2,1,3,3,3,0,2,2,0,0,6,-4,-1,2,1,0,0,1,1,1,1,1,5,1
KR_6747962000,440,0,34,-16,3,0,2,2,2,5,3,-5,0,5,6,7,1,0,0,0,0,8,116,-9,13,4,6,0,0,-1,-1,1,1,3,1
KR_6731500921,420,-1,99,-35,3,5,6,1,0,1,1,-2,1,3,3,7,4,-3,0,3,0,1,8,2,2,4,-3,0,1,-1,0,1,-1,3,1
KR_6767246614,420,4,10,44,10,4,4,0,1,2,1,3,3,0,0,2,2,2,3,1,0,7,-384,4,0,4,-2,0,1,1,1,1,1,1,1
KR_6768355000,440,6,-5,-5,14,2,4,2,2,4,2,3,3,0,5,6,1,2,3,1,0,18,3,0,3,3,-2,0,2,1,1,1,-1,4,1
KR_6723329542,420,3,91,8,2,-1,2,3,0,2,2,0,3,3,2,3,1,1,3,2,0,3,-15,2,1,3,0,0,0,-1,-1,0,1,2,1
KR_6755604917,420,3,2,6,9,2,4,2,2,3,1,1,4,3,4,7,3,0,1,1,0,18,-5,-3,4,1,0,0,0,1,0,-1,1,6,1
KR_6768391847,420,0,6,-26,5,-1,0,1,-2,1,3,2,4,2,4,6,2,2,4,2,0,6,-19,2,2,4,2,0,-1,0,-1,-1,-1,0,1
KR_6579675940,420,0,48,-2,1,0,4,4,-4,2,6,0,1,1,5,7,2,0,2,2,-1,3,-3,-4,6,2,3,0,2,1,1,1,-1,6,1
KR_6765290445,420,1,35,-3,-2,5,5,0,-3,1,4,1,8,7,-4,2,6,-1,2,3,0,-12,19,0,3,3,-3,0,1,1,-1,1,-1,2,1
KR_6764237207,420,2,61,-10,-5,-4,0,4,3,3,0,1,2,1,-2,5,7,-3,1,4,0,-8,0,1,2,3,-1,0,1,0,-1,1,1,0,1
KR_6559560486,420,-1,16,-16,4,-1,2,3,1,11,10,2,4,2,1,3,2,1,2,1,0,5,-31,12,6,18,12,0,0,1,1,-1,1,1,1
KR_6705104537,420,1,-9,37,4,0,2,2,1,5,4,3,3,0,0,1,1,0,1,1,0,2,-4,0,3,3,0,0,0,1,-1,0,-1,3,1
KR_6764606102,420,2,32,3,12,7,8,1,4,7,3,-1,4,5,1,1,0,1,1,0,0,13,2,4,2,6,6,0,1,1,0,1,1,1,1
KR_6766596948,420,2,-9,40,-6,-2,0,2,-4,4,8,-4,0,4,3,5,2,1,1,0,0,-8,1,-2,4,2,-2,0,-1,1,-1,-1,-1,6,1
KR_6768528609,420,1,53,21,13,-5,1,6,0,2,2,6,8,2,11,12,1,1,1,0,1,4,25,5,5,10,0,0,1,1,0,1,1,5,1
KR_6723678448,420,2,51,-29,3,4,4,0,-1,2,3,1,1,0,0,3,3,-1,2,3,0,-4,-20,6,3,9,1,0,-1,-1,-1,-1,1,6,1
KR_6734058078,420,0,-40,1,-3,0,0,0,-5,2,7,3,4,1,-1,1,2,0,1,1,0,-5,15,-1,8,7,-3,0,0,-1,-1,-1,-1,5,1
KR_6763666140,420,2,20,-22,9,0,3,3,3,6,3,1,2,1,1,1,0,4,5,1,-1,12,3,0,4,4,0,0,0,-1,0,1,-1,4,1
KR_6666000667,420,4,69,36,7,5,5,0,0,5,5,2,4,2,2,3,1,-2,3,5,0,4,-6,-1,5,4,-1,0,1,1,-1,1,1,2,1
KR_6767445860,420,-1,78,-20,1,-1,2,3,-2,3,5,-3,2,5,6,8,2,1,2,1,0,3,-118,-1,5,4,3,0,0,0,0,0,-1,0,1
KR_6747885108,420,2,10,4,7,3,3,0,5,7,2,0,2,2,-2,2,4,1,3,2,1,5,-1,0,1,1,4,0,4,-1,1,1,1,4,1
KR_6689783130,420,1,3,12,1,0,1,1,5,8,3,-5,1,6,0,3,3,1,1,0,0,8,-20,-2,5,3,1,0,0,-1,0,1,1,4,1
KR_6734273176,420,4,90,18,13,6,6,0,-1,2,3,6,7,1,3,3,0,-1,0,1,0,6,4,4,0,4,0,0,3,1,1,1,1,5,1
KR_6651119721,420,-1,66,-25,-1,-2,0,2,-1,4,5,3,4,1,-1,0,1,0,0,0,0,0,-11,0,4,4,1,0,0,-1,-1,1,-1,4,1
KR_6482385790,420,-2,9,31,0,-3,0,3,0,4,4,3,3,0,0,3,3,0,1,1,3,1,392,-3,6,3,-5,0,2,1,-1,1,1,3,1
KR_6724953653,440,3,90,17,-1,-1,4,5,0,1,1,-7,1,8,4,5,1,3,4,1,0,-1,-1,1,3,4,-1,0,0,-1,-1,-1,-1,2,1
KR_6731732758,420,2,13,4,8,0,1,1,0,2,2,4,5,1,2,3,1,2,2,0,0,4,23,2,3,5,-2,0,1,1,1,1,-1,4,1
KR_6762395094,440,2,-8,-2,2,-6,0,6,0,3,3,6,7,1,5,7,2,-3,0,3,0,6,5,3,3,6,0,0,0,-1,-1,-1,-1,1,1
KR_6756478570,420,-1,36,-5,1,-1,1,2,1,4,3,-4,0,4,4,5,1,1,1,0,0,2,16,0,4,4,0,0,0,1,1,0,-1,4,1
KR_6387369738,420,2,-22,20,6,0,0,0,4,5,1,-1,2,3,0,2,2,3,4,1,0,9,14,4,1,5,-3,0,0,1,1,1,1,1,1
KR_6573189411,420,1,20,11,2,-3,3,6,-3,1,4,4,4,0,4,4,0,0,2,2,0,0,-217,-3,7,4,5,0,0,0,1,0,1,0,1
KR_6723167828,420,5,77,-8,14,2,2,0,15,16,1,-4,1,5,1,4,3,0,0,0,-1,23,14,5,2,7,2,0,2,1,1,1,-1,4,1
KR_6758114890,420,4,46,28,6,1,4,3,0,1,1,5,5,0,1,5,4,-1,1,2,1,9,2,4,1,5,0,0,2,1,1,1,1,1,1
KR_6729897990,420,-1,-30,16,0,-1,2,3,-1,0,1,1,2,1,-1,0,1,2,4,2,0,2,3,-2,7,5,-3,0,-1,-1,-1,-1,-1,4,1
KR_6733551287,420,1,31,0,1,-9,0,9,3,4,1,2,4,2,4,6,2,1,1,0,-1,2,-7,-1,4,3,-3,0,-2,1,1,-1,1,3,1
KR_6722065925,420,-1,-38,3,-9,-2,3,5,-3,1,4,1,3,2,-2,3,5,-3,1,4,0,0,-228,-1,4,3,1,0,0,1,-1,-1,-1,3,1
KR_6755716123,420,3,88,-14,12,-1,2,3,0,1,1,4,6,2,2,3,1,7,7,0,2,20,9,2,4,6,5,0,2,1,1,1,1,5,1
KR_6595023657,420,3,14,32,2,0,1,1,2,3,1,1,2,1,-1,0,1,0,0,0,0,2,13,-2,5,3,-1,0,1,1,1,1,-1,4,1
KR_6767814458,420,7,123,43,18,2,4,2,4,6,2,9,10,1,0,3,3,3,3,0,1,17,3,-2,6,4,10,0,1,1,1,1,1,4,1
KR_6634069678,420,4,52,-6,7,-3,0,3,2,4,2,8,10,2,0,3,3,0,1,1,0,8,27,-8,12,4,-1,0,-1,1,-1,-1,1,6,1
KR_6767547632,420,2,76,-3,1,-4,0,4,3,3,0,1,3,2,-1,0,1,2,2,0,1,0,27,1,2,3,0,0,0,-1,1,0,1,4,1
KR_6755307479,420,-4,-22,8,-4,-5,0,5,3,3,0,-4,1,5,2,4,2,0,1,1,0,3,1,0,3,3,-3,0,-3,-1,1,-1,-1,4,1
KR_6765667524,420,-3,-88,-15,-9,-4,0,4,-2,2,4,1,4,3,-1,2,3,-3,1,4,0,-11,1,1,4,5,-5,0,-1,-1,-1,-1,-1,3,1
KR_6713531291,420,-1,30,-6,-4,-2,2,4,3,3,0,-3,0,3,3,4,1,-5,0,5,0,-4,4,1,3,4,1,0,0,-1,-1,0,-1,4,1
KR_6638732110,420,-2,21,-8,1,-1,0,1,-2,0,2,1,4,3,2,7,5,1,2,1,0,1,3,2,2,4,-1,0,-1,1,-1,-1,1,1,1
KR_6748043668,420,-1,-9,8,-4,0,2,2,-6,0,6,4,5,1,-2,2,4,0,1,1,0,-10,-207,-1,6,5,3,0,0,-1,1,1,1,2,1
KR_6763799412,420,3,-25,58,-3,-2,0,2,2,3,1,-3,1,4,2,4,2,-2,2,4,0,1,-2,-1,4,3,4,0,0,1,-1,0,1,5,1
KR_6758892138,420,1,30,3,3,-1,1,2,5,7,2,-1,3,4,0,2,2,0,1,1,0,7,-174,4,3,7,-32,0,2,1,1,1,-1,3,1
KR_6764334807,420,-1,57,23,-2,2,4,2,-6,0,6,1,2,1,1,2,1,0,2,2,0,-9,-1,1,4,5,-1,0,2,0,1,1,1,0,1
KR_6751332663,440,3,62,-6,6,0,1,1,1,1,0,4,5,1,1,2,1,0,2,2,0,9,-5,6,4,10,-4,0,0,1,1,0,1,6,1
KR_6759323433,420,1,8,7,-6,3,3,0,-3,1,4,0,3,3,-4,1,5,-2,0,2,0,-7,9,5,2,7,-5,0,1,-1,1,1,-1,6,1
KR_6768078369,420,5,35,12,15,2,3,1,2,3,1,10,11,1,2,5,3,-1,3,4,0,4,-1,0,1,1,-1,0,0,0,-1,0,-1,0,1
KR_6752601818,420,0,37,40,-5,-2,1,3,2,4,2,-1,2,3,-2,1,3,-2,0,2,0,-3,-33,-3,5,2,2,0,0,1,1,0,-1,2,1
KR_6609354430,420,1,-5,5,8,-1,1,2,-1,4,5,2,3,1,7,8,1,1,1,0,0,14,3,2,3,5,1,0,-1,1,-1,-1,1,3,1
KR_6741217934,420,3,42,26,-1,2,2,0,-1,1,2,-3,0,3,0,0,0,1,1,0,0,-3,3,4,1,5,-3,0,0,1,1,-1,1,3,1
KR_6763978374,420,0,-12,24,3,0,3,3,1,4,3,1,4,3,0,3,3,1,1,0,1,5,-31,-5,9,4,-4,0,0,-1,1,0,-1,1,1
KR_6719202966,420,5,37,34,2,2,3,1,4,8,4,1,3,2,-6,1,7,1,2,1,0,-5,-5,-5,6,1,-1,0,-1,1,-1,-1,-1,1,1
KR_6719222891,440,0,-2,1,0,-2,1,3,8,9,1,-7,1,8,-1,4,5,2,2,0,0,4,-33,4,1,5,17,0,0,-1,1,0,1,2,1
KR_6761656987,420,-4,-101,16,-3,-3,2,5,-4,0,4,1,1,0,4,5,1,-1,1,2,0,-3,7,0,3,3,1,0,-1,-1,1,-1,1,2,1
KR_6676108549,420,2,-9,-4,-3,-1,1,2,0,1,1,-2,1,3,0,4,4,0,1,1,0,-6,-28,0,2,2,1,0,0,1,-1,0,-1,2,1
KR_6642553872,420,-3,-35,20,5,1,4,3,2,5,3,0,2,2,1,4,3,1,1,0,0,2,-114,3,3,6,2,0,1,-1,1,1,-1,1,1
KR_6743602227,420,5,-1,-18,12,1,3,2,2,5,3,8,8,0,0,0,0,1,2,1,0,16,-6,-3,4,1,8,0,0,-1,1,0,1,4,1
KR_6701889380,420,0,36,-8,-2,1,1,0,-1,0,1,-6,2,8,4,5,1,0,0,0,0,6,-11,-5,6,1,5,0,2,1,1,1,-1,5,1
KR_6733140495,420,6,27,27,16,1,3,2,5,5,0,4,6,2,5,7,2,1,2,1,-1,21,0,1,4,5,5,0,0,1,0,1,-1,3,1
KR_6727311378,420,2,-18,58,0,-3,0,3,1,1,0,4,4,0,-1,6,7,-1,2,3,1,8,10,-1,6,5,2,0,1,1,0,1,1,1,1
KR_6685991513,420,8,80,25,25,4,4,0,4,5,1,3,5,2,15,15,0,-1,0,1,1,28,-2,4,1,5,1,0,3,0,1,1,1,0,1
KR_6761353838,420,3,65,17,5,-1,0,1,1,5,4,2,2,0,3,5,2,0,1,1,0,0,-7,-5,8,3,-1,0,0,-1,-1,0,1,6,1
KR_6768507551,420,3,16,24,5,6,6,0,0,2,2,0,1,1,-2,3,5,1,1,0,1,1,-5,1,5,6,-4,0,0,0,1,1,1,0,1
KR_6705138676,420,5,68,0,10,6,6,0,3,5,2,1,1,0,-2,3,5,2,2,0,1,5,1,2,6,8,-3,0,1,-1,1,1,1,1,1
KR_6735111712,420,-1,52,-3,-3,-1,1,2,1,1,0,-1,1,2,-3,1,4,1,1,0,1,-3,18,0,3,3,-2,0,1,0,1,1,1,0,1
KR_6741537307,420,-1,7,-4,7,4,5,1,-4,3,7,7,9,2,-2,2,4,2,3,1,3,16,-19,-2,3,1,-1,0,1,1,1,1,1,3,1
KR_6742084664,440,3,-9,-15,12,-1,1,2,4,4,0,4,5,1,3,5,2,2,2,0,0,21,6,1,4,5,2,0,1,0,-1,1,-1,0,1
KR_6743352841,420,4,61,12,12,-2,0,2,4,7,3,7,7,0,0,3,3,3,3,0,0,15,3,-2,3,1,-1,0,2,1,-1,1,-1,2,1
KR_6749359987,420,2,-28,36,7,-1,3,4,1,4,3,4,4,0,1,3,2,2,3,1,1,2,6,2,4,6,-3,0,0,1,0,0,1,4,1
KR_6763675709,420,1,18,-11,9,2,3,1,0,2,2,4,4,0,1,2,1,2,2,0,0,8,-8,-2,4,2,3,0,0,0,1,1,1,0,1
KR_6711377069,440,2,59,-9,4,-1,0,1,1,1,0,0,4,4,3,3,0,1,1,0,0,3,66,-2,7,5,-5,0,1,1,-1,1,-1,1,1
KR_6732493652,440,-4,-51,-6,-7,-11,0,11,3,5,2,0,0,0,0,4,4,1,2,1,0,1,-18,-1,2,1,1,0,-2,-1,-1,-1,-1,1,1
KR_6765646868,420,4,100,-4,5,7,7,0,-1,1,2,1,3,2,1,3,2,-3,1,4,0,-2,1,1,3,4,-1,0,1,1,1,1,1,6,1
KR_6752324418,420,2,-28,6,8,1,2,1,6,7,1,0,3,3,1,1,0,0,0,0,0,5,-4,-3,6,3,2,0,0,1,-1,0,1,3,1
KR_6767526023,420,4,47,37,7,0,1,1,5,8,3,1,3,2,2,4,2,-1,2,3,0,5,8,0,2,2,1,0,3,1,1,1,1,3,1
KR_6752010306,420,4,55,12,3,0,1,1,-3,2,5,1,2,1,3,4,1,2,4,2,-1,-4,-10,3,5,8,13,0,-1,1,1,-1,-1,4,1
KR_6684058370,420,0,-19,-14,8,-2,2,4,7,9,2,-2,1,3,-1,1,2,6,6,0,0,8,-6,1,3,4,2,0,0,1,1,0,1,5,1
KR_6756553317,420,-2,36,24,-6,-2,2,4,2,2,0,0,4,4,-6,1,7,0,0,0,0,-6,5,3,3,6,-1,0,0,-1,1,1,-1,4,1
KR_6767838471,420,3,-5,-14,3,3,3,0,-1,3,4,2,6,4,-1,1,2,0,2,2,0,-11,-5,0,5,5,0,0,0,1,-1,-1,1,1,1
KR_6609852499,420,2,20,20,1,0,2,2,-2,1,3,-5,1,6,5,7,2,3,3,0,0,7,7,-2,8,6,-4,0,0,1,-1,1,-1,3,1
KR_6715894048,420,0,62,5,2,5,6,1,-4,0,4,-3,0,3,1,3,2,3,3,0,0,-1,3,1,3,4,1,0,2,1,1,1,-1,2,1
KR_6764097766,420,3,99,4,1,0,2,2,-2,1,3,3,4,1,2,4,2,-2,0,2,0,-1,0,0,4,4,2,0,1,1,1,1,1,2,1
KR_6760866101,420,-2,-35,10,-2,1,3,2,1,3,2,-2,3,5,1,2,1,-3,1,4,0,2,-6,2,4,6,-1,0,-2,-1,1,-1,-1,6,1
KR_6732645846,420,2,37,24,7,-2,0,2,6,7,1,0,2,2,3,5,2,0,1,1,0,4,-66,4,4,8,31,0,1,1,-1,-1,1,3,1
KR_6756956161,420,5,58,-12,14,4,6,2,-1,2,3,2,3,1,8,8,0,1,1,0,0,9,15,-1,6,5,5,0,2,1,-1,1,1,4,1
KR_6710177909,420,1,42,28,4,6,8,2,1,4,3,1,2,1,-5,0,5,1,1,0,1,1,6,3,2,5,-2,0,1,1,1,1,1,3,1
KR_6765857605,440,4,56,-3,7,3,4,1,-2,3,5,5,5,0,-1,2,3,2,2,0,0,5,8,-1,6,5,3,0,3,0,1,1,-1,0,1
KR_6725626747,440,5,9,16,13,2,3,1,3,5,2,4,6,2,0,3,3,4,6,2,0,10,6,1,2,3,-2,0,1,1,-1,1,1,3,1
KR_6756564654,420,2,-18,-12,3,0,1,1,5,7,2,0,3,3,-3,1,4,1,1,0,1,3,1,1,5,6,-1,0,-1,0,0,-1,1,0,1
KR_6638408390,420,-5,-60,4,-2,3,3,0,-1,1,2,-2,0,2,-3,0,3,1,1,0,0,-5,-5,1,4,5,-2,0,-1,1,1,-1,1,1,1
KR_6743778498,420,-1,-49,23,0,-6,1,7,3,4,1,-2,2,4,5,6,1,0,1,1,0,4,-4,-2,3,1,3,-1,-2,1,-1,-1,-1,2,1
KR_6751731328,420,0,47,-12,1,-2,0,2,0,1,1,-5,1,6,5,5,0,3,5,2,0,5,-1,1,5,6,-4,0,1,0,-1,1,-1,0,1
KR_6761585911,420,1,-22,-16,-5,1,2,1,-5,2,7,0,3,3,-3,0,3,2,2,0,0,-5,429,-3,5,2,-4,0,0,-1,-1,0,-1,1,1
KR_6662752160,420,5,58,-12,12,2,3,1,0,4,4,2,2,0,7,8,1,1,3,2,0,14,25,8,0,8,-1,0,3,1,1,1,-1,6,1
KR_6752251362,420,1,7,4,0,-3,1,4,0,1,1,1,2,1,0,1,1,2,2,0,0,3,111,1,3,4,0,0,-1,1,-1,-1,-1,4,1
KR_6582633614,420,3,35,0,3,-5,0,5,3,4,1,2,2,0,4,4,0,-1,0,1,0,12,21,4,3,7,-2,0,-1,1,-1,-1,-1,4,1
KR_6762488442,420,2,28,0,5,1,3,2,-2,1,3,0,1,1,5,6,1,1,1,0,1,6,10,4,4,8,-6,0,0,1,1,1,1,3,1
KR_6641800023,420,0,50,-21,2,0,1,1,0,5,5,3,5,2,2,3,1,-3,2,5,0,0,-7,-2,7,5,2,0,0,-1,-1,0,-1,3,1
KR_6761272651,440,2,32,12,5,1,3,2,-2,1,3,2,7,5,4,4,0,0,0,0,0,1,5,-1,3,2,1,0,1,1,1,1,-1,1,1
KR_6679310585,420,-1,-2,12,2,0,2,2,-3,2,5,2,3,1,2,3,1,1,2,1,0,-2,-2,5,2,7,0,0,0,1,0,-1,1,3,1
KR_6762646690,440,1,44,7,8,-1,1,2,0,2,2,-3,3,6,10,11,1,2,2,0,0,4,-12,-3,7,4,2,0,2,-1,-1,1,-1,6,1
KR_6703207243,420,-1,-3,16,-4,-4,0,4,2,4,2,5,10,5,-6,2,8,-1,0,1,0,0,9,3,4,7,3,0,-1,1,-1,-1,1,1,1
KR_6687138812,420,4,6,77,6,1,2,1,7,9,2,-1,3,4,2,3,1,-3,1,4,5,12,16,5,0,5,-5,0,0,1,1,0,1,3,1
KR_6715754601,420,3,16,8,17,7,8,1,2,3,1,5,6,1,5,5,0,-2,0,2,0,11,-24,5,3,8,0,0,1,1,1,1,1,4,1
KR_6760940814,420,2,23,2,-4,1,4,3,-2,1,3,0,2,2,-3,0,3,0,1,1,-1,-8,0,-3,6,3,-1,0,1,-1,1,1,-1,6,1
KR_6591935097,420,1,21,-5,-1,2,3,1,-5,2,7,2,5,3,0,0,0,0,0,0,0,4,8,4,2,6,-5,0,0,-1,1,1,-1,3,1
KR_6755542111,420,3,39,-16,6,0,2,2,-1,5,6,6,8,2,1,4,3,0,1,1,-2,-9,-1,-2,7,5,2,0,1,1,0,1,-1,1,1
KR_6760497504,420,1,52,0,-1,1,5,4,-2,0,2,-1,1,2,0,2,2,1,1,0,0,-3,6,1,1,2,1,0,0,-1,-1,1,1,6,1
KR_6755615152,420,4,130,8,6,1,3,2,5,6,1,1,4,3,1,2,1,-2,0,2,2,6,3,5,5,10,3,0,1,1,0,1,1,1,1
KR_6712304587,440,6,119,12,15,8,8,0,0,4,4,5,5,0,3,5,2,-1,0,1,1,9,29,3,1,4,0,0,3,1,1,1,1,2,1
KR_6608845600,420,-2,-15,-24,-4,1,2,1,-2,1,3,1,4,3,-3,2,5,-1,1,2,0,-6,-8,3,2,5,0,0,0,1,1,0,1,3,1
KR_6739258615,420,0,-66,23,2,-2,1,3,-6,2,8,7,7,0,4,5,1,-1,2,3,0,18,2,-3,5,2,1,0,0,1,1,-1,1,5,1
KR_6759404374,420,4,17,15,7,-1,4,5,2,3,1,0,2,2,4,5,1,2,7,5,0,12,20,6,0,6,-1,0,1,1,1,1,-1,4,1
KR_6742563328,420,4,-4,20,7,-2,0,2,0,3,3,4,4,0,5,5,0,0,0,0,0,9,-48,3,1,4,17,0,0,1,-1,0,1,6,1
KR_6610131108,440,2,-15,5,6,-3,1,4,4,5,1,3,5,2,2,3,1,0,0,0,0,14,-3,-1,7,6,3,0,1,-1,0,1,1,1,1
KR_6738670348,420,2,24,44,-1,-1,2,3,-3,1,4,1,5,4,1,3,2,1,1,0,0,-8,5,2,2,4,-3,0,1,-1,1,1,1,2,1
KR_6727275439,420,0,3,12,4,1,1,0,1,2,1,0,3,3,3,3,0,-1,1,2,0,5,8,3,2,5,-2,0,0,1,1,0,1,5,1
KR_6724060004,420,2,29,36,1,0,3,3,0,1,1,2,4,2,2,3,1,-3,0,3,0,8,1,0,7,7,5,0,1,1,1,1,-1,6,1
KR_6702309479,420,3,-18,28,11,2,4,2,3,4,1,2,4,2,0,2,2,4,4,0,0,6,2,-1,3,2,-1,0,0,0,1,1,1,0,1
KR_6703490426,420,3,-8,43,7,4,5,1,1,2,1,3,8,5,-2,1,3,1,2,1,1,2,-5,-1,5,4,-1,0,0,1,1,1,-1,2,1
KR_6746780328,420,0,24,7,3,-2,2,4,2,2,0,3,4,1,0,2,2,0,2,2,1,0,2,4,4,8,-3,0,1,0,1,1,1,0,1
KR_6734316446,420,5,6,44,7,-1,0,1,2,4,2,5,5,0,4,4,0,-3,0,3,0,5,-97,3,2,5,-4,0,0,1,1,1,-1,5,1
KR_6766813677,420,1,-12,23,-4,1,2,1,0,2,2,-10,0,10,5,5,0,0,0,0,1,6,-10,-3,5,2,2,0,0,0,0,0,1,0,1
KR_6764786791,420,-1,3,-5,-3,0,2,2,-2,0,2,-1,4,5,-1,2,3,1,1,0,0,-6,-33,1,6,7,0,0,0,0,1,0,-1,0,1
KR_6751662186,420,-2,-27,16,-6,1,1,0,-1,2,3,1,4,3,-2,2,4,-5,0,5,0,-6,-1,1,1,2,-2,0,0,-1,0,0,-1,1,1
KR_6668638674,420,3,9,29,6,-1,0,1,-2,2,4,4,4,0,3,6,3,2,4,2,0,1,32,4,2,6,-1,0,3,-1,-1,1,1,5,1
KR_6746844980,420,2,-18,12,7,2,3,1,3,5,2,0,4,4,2,3,1,0,1,1,0,9,3,4,1,5,-5,0,0,1,0,0,1,3,1
KR_6757933692,420,1,7,-23,3,-1,1,2,-3,1,4,4,6,2,3,4,1,0,2,2,0,6,-5,-1,7,6,-2,0,-1,1,-1,-1,1,2,1
KR_6678249762,420,4,51,-1,10,6,6,0,4,5,1,-3,1,4,0,2,2,3,3,0,0,11,46,1,4,5,-17,0,2,1,1,1,1,5,1
KR_6631181116,420,3,-8,0,9,2,3,1,3,3,0,5,5,0,0,2,2,-1,1,2,0,4,7,0,3,3,5,0,1,1,0,1,-1,5,1
KR_6672569530,440,3,21,15,5,-2,1,3,1,6,5,9,9,0,-1,4,5,-2,1,3,0,-3,-45,2,1,3,12,0,1,-1,-1,1,1,3,1
KR_6659434230,420,1,-7,16,2,4,4,0,-2,5,7,-6,0,6,8,11,3,-2,0,2,0,-1,29,6,4,10,-8,0,1,0,1,1,1,0,1
KR_6747198283,420,2,34,23,11,-1,2,3,2,4,2,1,1,0,6,9,3,3,5,2,0,17,298,2,4,6,0,0,3,1,1,1,1,2,1
KR_6760546865,420,-1,-8,8,4,3,3,0,2,3,1,2,3,1,-2,0,2,-1,0,1,0,0,-16,-3,4,1,-1,0,-1,0,1,-1,1,0,1
KR_6752206142,420,-2,-55,-8,-4,-4,2,6,0,4,4,-3,3,6,2,5,3,1,1,0,2,4,1,0,7,7,-1,0,0,0,-1,-1,1,0,1
KR_6681197669,420,0,-22,-5,5,-2,0,2,5,6,1,1,2,1,-3,4,7,4,6,2,0,8,8,2,5,7,1,0,0,1,-1,-1,-1,2,1
KR_6643299917,420,-2,-73,27,2,-1,2,3,3,8,5,-2,3,5,1,3,2,1,2,1,-1,10,38,0,0,0,-2,0,0,1,1,1,-1,4,1
KR_6762546164,420,1,136,17,0,4,5,1,3,3,0,-10,0,10,1,2,1,2,2,0,2,1,-16,2,3,5,-2,0,2,0,1,1,1,0,1
KR_6703347689,420,3,-61,-12,6,4,4,0,1,2,1,3,4,1,1,2,1,-3,1,4,-1,1,-2,-1,5,4,0,0,-1,-1,1,1,-1,5,1
KR_6766821920,420,1,19,28,6,0,0,0,-2,1,3,0,0,0,7,7,0,1,1,0,0,6,-1,-3,6,3,1,0,1,1,-1,1,1,1,1
KR_6745617251,420,-1,-24,10,-6,-5,2,7,-5,1,6,4,8,4,1,1,0,-1,0,1,1,-8,0,3,0,3,0,0,0,0,-1,-1,1,0,1
KR_6705234014,440,1,-46,-21,5,-3,1,4,0,2,2,4,6,2,3,4,1,1,1,0,-1,8,-11,-1,4,3,4,0,1,0,1,1,-1,0,1
KR_6741965811,440,0,1,32,1,1,4,3,0,0,0,1,3,2,-2,0,2,1,2,1,0,5,4,2,0,2,-2,0,0,1,1,0,1,3,1
KR_6717328340,420,3,58,0,9,4,4,0,3,5,2,0,2,2,2,3,1,0,0,0,1,15,6,0,2,2,2,0,0,1,-1,-1,1,4,1
KR_6757717595,420,1,34,36,7,0,1,1,1,4,3,0,3,3,3,4,1,3,3,0,0,5,6,-1,5,4,2,0,1,0,1,1,1,0,1
KR_6741944535,420,3,48,-24,9,2,4,2,3,8,5,1,2,1,2,3,1,1,1,0,0,7,197,-4,5,1,1,0,0,-1,-1,0,1,1,1
KR_6726812111,420,1,2,24,-5,-2,2,4,-3,1,4,2,3,1,-1,2,3,-1,0,1,-1,-4,-343,-1,2,1,1,0,-1,-1,-1,-1,-1,2,1
KR_6751895900,420,-1,-52,19,-5,-4,2,6,2,4,2,1,2,1,-3,0,3,-1,1,2,0,-3,-11,-3,7,4,1,0,1,0,0,1,-1,0,1
KR_6724094893,420,4,78,7,12,2,2,0,0,3,3,6,9,3,5,5,0,-1,1,2,0,7,26,1,5,6,1,0,1,-1,-1,1,1,5,1
KR_6764941028,420,1,-41,6,0,1,2,1,-5,3,8,1,3,2,3,4,1,0,2,2,0,2,-9,-2,8,6,3,0,0,-1,-1,-1,-1,4,1
KR_6762043743,420,0,26,7,-3,-1,1,2,3,4,1,0,3,3,0,3,3,-5,0,5,0,1,27,8,3,11,-4,0,0,-1,1,0,-1,3,1
KR_6742672966,420,-1,-1,-12,4,-1,1,2,-6,2,8,3,5,2,2,4,2,6,7,1,0,7,15,2,3,5,0,0,1,-1,1,1,1,1,1
KR_6754306516,420,-1,-41,-12,-3,4,4,0,0,2,2,-3,0,3,-5,0,5,1,1,0,0,-1,-2,-3,8,5,-3,0,0,-1,1,0,-1,3,1
KR_6695758352,440,-1,27,16,-12,-4,1,5,0,6,6,-2,1,3,-5,0,5,-1,3,4,-1,-20,-19,-5,10,5,2,0,-1,-1,-1,-1,1,1,1
KR_6745708400,420,3,-76,24,5,-4,0,4,4,4,0,-2,3,5,6,6,0,1,2,1,0,7,-1,0,2,2,1,0,1,-1,1,1,1,3,1
KR_6645227295,420,8,148,48,7,3,5,2,-2,2,4,5,6,1,2,6,4,-1,1,2,0,-4,-186,2,2,4,2,0,1,1,1,1,1,5,1
KR_6597216624,420,0,54,-19,11,-1,1,2,7,7,0,1,4,3,2,3,1,2,2,0,1,10,-31,5,3,8,9,0,2,1,1,1,1,5,1
KR_6754802418,420,1,23,17,2,0,1,1,2,4,2,-1,2,3,3,6,3,-2,2,4,1,3,-193,0,3,3,4,0,0,-1,0,0,-1,5,1
KR_6705466260,420,2,32,-4,5,-1,2,3,3,3,0,0,1,1,2,4,2,1,3,2,1,14,-2,2,2,4,4,0,2,1,-1,1,1,4,1
KR_6499439512,420,3,-28,20,3,-3,0,3,7,8,1,2,4,2,-3,2,5,0,1,1,0,-5,35,-2,5,3,-14,0,0,0,0,0,1,0,1
KR_6761559524,420,3,-4,21,5,3,5,2,2,4,2,-1,0,1,-1,2,3,2,4,2,-1,5,26,-1,7,6,-7,0,1,0,1,1,-1,0,1
KR_6488156066,420,6,85,-28,15,7,7,0,1,2,1,1,4,3,4,5,1,2,3,1,0,17,-93,0,4,4,-1,0,2,1,1,1,1,6,1
KR_6732713839,440,1,66,-14,0,-4,1,5,1,2,1,-1,2,3,6,6,0,-2,0,2,0,-1,-4,-3,6,3,-1,0,0,-1,1,0,1,5,1
KR_6764043247,420,4,139,12,8,4,4,0,0,1,1,-1,0,1,2,5,3,3,4,1,0,5,-24,2,3,5,1,0,2,1,1,1,1,5,1
KR_6744537749,420,-1,-70,-29,-2,1,2,1,2,4,2,0,3,3,-4,1,5,-1,0,1,0,4,28,0,4,4,-2,0,0,1,1,-1,-1,1,1
KR_6762262227,420,0,40,-31,-3,1,2,1,0,4,4,3,4,1,-3,2,5,-4,0,4,0,-9,-21,-2,7,5,6,0,0,-1,1,1,1,6,1
KR_6762785271,420,2,12,-29,6,5,5,0,3,5,2,-3,0,3,2,3,1,-1,1,2,0,5,0,3,3,6,0,0,0,1,1,0,1,6,1
KR_6731818663,420,0,24,5,-1,1,3,2,0,4,4,0,2,2,-1,5,6,-1,2,3,-2,-11,-19,0,3,3,0,0,0,1,1,0,-1,4,1
KR_6656693818,420,4,9,25,1,0,0,0,3,6,3,-7,0,7,5,8,3,0,2,2,1,-5,-32,2,3,5,2,0,0,-1,1,0,1,5,1
KR_6763918701,440,3,73,27,8,3,4,1,-1,3,4,1,5,4,4,7,3,1,2,1,0,8,49,-2,4,2,-17,0,3,1,0,1,1,1,1
KR_6665151657,420,0,-5,-12,1,0,1,1,-3,1,4,4,5,1,1,4,3,-1,1,2,0,-1,4,4,2,6,0,0,0,1,0,0,-1,2,1
KR_6738922752,420,7,90,44,11,1,4,3,2,6,4,4,4,0,4,5,1,0,2,2,0,8,0,-1,4,3,3,0,2,1,0,1,1,1,1
KR_6729804859,420,4,65,6,5,-1,3,4,1,1,0,1,3,2,-1,0,1,5,5,0,0,11,5,-2,7,5,4,0,1,1,1,1,1,2,1
KR_6682614147,440,-2,-32,-16,-4,0,3,3,-1,2,3,-3,0,3,1,5,4,-1,1,2,-1,-5,-7,4,2,6,2,0,-1,-1,1,-1,-1,3,1
KR_6758487295,420,1,-20,1,5,-1,2,3,2,2,0,2,2,0,3,3,0,-1,2,3,0,11,-50,-3,7,4,18,0,-1,1,-1,-1,1,1,1
KR_6621454603,420,1,3,16,4,0,0,0,1,5,4,-4,0,4,5,6,1,2,2,0,1,6,2,1,4,5,4,0,3,1,1,1,1,3,1
KR_6754568223,420,1,-26,11,5,1,2,1,4,6,2,0,2,2,1,2,1,-1,3,4,0,9,-104,5,3,8,-5,0,1,1,-1,1,1,6,1
KR_6741288280,420,-2,-44,-4,-5,-3,2,5,-2,1,3,-4,1,5,2,4,2,2,2,0,-1,6,72,1,6,7,2,0,-1,1,-1,-1,-1,6,1
KR_6687241825,420,4,76,23,13,-3,0,3,4,4,0,1,2,1,11,11,0,0,3,3,4,24,16,2,4,6,3,0,3,0,1,1,1,0,1
KR_6757127258,420,3,48,3,1,3,4,1,-2,1,3,6,6,0,-3,3,6,-3,1,4,-1,1,-6,1,5,6,-1,0,1,-1,-1,1,-1,3,1
KR_6723050342,420,5,70,27,8,2,3,1,4,6,2,-1,1,2,3,5,2,0,0,0,1,9,25,1,1,2,0,0,1,1,1,1,1,4,1
KR_6767060267,420,2,31,-1,7,0,2,2,-2,4,6,2,2,0,2,3,1,5,5,0,1,8,9,1,3,4,0,0,1,-1,1,1,1,1,1
KR_6616469946,420,1,65,-24,5,3,3,0,-5,0,5,7,7,0,-2,3,5,2,5,3,0,-1,-455,1,0,1,15,0,1,-1,1,1,-1,6,1
KR_6725877635,420,3,107,20,3,7,8,1,2,5,3,0,1,1,-1,1,2,-5,0,5,0,-12,14,4,1,5,-2,0,2,1,1,1,1,6,1
KR_6685090943,420,2,37,-16,8,3,5,2,2,2,0,0,2,2,1,4,3,2,2,0,0,8,5,1,4,5,2,0,1,1,1,1,-1,4,1
KR_6747999144,440,2,-5,16,5,1,1,0,6,6,0,-2,1,3,0,2,2,0,0,0,1,8,0,6,3,9,-1,0,0,1,1,0,1,3,1
KR_6753967712,420,4,31,20,2,-1,1,2,0,1,1,2,4,2,1,4,3,0,1,1,0,-5,5,1,6,7,-2,0,-1,0,-1,-1,-1,0,1
KR_6713232419,420,5,75,4,11,5,6,1,2,4,2,-1,2,3,4,4,0,1,1,0,1,14,9,-1,4,3,-4,0,3,1,-1,1,1,6,1
KR_6484910381,420,-1,38,-37,-1,1,2,1,-2,3,5,0,1,1,0,0,0,0,0,0,0,-3,-8,-1,5,4,7,0,0,-1,-1,1,-1,4,1
KR_6230984020,420,4,93,0,5,0,1,1,4,4,0,2,6,4,0,3,3,-1,0,1,0,-1,24,1,4,5,-28,0,1,1,-1,1,1,4,1
KR_6762684509,420,5,18,26,7,-1,4,5,3,3,0,7,7,0,-5,1,6,3,4,1,0,1,-111,1,2,3,-4,0,1,0,1,1,-1,0,1
KR_6765253680,420,0,-49,32,-1,-4,1,5,7,9,2,-2,1,3,-1,1,2,-1,3,4,0,-7,-6,0,3,3,1,0,0,1,-1,0,-1,4,1
KR_6461013044,420,2,27,4,-3,-1,2,3,-2,1,3,-1,4,5,2,4,2,-1,2,3,0,-2,2,0,4,4,1,0,0,-1,1,0,1,3,1
KR_6674450098,440,4,39,20,14,3,3,0,3,3,0,4,4,0,0,5,5,4,4,0,0,15,-7,1,4,5,5,0,0,1,1,1,1,3,1
KR_6761166481,420,2,55,12,8,2,2,0,5,5,0,2,4,2,0,1,1,-1,0,1,0,6,-2,0,3,3,-1,0,0,1,1,1,1,4,1
KR_6667590008,420,7,51,-9,8,1,1,0,2,2,0,1,4,3,3,3,0,1,1,0,0,9,77,1,4,5,6,0,1,1,1,1,1,5,1
KR_6671734992,420,1,44,8,13,2,2,0,1,2,1,-1,3,4,9,9,0,2,2,0,0,15,3,1,3,4,1,0,2,1,1,1,1,2,1
KR_6762618670,420,2,82,-20,3,1,4,3,-1,1,2,-4,1,5,6,7,1,1,2,1,0,5,1,4,3,7,-2,0,1,-1,0,1,1,1,1
KR_6746811770,420,1,0,8,1,0,2,2,1,2,1,-2,1,3,5,7,2,-3,2,5,0,-5,4,-1,1,0,-1,0,1,1,-1,1,1,4,1
KR_6727635439,440,1,7,-4,5,0,2,2,1,2,1,6,6,0,2,4,2,-4,0,4,0,0,-14,-2,7,5,7,0,0,-1,0,1,1,5,1
KR_6763180284,440,1,22,24,4,-1,0,1,3,6,3,0,1,1,0,1,1,2,5,3,1,1,-3,2,5,7,1,0,0,-1,1,0,1,5,1
KR_6720254124,420,-1,37,-12,1,-2,0,2,3,3,0,-1,2,3,3,7,4,-2,3,5,0,6,-4,-3,8,5,0,0,1,0,1,1,1,0,1
KR_6683891167,420,7,108,76,5,0,4,4,-2,1,3,3,3,0,4,6,2,0,1,1,1,1,7,3,5,8,-2,0,1,1,-1,1,1,5,1
KR_6637658174,420,-3,-53,-37,-5,-6,2,8,-1,4,5,4,5,1,-2,0,2,0,2,2,0,0,3,3,1,4,-1,0,-3,-1,-1,-1,-1,3,1
KR_6683163762,420,2,23,12,1,3,3,0,-2,2,4,5,8,3,-5,0,5,0,0,0,0,-8,-3,2,1,3,-2,0,0,-1,1,-1,-1,6,1
KR_6755599285,420,-1,-15,-12,-1,5,5,0,0,5,5,-3,0,3,0,3,3,-3,0,3,0,-8,-8,-5,6,1,4,0,-1,1,-1,-1,-1,6,1
KR_6517154034,420,-1,4,-20,-4,4,4,0,-8,1,9,-4,0,4,2,3,1,2,2,0,0,-3,1,1,5,6,1,0,1,-1,1,1,-1,4,1
KR_6719193613,440,5,42,45,5,0,4,4,3,4,1,5,6,1,-3,1,4,0,0,0,0,6,-6,3,3,6,1,0,1,1,1,1,1,1,1
KR_6765634815,420,1,-25,41,-4,1,3,2,1,2,1,5,5,0,-11,1,12,0,0,0,0,-8,9,8,2,10,1,0,0,1,0,1,-1,5,1
KR_6749873606,420,7,67,0,16,0,3,3,2,2,0,4,4,0,9,9,0,1,2,1,0,20,48,3,2,5,-19,0,3,1,1,1,-1,5,1
KR_6748696695,420,2,6,28,12,-2,1,3,6,6,0,0,1,1,3,3,0,5,5,0,2,19,16,3,2,5,-4,0,1,1,1,1,1,4,1
KR_6762874160,420,5,36,11,8,1,2,1,0,2,2,2,5,3,4,6,2,1,2,1,0,1,-5,0,4,4,3,0,0,-1,1,0,1,5,1
KR_6766502546,420,2,45,-21,4,1,2,1,-2,1,3,1,2,1,4,4,0,0,0,0,0,6,248,-2,9,7,3,0,1,1,-1,1,1,5,1
KR_6745927688,420,-3,-4,-5,1,0,0,0,3,3,0,-1,3,4,2,3,1,-3,0,3,0,3,-2,-3,6,3,1,0,0,0,1,0,1,0,1
KR_6743695175,420,-1,-41,20,3,-1,3,4,-2,2,4,2,3,1,2,3,1,2,3,1,1,9,5,1,4,5,3,0,0,1,0,0,1,6,1
KR_6766139817,420,4,19,26,8,0,4,4,-4,0,4,1,2,1,13,13,0,-2,0,2,0,7,-5,-2,4,2,0,0,0,0,1,1,1,0,1
KR_6759088233,420,4,27,-8,10,7,7,0,-1,1,2,1,1,0,1,3,2,2,3,1,0,1,5,1,1,2,0,0,1,1,1,1,1,5,1
KR_6740302120,420,-1,-11,-24,1,1,2,1,1,5,4,2,3,1,-2,1,3,-1,2,3,0,-9,-105,-2,4,2,-2,0,0,1,-1,0,1,3,1
KR_6764981528,420,3,24,-15,6,-3,4,7,-3,0,3,5,5,0,5,6,1,2,2,0,0,7,-8,-5,7,2,6,0,1,-1,-1,1,-1,5,1
KR_6740238623,420,0,-1,-21,-1,2,3,1,1,1,0,3,6,3,-7,2,9,0,0,0,0,-5,6,-1,7,6,2,0,2,0,1,1,1,0,1
KR_6733231329,420,1,-33,44,2,-3,2,5,4,5,1,-2,3,5,1,1,0,2,3,1,1,7,-8,-1,5,4,3,0,1,1,-1,1,1,1,1
KR_6760729713,420,0,16,-7,4,2,2,0,-4,2,6,5,5,0,2,6,4,-1,4,5,0,-4,-13,-2,5,3,3,0,0,1,1,1,1,4,1
KR_6764867032,420,-4,41,0,-10,0,1,1,-5,1,6,-2,4,6,-3,2,5,0,1,1,0,-24,-1,-2,4,2,2,0,1,-1,1,1,-1,4,1
KR_6764580647,420,0,6,-8,-1,3,4,1,-3,1,4,0,1,1,0,3,3,-1,0,1,0,-4,-5,-2,5,3,3,0,0,0,1,1,1,0,1
KR_6647788474,420,5,6,8,8,2,2,0,-1,2,3,4,5,1,3,4,1,0,0,0,0,6,-2,6,2,8,1,0,0,1,-1,0,-1,3,1
KR_6688967898,420,0,-28,29,-6,-1,1,2,0,3,3,-4,1,5,-2,1,3,1,1,0,0,-2,-2,3,3,6,1,0,0,1,-1,0,-1,1,1
KR_6739856104,440,5,104,36,12,5,6,1,5,5,0,2,4,2,0,2,2,0,0,0,0,5,-3,-1,4,3,-2,0,1,1,1,1,1,3,1
KR_6709401685,420,1,-85,-1,1,1,3,2,3,4,1,-4,2,6,2,2,0,-1,2,3,0,7,12,3,3,6,-4,0,-1,1,1,1,-1,4,1
KR_6726267618,420,3,15,3,12,5,5,0,4,6,2,-2,0,2,3,9,6,2,4,2,0,10,0,-1,4,3,-6,0,2,1,1,1,1,5,1
KR_6766893940,420,3,44,-8,5,0,1,1,0,2,2,2,2,0,0,1,1,3,3,0,0,2,116,-1,4,3,3,0,1,-1,-1,1,-1,3,1
KR_6743245620,420,2,30,12,4,1,1,0,3,4,1,3,4,1,-3,0,3,0,2,2,-1,0,135,2,3,5,1,0,1,1,1,1,-1,4,1
KR_6694440544,420,3,30,12,6,0,0,0,-2,2,4,4,4,0,4,7,3,0,0,0,0,4,6,4,4,8,0,0,1,1,1,1,1,3,1
KR_6742917954,420,3,81,5,4,0,0,0,1,4,3,1,1,0,1,2,1,1,1,0,0,0,12,1,4,5,-1,0,1,-1,1,1,-1,3,1
KR_6722134556,420,3,20,26,7,0,3,3,3,4,1,6,7,1,-1,2,3,-1,2,3,-1,6,-3,1,4,5,3,0,0,1,1,0,-1,2,1
KR_6702582233,420,0,-50,-12,0,0,1,1,-3,1,4,-1,1,2,5,6,1,-1,1,2,0,6,3,-1,4,3,2,0,-1,-1,-1,-1,-1,6,1
KR_6634010546,420,5,-46,21,9,-2,0,2,6,8,2,3,3,0,1,3,2,1,1,0,0,12,-1,-1,8,7,0,0,0,1,1,0,1,2,1
KR_6760791023,420,3,88,20,1,1,2,1,-5,1,6,-1,1,2,3,5,2,3,6,3,-1,-1,4,-1,6,5,6,0,1,-1,-1,1,-1,3,1
KR_6746693979,420,-2,-26,5,-4,-1,1,2,1,3,2,-3,0,3,-4,2,6,3,4,1,0,0,-2,-2,5,3,2,0,-1,-1,-1,-1,-1,3,1
KR_6763233724,440,1,41,8,2,3,6,3,-2,3,5,-2,0,2,1,3,2,2,2,0,0,-7,-98,0,3,3,3,0,1,-1,1,1,-1,5,1
KR_6761472192,420,1,0,4,-2,-1,0,1,-1,1,2,1,2,1,-2,2,4,1,1,0,0,0,-70,-2,5,3,-5,0,0,1,0,0,-1,5,1
KR_6765590306,420,3,14,4,7,1,3,2,1,3,2,0,2,2,3,5,2,2,3,1,0,-1,0,-5,6,1,2,0,0,0,-1,0,1,0,1
KR_6761058679,420,-1,-9,0,-7,1,2,1,3,4,1,-3,5,8,-6,0,6,-2,0,2,0,-6,-3,-5,9,4,-2,0,-3,-1,-1,-1,-1,5,1
KR_6636429920,420,2,-67,56,5,-2,2,4,-1,1,2,2,3,1,2,3,1,4,4,0,0,4,-2,2,5,7,2,0,1,-1,1,1,-1,5,1
KR_6729380834,420,0,82,8,6,9,9,0,0,4,4,-1,4,5,0,6,6,-2,1,3,1,6,-41,1,4,5,28,0,0,1,1,1,1,2,1
KR_6692175859,420,-1,17,-40,-1,1,3,2,2,5,3,-2,1,3,-2,1,3,0,0,0,0,4,38,-6,7,1,-6,0,0,-1,1,0,1,3,1
KR_6650334599,420,2,69,16,6,5,6,1,1,1,0,-3,1,4,2,4,2,1,2,1,0,1,29,-1,5,4,5,0,2,1,1,1,1,3,1
KR_6761777213,420,-1,18,-18,1,3,3,0,2,2,0,0,1,1,-3,1,4,-1,1,2,0,2,-23,-2,6,4,6,0,0,0,-1,1,1,0,1
KR_6746577999,420,0,-23,38,-8,1,1,0,1,3,2,0,0,0,-7,2,9,-3,0,3,0,-13,1,0,8,8,-1,0,-1,1,-1,-1,-1,1,1
KR_6761663726,420,2,-7,4,7,0,2,2,1,2,1,4,6,2,-2,3,5,4,4,0,1,6,2,3,2,5,1,0,0,0,1,1,-1,0,1
KR_6755069870,420,2,58,8,5,10,11,1,0,1,1,-2,3,5,1,3,2,-4,0,4,0,-9,0,1,1,2,-1,0,1,1,1,1,-1,6,1
KR_6745960299,420,4,96,15,9,6,6,0,5,7,2,0,1,1,0,2,2,-2,0,2,0,1,2,0,4,4,2,0,0,0,0,1,1,0,1
KR_6728364751,420,2,33,20,4,2,5,3,-1,5,6,1,2,1,1,3,2,1,3,2,0,9,-402,0,4,4,3,0,1,-1,1,1,-1,3,1
KR_6767186334,420,3,4,15,8,-4,0,4,1,4,3,3,7,4,7,7,0,1,1,0,2,14,5,5,5,10,0,0,1,1,1,1,1,3,1
KR_6761788578,420,0,19,-19,3,-1,0,1,0,1,1,-7,0,7,11,12,1,0,2,2,0,8,3,4,3,7,-2,0,-1,-1,-1,1,-1,3,1
KR_6735034126,420,4,46,0,5,-1,2,3,0,2,2,1,3,2,4,6,2,1,2,1,0,5,-27,0,6,6,-1,0,0,1,1,1,1,4,1
KR_6755674673,420,1,52,-8,12,0,3,3,9,9,0,2,5,3,1,8,7,0,2,2,-1,14,24,1,2,3,-1,0,3,1,-1,1,1,2,1
KR_6766991937,420,5,-1,4,12,4,4,0,-2,0,2,1,3,2,1,5,4,8,9,1,0,14,1,0,4,4,2,0,2,1,-1,1,-1,2,1
KR_6598224293,440,2,52,20,2,-1,2,3,1,1,0,-1,2,3,2,2,0,1,1,0,0,5,0,-5,6,1,4,0,0,1,-1,1,1,3,1
KR_6761311577,440,-1,42,-70,1,0,2,2,2,6,4,-1,2,3,2,3,1,-2,1,3,0,7,0,-1,5,4,2,0,1,1,-1,1,1,4,1
KR_6735243857,440,-2,12,12,-3,-3,1,4,0,1,1,3,4,1,-4,4,8,1,2,1,0,-6,6,-3,6,3,-6,0,0,1,1,1,-1,5,1
KR_6768403927,420,-1,-8,-4,-4,-6,2,8,-1,2,3,-1,1,2,4,4,0,0,0,0,1,1,-4,0,1,1,-1,0,1,1,-1,1,1,4,1
KR_6725394878,420,6,56,47,18,10,10,0,1,2,1,1,2,1,1,5,4,5,5,0,1,11,11,2,2,4,-4,0,1,1,1,1,1,5,1
KR_6728664666,420,3,-40,-13,4,3,3,0,3,3,0,-3,2,5,0,2,2,1,2,1,0,5,2,-1,5,4,4,0,0,-1,0,0,1,4,1
KR_6650672616,420,0,31,9,4,2,3,1,-2,1,3,5,5,0,-2,0,2,1,3,2,0,2,-4,-1,4,3,3,0,0,1,-1,0,1,1,1
KR_6741706089,420,3,6,5,8,1,1,0,0,2,2,1,5,4,3,3,0,3,3,0,0,13,12,4,2,6,0,0,1,1,-1,1,1,3,1
KR_6596682086,420,-1,28,-19,-4,0,0,0,-4,1,5,0,2,2,-1,0,1,1,1,0,0,0,-44,0,6,6,28,0,0,-1,-1,0,-1,3,1
KR_6757880482,420,2,61,-10,4,2,4,2,0,4,4,0,3,3,0,0,0,2,3,1,1,3,-26,-1,4,3,1,0,1,1,1,1,1,2,1
KR_6723212397,420,7,92,22,16,2,3,1,9,9,0,-2,2,4,7,9,2,0,1,1,0,7,10,3,3,6,2,0,2,1,1,1,1,2,1
KR_6714553054,420,2,-28,35,6,-3,2,5,5,8,3,-4,1,5,6,8,2,2,2,0,0,5,-7,0,3,3,0,0,1,-1,1,1,1,2,1
KR_6765464982,420,1,30,16,-2,-1,1,2,-1,3,4,5,5,0,-2,2,4,-3,0,3,0,-12,7,2,1,3,1,0,0,1,-1,0,-1,4,1
KR_6756780353,420,2,102,13,0,3,4,1,-2,2,4,-3,1,4,1,3,2,1,1,0,0,-3,-4,0,5,5,4,0,0,1,1,1,1,3,1
KR_6635149770,420,-2,9,-8,2,-2,2,4,0,3,3,2,4,2,0,3,3,2,2,0,0,-4,7,4,4,8,0,0,0,1,-1,-1,1,1,1
KR_6726527465,420,7,110,27,14,6,7,1,0,0,0,6,7,1,1,3,2,1,1,0,-1,6,13,1,2,3,-1,0,2,1,1,1,-1,4,1
KR_6744982799,420,-4,-41,0,-6,-1,0,1,-1,5,6,-1,3,4,-1,1,2,-2,1,3,0,-3,5,0,3,3,-1,0,-1,-1,-1,-1,-1,6,1
KR_6760716285,420,10,191,-7,15,3,4,1,0,1,1,4,5,1,8,8,0,0,2,2,0,9,58,3,0,3,1,0,4,1,1,1,1,3,1
KR_6767542550,420,0,78,4,4,2,3,1,1,4,3,-2,2,4,4,8,4,-1,0,1,0,1,226,0,5,5,0,0,2,-1,1,1,1,1,1
KR_6727737385,420,1,72,-3,-3,-4,0,4,-1,2,3,1,2,1,-1,3,4,2,2,0,0,-3,-21,-3,9,6,2,0,-1,1,-1,-1,-1,4,1
KR_6759831600,420,2,49,4,0,-4,0,4,1,4,3,-2,2,4,5,6,1,0,0,0,0,7,-16,2,3,5,-2,0,-1,1,-1,-1,1,1,1
KR_6745902476,420,2,-23,-8,6,1,1,0,1,4,3,-2,1,3,4,5,1,2,2,0,0,10,3,-1,5,4,-1,0,0,0,0,0,1,0,1
KR_6748612179,420,-2,-6,-24,0,-1,0,1,0,3,3,1,1,0,-1,5,6,1,2,1,0,-5,38,-1,4,3,-17,0,1,0,1,1,1,0,1
KR_6761659583,440,3,37,-20,5,0,0,0,6,8,2,0,4,4,-1,3,4,0,1,1,0,13,-1,2,1,3,4,0,0,1,0,1,-1,4,1
KR_6720306536,420,2,17,-32,6,-1,2,3,0,2,2,0,2,2,6,9,3,1,3,2,0,16,-2,2,4,6,0,0,1,1,1,1,-1,4,1
KR_6723598354,420,2,34,37,6,2,2,0,0,1,1,4,4,0,2,2,0,-2,0,2,0,1,-181,1,2,3,3,0,1,1,-1,1,1,2,1
KR_6615536381,420,0,16,-24,0,5,6,1,-5,0,5,2,4,2,-3,0,3,1,2,1,2,-4,-4,-2,6,4,-3,0,0,-1,1,0,1,1,1
KR_6728851279,420,3,28,4,-4,6,7,1,-5,2,7,-5,0,5,-2,3,5,2,2,0,0,-16,0,-2,6,4,-2,0,0,-1,1,1,-1,6,1
KR_6671221273,420,3,-2,14,3,-3,1,4,1,4,3,1,2,1,1,4,3,3,5,2,0,-8,-13,1,3,4,1,0,0,0,1,1,1,0,1
KR_6731823089,420,-3,-41,-26,-9,1,5,4,0,2,2,-1,0,1,-8,0,8,-1,0,1,-1,-11,-29,-4,6,2,-1,0,-2,-1,-1,-1,-1,1,1
KR_6750053298,420,5,66,15,4,-2,0,2,2,3,1,3,4,1,1,3,2,0,1,1,0,-1,8,3,1,4,-1,0,1,1,-1,1,1,1,1
KR_6755348045,420,-2,-20,-16,-2,6,7,1,-4,2,6,1,1,0,-4,1,5,-1,2,3,1,-1,6,2,2,4,-4,0,2,1,1,1,1,2,1
KR_6744002488,420,0,56,-6,-1,2,3,1,1,2,1,-1,2,3,-2,0,2,-1,3,4,0,-5,428,-1,5,4,6,0,0,1,1,1,1,4,1
KR_6682251822,420,4,33,9,4,-1,2,3,2,3,1,3,3,0,1,2,1,-1,0,1,1,2,-10,-2,5,3,1,0,0,-1,-1,0,1,1,1
KR_6729571139,420,-2,-40,4,-8,2,3,1,-2,0,2,-6,1,7,-1,1,2,-1,0,1,-1,-4,-3,-9,12,3,1,0,0,-1,-1,0,-1,6,1
KR_6698977274,420,7,44,39,0,0,2,2,-2,4,6,8,10,2,-4,2,6,-2,0,2,-3,-6,-1,2,6,8,6,0,3,-1,1,1,-1,4,1
KR_6757509591,420,-2,52,-14,-1,-1,0,1,3,8,5,0,1,1,-3,5,8,0,1,1,0,2,293,3,1,4,1,0,1,1,1,1,-1,1,1
KR_6756144108,420,1,-3,-1,9,-3,1,4,4,5,1,6,7,1,3,5,2,-1,0,1,0,13,-2,1,0,1,4,0,-1,-1,1,-1,-1,4,1
KR_6730770083,420,2,8,-12,5,-3,0,3,1,2,1,2,2,0,3,5,2,2,2,0,0,12,0,1,4,5,3,0,1,1,-1,1,1,6,1
KR_6555701785,420,-3,-58,-28,-5,2,2,0,1,1,0,-7,2,9,2,3,1,-3,1,4,0,-3,-9,-3,7,4,1,0,-1,0,-1,-1,-1,0,1
KR_6655555352,420,0,-2,-16,7,3,4,1,1,3,2,0,4,4,3,4,1,0,1,1,1,16,-36,3,3,6,18,0,0,-1,0,-1,1,4,1
KR_6748723905,420,6,80,28,12,1,1,0,2,3,1,1,1,0,8,10,2,0,0,0,0,11,-2,1,7,8,4,0,1,1,1,1,1,3,1
KR_6742021350,440,1,65,-11,4,0,1,1,2,2,0,0,3,3,2,2,0,0,0,0,0,10,3,3,3,6,0,0,0,1,-1,0,1,4,1
KR_6719150774,440,2,36,16,1,-2,0,2,-2,0,2,-4,2,6,7,9,2,2,2,0,0,4,-320,3,3,6,-4,0,1,0,0,1,-1,0,1
KR_6664585888,440,2,26,-40,6,-2,0,2,1,4,3,0,0,0,2,4,2,5,7,2,0,10,-4,-3,8,5,2,0,1,-1,-1,1,1,6,1
KR_6525283862,420,4,-7,4,12,3,4,1,4,5,1,2,5,3,3,4,1,0,0,0,0,7,-13,3,1,4,2,0,0,1,1,1,1,3,1
KR_6670598947,420,-3,-4,28,-6,-5,0,5,4,6,2,-5,1,6,1,4,3,-1,1,2,1,-5,16,-1,3,2,-4,0,0,1,1,1,1,3,1
KR_6645003422,420,5,50,39,14,2,2,0,7,9,2,3,7,4,1,1,0,1,2,1,1,18,14,4,3,7,-7,0,2,1,1,1,1,2,1
KR_6758490618,420,2,-5,5,2,-3,1,4,-3,2,5,2,3,1,2,3,1,4,5,1,0,9,-2,-1,5,4,5,0,1,1,-1,1,1,3,1
KR_6631701661,420,2,-11,6,3,-1,2,3,-3,2,5,3,6,3,7,7,0,-3,0,3,0,2,1,-4,8,4,-3,0,1,1,1,1,-1,5,1
KR_6767094983,420,-2,25,-44,-2,1,1,0,0,3,3,-3,2,5,2,6,4,-2,0,2,0,-2,-46,0,4,4,20,0,-1,-1,1,-1,-1,5,1
KR_6738553268,420,-2,-32,-10,-8,2,4,2,2,4,2,-4,0,4,-7,1,8,-1,2,3,0,-10,14,-1,3,2,-4,0,-1,-1,0,-1,-1,6,1
KR_6733150504,420,6,81,16,12,4,4,0,1,3,2,6,6,0,0,0,0,1,1,0,0,4,-22,3,2,5,3,0,0,1,1,1,1,6,1
KR_6755563411,420,5,63,25,11,2,2,0,5,8,3,3,4,1,1,1,0,0,0,0,0,5,-3,-1,4,3,3,0,2,1,1,1,1,5,1
KR_6729494648,440,5,26,-11,10,2,3,1,0,2,2,2,3,1,4,4,0,2,2,0,0,16,-5,-1,7,6,0,0,1,1,-1,1,-1,1,1
KR_6753574937,420,4,71,-4,10,1,3,2,3,5,2,-2,3,5,2,3,1,6,6,0,0,12,-5,3,1,4,1,0,1,0,1,1,1,0,1
KR_6761142544,440,1,81,17,-4,0,0,0,1,3,2,-2,1,3,-4,1,5,1,2,1,0,-12,-1,-1,5,4,-1,0,0,-1,1,0,1,5,1
KR_6767408412,420,2,54,-13,5,-1,1,2,4,10,6,2,3,1,0,1,1,0,1,1,0,11,11,3,6,9,4,0,0,1,-1,0,-1,3,1
KR_6757054385,440,9,98,23,23,8,8,0,3,4,1,1,2,1,4,6,2,7,8,1,2,18,-28,3,4,7,-2,0,2,1,-1,1,1,5,1
KR_6691821828,420,1,39,-15,5,5,5,0,0,3,3,1,3,2,0,1,1,-1,0,1,0,6,5,2,2,4,-2,0,1,1,-1,1,-1,1,1
KR_6762486452,440,3,68,29,2,-2,0,2,4,5,1,-1,1,2,1,1,0,0,4,4,1,-6,5,-1,2,1,-5,0,0,0,1,1,1,0,1
KR_6085595238,420,-1,-16,17,7,-4,1,5,-3,1,4,1,1,0,12,12,0,1,1,0,0,5,-17,-1,5,4,1,0,0,-1,1,0,1,4,1
KR_6711433650,440,-2,29,6,4,0,1,1,4,6,2,2,4,2,-1,1,2,-1,2,3,0,8,-56,-2,5,3,-25,0,0,1,-1,1,1,5,1
KR_6682417959,440,2,7,40,1,7,7,0,0,4,4,-4,1,5,0,2,2,-2,0,2,-1,-5,8,3,1,4,0,0,1,1,0,1,-1,1,1
KR_6711197288,420,-3,-25,70,-3,2,3,1,-1,2,3,-3,0,3,-1,0,1,0,2,2,0,-4,-71,0,2,2,-1,0,0,-1,1,-1,1,4,1
KR_6761268496,420,-2,-26,-4,-3,-3,1,4,-2,1,3,3,4,1,0,0,0,-1,0,1,0,1,15,2,2,4,-1,0,0,-1,1,0,1,3,1
KR_6737629634,420,3,66,55,6,3,5,2,0,0,0,-3,3,6,5,8,3,1,1,0,1,3,-34,3,4,7,2,0,2,1,1,1,1,1,1
KR_6755971012,420,5,139,0,14,6,7,1,4,4,0,1,2,1,-1,1,2,4,5,1,0,7,90,1,5,6,5,0,0,1,1,1,1,4,1
KR_6704763514,420,-2,-1,15,1,2,3,1,3,4,1,1,2,1,-2,3,5,-3,0,3,0,-3,32,3,5,8,-2,0,0,-1,1,0,1,4,1
KR_6643750087,420,5,96,0,9,5,5,0,-1,2,3,2,3,1,4,5,1,-1,0,1,0,3,-1,-3,8,5,4,0,1,1,1,1,1,1,1
KR_6716567249,440,4,101,32,8,6,6,0,0,2,2,1,3,2,-1,2,3,2,2,0,0,0,-2,2,1,3,1,0,2,-1,0,1,-1,5,1
KR_6718264563,420,0,-2,12,3,-2,1,3,0,1,1,0,2,2,2,2,0,3,3,0,0,13,-10,2,3,5,4,0,-1,1,-1,-1,1,4,1
KR_6766599182,420,-2,-38,10,-1,2,4,2,2,3,1,-11,1,12,6,8,2,0,2,2,1,-4,-3,-3,6,3,-2,0,0,0,1,1,1,0,1
KR_6724137607,420,5,72,32,2,0,1,1,1,5,4,1,3,2,0,1,1,0,1,1,0,0,4,-4,10,6,4,0,0,1,1,1,-1,2,1
KR_6754251055,420,0,73,0,0,2,2,0,1,3,2,0,2,2,0,3,3,-3,0,3,0,-6,8,2,1,3,0,0,-1,1,1,1,-1,2,1
KR_6740033208,420,3,41,40,11,9,9,0,-1,4,5,0,2,2,0,1,1,3,4,1,1,0,1,1,1,2,-1,0,0,1,1,1,1,4,1
KR_6740600927,420,8,65,24,20,9,9,0,8,8,0,1,3,2,0,1,1,2,3,1,2,23,0,0,6,6,1,0,3,-1,1,1,1,1,1
KR_6700905899,420,-3,22,-7,-4,2,3,1,-5,2,7,-1,2,3,-1,0,1,1,1,0,0,2,5,1,5,6,-7,0,2,1,1,1,-1,2,1
KR_6713783813,420,3,8,0,6,1,1,0,2,2,0,2,4,2,1,1,0,0,0,0,0,6,-5,-1,7,6,-14,0,0,1,-1,0,-1,1,1
KR_6764686251,420,1,68,-12,-1,1,2,1,-1,3,4,-1,1,2,3,5,2,-3,0,3,1,2,14,4,2,6,-2,0,1,-1,0,1,1,5,1
KR_6636080203,420,2,60,8,-2,0,1,1,-1,0,1,-5,1,6,3,4,1,1,2,1,0,-14,-5,-1,2,1,2,0,2,1,1,1,1,5,1
KR_6749965327,420,2,53,1,1,1,1,0,-5,2,7,0,1,1,5,6,1,0,2,2,0,-3,24,1,4,5,0,0,1,-1,1,1,1,4,1
KR_6638270148,440,2,74,18,3,4,5,1,5,8,3,-3,3,6,-5,3,8,2,2,0,0,-1,3,-2,5,3,-3,0,0,1,-1,0,1,3,1
KR_6669344999,420,0,-45,18,3,1,2,1,2,4,2,2,2,0,1,4,3,-3,2,5,0,1,-108,1,4,5,-3,0,1,1,-1,1,1,1,1
KR_6757142219,420,-5,-90,24,-7,0,1,1,-1,1,2,-4,1,5,0,3,3,-2,0,2,0,-6,-90,-3,6,3,1,0,-2,0,-1,-1,-1,0,1
KR_6704442622,420,5,76,-16,21,2,2,0,2,5,3,4,5,1,10,11,1,3,3,0,0,21,15,1,4,5,1,0,1,0,0,1,1,0,1
KR_6760205379,420,0,3,24,4,3,3,0,-1,1,2,0,3,3,2,3,1,0,4,4,0,0,116,-1,2,1,0,0,1,1,1,1,1,4,1
KR_6735032715,420,1,-11,0,-4,0,2,2,1,2,1,-1,2,3,-5,0,5,1,1,0,0,-5,8,4,2,6,-4,0,0,-1,0,0,-1,6,1
KR_6725046775,440,-1,3,0,-1,1,3,2,-2,1,3,-1,1,2,1,4,3,0,0,0,0,4,4,1,4,5,-4,0,-1,1,-1,-1,-1,4,1
KR_6724886584,420,2,15,-9,1,-1,0,1,-1,2,3,1,3,2,2,2,0,0,1,1,0,-2,2,3,2,5,3,0,0,-1,0,0,-1,3,1
KR_6738114371,420,5,65,-4,5,2,2,0,-5,1,6,2,3,1,-1,2,3,7,8,1,0,4,21,-1,6,5,-7,0,1,-1,1,1,1,2,1
KR_6752389830,420,3,4,0,4,1,4,3,0,3,3,5,6,1,-1,2,3,-1,0,1,0,7,-12,-4,4,0,1,0,1,-1,1,1,1,6,1
KR_6671807443,420,-1,-10,-6,4,3,3,0,0,2,2,1,4,3,0,2,2,0,4,4,1,2,-2,1,3,4,-5,0,1,1,1,1,1,1,1
KR_6756609592,420,-4,-36,-27,-2,-1,1,2,-1,3,4,0,1,1,0,2,2,0,1,1,0,1,-135,3,5,8,1,0,0,-1,-1,0,1,5,1
KR_6734394529,440,4,83,20,8,1,3,2,0,1,1,0,2,2,7,7,0,0,1,1,0,10,10,5,2,7,1,0,0,1,1,0,-1,1,1
KR_6759017563,420,-3,-69,-24,1,-1,2,3,1,4,3,1,3,2,1,7,6,-1,0,1,1,4,0,-3,6,3,-1,0,-1,-1,-1,-1,1,2,1
KR_6767522604,420,1,-14,4,8,-3,0,3,0,2,2,5,6,1,5,6,1,1,1,0,1,7,3,1,6,7,6,0,1,-1,1,1,1,4,1
KR_6721152957,420,2,68,4,5,1,2,1,3,7,4,0,2,2,2,5,3,-1,0,1,0,-1,0,0,4,4,0,0,1,1,0,-1,-1,2,1
KR_6713406414,420,11,128,72,11,3,5,2,5,5,0,3,6,3,1,4,3,-1,1,2,0,9,15,2,1,3,1,0,4,1,1,1,1,1,1
KR_6761254466,420,3,19,0,7,2,3,1,1,3,2,4,6,2,0,5,5,0,0,0,0,1,-1,1,1,2,2,0,0,1,1,0,1,4,1
KR_6759975940,420,5,53,8,2,1,3,2,-3,3,6,0,1,1,4,4,0,0,0,0,0,0,9,5,3,8,0,0,2,1,1,1,1,4,1
KR_6763282874,420,-2,0,-13,2,-1,1,2,3,5,2,-3,0,3,3,5,2,0,1,1,0,-2,0,1,4,5,4,0,0,0,1,0,1,0,1
KR_6729670780,420,4,98,-24,14,3,7,4,-1,1,2,5,5,0,11,13,2,-4,1,5,0,6,7,5,1,6,0,0,1,-1,1,1,1,5,1
KR_6754355997,420,5,-20,16,14,4,5,1,-1,1,2,-2,1,3,10,10,0,3,3,0,1,13,-118,1,3,4,2,0,0,1,-1,1,1,5,1
KR_6610055707,440,4,48,24,6,0,3,3,-1,0,1,3,4,1,-1,1,2,5,6,1,0,-1,-2,-6,8,2,2,0,1,1,0,1,1,1,1
KR_6725466828,420,0,32,12,1,2,4,2,0,3,3,0,3,3,0,2,2,-1,0,1,0,-3,-2,0,3,3,4,0,0,1,-1,-1,1,4,1
KR_6720617020,440,3,21,44,1,2,4,2,3,4,1,-6,4,10,3,5,2,-1,1,2,0,-10,5,0,7,7,-6,0,3,1,1,1,-1,5,1
KR_6767851532,440,2,34,-8,9,-3,1,4,0,2,2,3,3,0,5,7,2,4,4,0,1,15,3,2,3,5,1,0,0,1,1,1,1,5,1
KR_6720812841,440,6,94,-16,12,-4,0,4,-2,1,3,11,12,1,4,4,0,3,4,1,-1,8,7,2,2,4,-2,0,3,1,1,1,-1,1,1
KR_6755364265,440,1,89,-24,0,0,4,4,-4,1,5,1,3,2,4,6,2,-1,1,2,0,-3,-6,6,2,8,1,0,3,-1,1,1,-1,6,1
KR_6759662731,420,-4,-73,-2,-13,-7,0,7,0,3,3,-10,2,12,6,8,2,-2,2,4,-3,-13,-5,-9,9,0,1,0,0,0,-1,-1,-1,0,1
KR_6728017190,420,4,103,-5,3,1,1,0,3,4,1,1,3,2,-1,2,3,-1,0,1,0,2,0,0,4,4,5,0,0,1,-1,1,-1,5,1
KR_6514813460,420,3,-37,-8,9,-2,0,2,4,6,2,4,4,0,0,0,0,3,3,0,0,9,6,2,3,5,1,0,0,-1,1,0,1,6,1
KR_6690365597,420,2,26,-12,2,2,3,1,1,4,3,-1,2,3,0,5,5,0,0,0,0,-6,1,1,3,4,-2,0,1,1,0,1,-1,6,1
KR_6666040501,420,2,62,16,5,-2,0,2,6,6,0,-3,1,4,3,4,1,1,1,0,0,6,5,-2,6,4,1,0,1,0,1,1,1,0,1
KR_6746323923,440,2,65,69,-8,-1,1,2,1,1,0,0,3,3,-7,1,8,-1,2,3,0,-10,-107,-2,2,0,1,0,1,1,0,1,1,5,1
KR_6762175608,420,-2,46,-12,-3,3,3,0,-1,4,5,1,3,2,-1,1,2,-5,0,5,0,-7,7,1,5,6,-3,0,-1,1,-1,-1,1,1,1
KR_6684781517,420,3,38,-6,9,5,5,0,0,3,3,-1,0,1,4,4,0,1,2,1,2,5,-1,-2,6,4,1,0,1,1,1,1,1,1,1
KR_6674097813,420,5,119,14,13,7,7,0,1,2,1,2,2,0,3,3,0,0,0,0,0,15,4,1,2,3,0,0,3,1,1,1,1,5,1
KR_6758155958,440,1,-41,24,5,-1,1,2,7,7,0,2,4,2,-2,1,3,-1,0,1,-1,4,-7,3,0,3,-2,0,0,-1,1,0,-1,3,1
KR_6731756293,420,-2,21,-20,-5,0,2,2,-4,0,4,-6,3,9,8,8,0,-3,0,3,1,-5,11,5,4,9,-2,0,0,-1,-1,1,1,1,1
KR_6740791989,420,1,171,-36,6,0,0,0,0,2,2,3,3,0,2,3,1,1,3,2,0,0,15,5,0,5,-1,0,2,-1,-1,1,1,3,1
KR_6759052463,420,-1,56,25,-2,1,3,2,1,2,1,-3,2,5,-2,1,3,1,1,0,1,4,7,5,3,8,7,0,1,1,-1,1,1,5,1
KR_6768043065,420,4,85,23,7,4,5,1,7,7,0,-3,0,3,-1,1,2,0,0,0,1,6,-2,5,5,10,0,0,1,-1,1,1,1,2,1
KR_6765306232,420,3,110,44,6,1,3,2,0,2,2,2,3,1,4,5,1,-1,1,2,1,3,-15,-2,7,5,-4,0,3,-1,1,1,1,4,1
KR_6681358999,420,3,25,9,10,3,4,1,4,7,3,-1,2,3,2,5,3,2,2,0,3,16,-1,0,3,3,-3,0,2,1,1,1,1,1,1
KR_6758165513,420,6,77,16,6,5,5,0,3,4,1,-2,4,6,1,6,5,-1,0,1,0,0,124,0,3,3,-1,0,3,1,1,1,1,6,1
KR_6687294778,420,-2,-51,-8,-8,2,2,0,-3,2,5,-1,1,2,-3,1,4,-3,1,4,-1,-14,-40,-6,8,2,21,0,1,-1,-1,1,-1,3,1
KR_6735008769,420,3,68,29,13,6,8,2,5,6,1,3,4,1,-2,4,6,1,1,0,0,5,4,-4,5,1,2,0,2,1,1,1,1,4,1
KR_6766773697,420,1,-13,-48,10,-1,1,2,9,9,0,5,6,1,0,0,0,-3,1,4,1,6,-5,3,2,5,0,0,2,-1,1,1,1,3,1
KR_6759344683,440,1,-4,16,0,1,2,1,-1,5,6,3,4,1,-2,0,2,-1,0,1,0,1,-21,0,4,4,1,0,0,1,1,1,-1,6,1
KR_6764006292,420,4,67,4,8,-2,3,5,3,3,0,3,3,0,4,4,0,0,0,0,0,3,237,2,4,6,2,0,2,1,-1,1,1,1,1
KR_6729278363,420,4,-7,24,12,4,4,0,9,10,1,1,4,3,-3,0,3,1,2,1,0,2,3,6,1,7,-1,0,2,1,-1,1,1,6,1
KR_6757388873,420,-3,-9,4,-12,-1,1,2,0,4,4,-4,0,4,-6,0,6,-1,0,1,0,-12,-11,2,2,4,1,0,0,-1,1,-1,1,3,1
KR_6649622342,420,-3,-38,-17,-8,-3,2,5,1,5,4,-5,2,7,-1,3,4,0,0,0,0,1,3,2,4,6,1,0,-1,1,1,1,-1,3,1
KR_6751661088,420,0,-70,16,2,3,4,1,1,4,3,-2,2,4,-1,1,2,1,2,1,0,2,-12,0,4,4,0,0,0,-1,1,0,1,5,1
KR_6671912343,420,-2,-17,37,5,2,5,3,-1,1,2,-6,3,9,8,9,1,2,4,2,1,10,-7,0,3,3,-2,0,0,1,-1,-1,1,5,1
KR_6760819086,420,-1,7,16,-2,-2,2,4,-2,1,3,-1,2,3,4,4,0,-1,0,1,0,-5,2,0,4,4,-16,0,-1,1,-1,-1,-1,2,1
KR_6762388372,420,1,-56,22,8,6,7,1,0,0,0,-3,1,4,-2,2,4,7,10,3,1,9,195,0,2,2,0,0,1,1,1,1,1,6,1
KR_6762817239,420,-3,-28,7,2,1,4,3,2,5,3,2,3,1,0,1,1,-3,0,3,0,2,406,2,1,3,2,0,1,1,1,1,1,3,1
KR_6721526419,420,0,-20,8,0,-3,0,3,-2,2,4,3,6,3,3,3,0,-1,6,7,0,0,25,-1,5,4,1,0,0,1,1,1,1,6,1
KR_6699547513,420,-4,-30,12,-3,-2,3,5,0,1,1,-2,4,6,-1,2,3,2,2,0,-1,-5,-45,-3,7,4,-1,0,-1,0,1,-1,1,0,1
KR_6767835836,420,1,-1,-14,5,-3,1,4,2,4,2,-1,3,4,2,2,0,5,8,3,0,6,-15,0,3,3,3,0,1,1,-1,-1,1,3,1
KR_6722920146,420,4,39,8,7,3,4,1,3,5,2,2,3,1,0,1,1,-1,1,2,0,5,-2,0,4,4,2,0,1,-1,1,1,1,6,1
KR_6628313620,420,-2,-43,4,0,-5,1,6,7,8,1,0,0,0,-3,0,3,1,3,2,0,2,-8,-2,5,3,2,0,-1,1,-1,-1,-1,3,1
KR_6757749165,440,3,59,-12,4,4,5,1,-5,1,6,3,3,0,2,3,1,0,1,1,0,0,5,-2,5,3,2,0,0,-1,-1,0,1,5,1
KR_6624597538,420,1,-60,7,-4,2,3,1,-1,3,4,-3,1,4,0,2,2,-2,0,2,0,-6,-31,-3,7,4,3,0,0,1,1,0,1,6,1
KR_6717552293,420,1,9,-29,1,1,3,2,0,2,2,-1,2,3,2,3,1,-1,0,1,0,2,7,4,4,8,-2,0,0,1,-1,1,-1,2,1
KR_6764505403,420,-1,-31,40,4,0,3,3,1,3,2,-4,2,6,2,4,2,5,5,0,1,14,17,4,4,8,4,0,0,1,0,1,1,2,1
KR_6634961833,420,-2,12,4,-7,-1,3,4,0,3,3,0,1,1,-5,1,6,-1,1,2,0,-12,-8,1,1,2,2,0,0,-1,1,-1,1,3,1
KR_6766731555,440,3,13,4,7,3,3,0,0,3,3,-1,3,4,5,5,0,0,0,0,0,0,-10,-1,3,2,1,0,0,0,1,1,1,0,1
KR_6714370504,420,-1,-62,23,-4,-1,1,2,-2,0,2,0,1,1,-1,1,2,0,1,1,0,-8,1,5,2,7,-1,0,0,-1,1,0,-1,5,1
KR_6764268754,420,0,11,-46,7,4,4,0,0,2,2,2,7,5,-3,4,7,4,5,1,1,2,5,0,2,2,1,0,1,1,-1,1,1,6,1
KR_6652328398,420,1,-55,31,3,-2,1,3,0,3,3,5,5,0,0,6,6,0,1,1,0,-5,-10,4,3,7,2,0,1,-1,1,1,1,2,1
KR_6765249938,420,2,65,-15,2,-1,0,1,1,4,3,-1,0,1,3,6,3,0,1,1,0,12,-11,-8,8,0,1,0,0,-1,-1,0,1,5,1
KR_6728899927,420,1,44,3,5,-2,1,3,2,2,0,-2,6,8,4,5,1,3,3,0,0,9,11,0,5,5,1,0,2,1,-1,1,1,3,1
KR_6709568763,420,9,113,24,20,4,5,1,5,5,0,4,6,2,5,5,0,2,2,0,0,13,0,2,4,6,0,0,5,1,1,1,1,1,1
KR_6593822896,420,3,80,8,6,2,3,1,2,2,0,-1,1,2,2,5,3,1,2,1,0,3,-34,0,9,9,3,0,4,-1,1,1,1,5,1
KR_6764508297,420,5,43,12,12,6,6,0,0,3,3,0,3,3,4,4,0,2,2,0,0,14,4,1,4,5,0,0,1,0,1,1,1,0,1
KR_6685680226,420,2,-11,-12,8,1,4,3,1,6,5,2,2,0,2,4,2,2,4,2,-1,13,6,1,5,6,3,0,-1,1,-1,-1,-1,3,1
KR_6723708406,420,2,-23,-6,11,5,6,1,1,2,1,3,5,2,0,1,1,2,2,0,1,14,-4,-5,6,1,3,0,0,-1,1,0,1,5,1
KR_6703959275,420,0,50,-13,1,-4,5,9,1,1,0,0,1,1,5,6,1,-1,0,1,0,7,-1,2,4,6,-2,0,-1,-1,1,1,-1,1,1
KR_6702790021,420,0,-7,-8,11,-3,0,3,4,5,1,7,8,1,2,2,0,1,2,1,0,11,-3,-6,9,3,4,0,2,1,-1,1,1,5,1
KR_6751441513,440,-2,-11,13,6,0,2,2,6,8,2,3,3,0,-4,2,6,1,2,1,0,3,-4,2,3,5,1,0,0,1,1,1,-1,1,1
KR_6760888716,420,3,25,18,14,1,2,1,7,8,1,4,5,1,0,2,2,2,2,0,1,10,-105,4,1,5,0,0,2,-1,1,1,1,1,1
KR_6656602170,420,2,33,12,5,1,4,3,1,2,1,4,4,0,-1,1,2,0,0,0,0,5,265,0,3,3,-3,0,1,1,1,1,1,6,1
KR_6689042462,440,-1,68,3,3,3,4,1,7,8,1,-1,2,3,-2,3,5,-4,1,5,1,-5,4,1,4,5,-1,0,-1,1,1,1,1,2,1
KR_6715603230,420,10,152,-23,13,2,2,0,3,3,0,5,6,1,3,3,0,0,1,1,0,17,-202,6,3,9,4,0,3,1,-1,1,1,6,1
KR_6758217255,420,2,83,-10,5,1,1,0,2,4,2,3,5,2,-2,2,4,1,1,0,0,-1,23,-6,7,1,-29,0,0,1,-1,1,1,4,1
KR_6765727440,420,3,-21,-4,2,3,3,0,-1,2,3,2,3,1,-1,3,4,-1,1,2,0,-3,13,4,4,8,-3,0,0,-1,1,0,1,3,1
KR_6765670268,420,3,-23,5,6,-2,2,4,1,4,3,4,5,1,2,8,6,1,1,0,0,8,2,3,4,7,-4,0,-1,0,1,-1,-1,0,1
KR_6569986841,420,-4,-75,4,-10,-3,0,3,-3,0,3,-2,2,4,0,3,3,-2,0,2,0,-9,-12,-7,9,2,3,0,-1,-1,-1,-1,-1,3,1
KR_6571218167,420,4,4,39,6,0,2,2,2,4,2,0,1,1,6,7,1,-2,0,2,3,15,-5,5,2,7,-4,0,0,1,1,1,1,4,1
KR_6726098574,420,0,13,-12,1,-1,1,2,2,3,1,0,3,3,1,2,1,-1,0,1,0,2,33,1,3,4,-4,0,0,-1,0,0,1,6,1
KR_6714116228,420,-2,-54,-14,-1,4,4,0,0,2,2,1,1,0,-7,0,7,1,1,0,0,-9,118,4,2,6,-4,0,1,-1,1,1,-1,1,1
KR_6762429797,420,-3,-51,5,-6,0,2,2,-1,1,2,-6,1,7,2,6,4,-1,0,1,1,-10,-3,1,5,6,1,0,-2,-1,1,-1,1,5,1
KR_6721732156,440,2,1,15,-1,-4,1,5,0,2,2,1,3,2,2,5,3,0,2,2,0,-2,-3,-2,5,3,5,0,0,-1,1,0,-1,4,1
KR_6750675759,420,1,3,-20,2,-3,0,3,2,4,2,4,4,0,-2,0,2,1,1,0,0,6,21,3,1,4,-1,0,1,0,1,1,1,0,1
KR_6767259007,420,0,21,20,-2,-1,0,1,-5,1,6,-2,2,4,6,7,1,0,1,1,-1,-7,2,-1,5,4,-1,0,0,-1,0,0,-1,1,1
KR_6642727101,420,-4,-78,-18,1,-3,1,4,-1,2,3,-2,3,5,5,9,4,2,2,0,0,5,-53,-1,4,3,20,0,1,-1,0,-1,1,2,1
KR_6768056475,420,6,29,24,8,3,3,0,1,2,1,0,0,0,5,6,1,-1,0,1,0,8,24,3,4,7,-2,0,2,1,-1,1,1,3,1
KR_6761386395,420,2,3,8,7,-3,0,3,-1,1,2,3,4,1,5,5,0,3,3,0,0,11,6,2,2,4,2,0,1,1,-1,1,1,5,1
KR_6715995912,420,2,48,-26,9,1,2,1,-2,0,2,0,2,2,9,10,1,1,2,1,1,4,0,-2,5,3,0,0,1,1,1,1,1,1,1
KR_6705196269,440,0,-35,18,8,0,1,1,6,8,2,-2,0,2,3,6,3,1,4,3,0,7,72,-2,4,2,-19,0,2,-1,0,1,1,2,1
KR_6763276828,420,3,76,56,8,1,3,2,3,3,0,4,5,1,0,4,4,0,3,3,0,6,200,-3,7,4,2,0,1,0,0,1,1,0,1
KR_6756906951,420,2,77,-6,14,-2,2,4,2,4,2,7,8,1,4,5,1,3,3,0,0,10,18,-3,7,4,1,0,1,1,1,1,1,3,1
KR_6768372346,420,3,58,32,4,7,7,0,0,2,2,1,3,2,-3,2,5,-1,0,1,0,-5,-5,-1,4,3,5,0,1,1,1,1,1,6,1
KR_6723203986,420,-1,-37,3,-7,0,1,1,0,3,3,-3,0,3,-4,1,5,0,1,1,0,-15,-7,-4,6,2,5,0,-1,-1,-1,-1,-1,5,1
KR_6768372346,420,3,58,32,4,7,7,0,0,2,2,1,3,2,-3,2,5,-1,0,1,0,-5,-5,-1,4,3,5,0,1,1,1,1,1,6,1
KR_6647901758,420,-4,-7,-14,-5,-1,1,2,1,2,1,1,3,2,-5,1,6,-1,0,1,1,-5,-16,1,4,5,3,0,0,0,0,-1,1,0,1
KR_6762766998,420,2,-11,28,3,1,2,1,3,4,1,-2,1,3,3,5,2,-2,0,2,1,5,-5,-2,6,4,1,0,1,1,0,1,1,4,1
KR_6725547726,420,-2,17,-4,-2,-4,1,5,1,3,2,-6,0,6,7,7,0,0,0,0,0,7,23,2,2,4,4,0,-1,1,-1,-1,-1,6,1
KR_6724388448,420,2,55,12,5,0,2,2,4,5,1,4,6,2,-4,0,4,1,1,0,0,-7,-2,-3,7,4,2,0,1,-1,1,1,1,2,1
KR_6766227883,420,3,24,7,5,1,3,2,0,1,1,6,8,2,-1,2,3,-1,1,2,0,0,-6,-2,8,6,5,0,0,-1,1,1,-1,3,1
KR_6759604440,440,-2,-10,0,0,2,5,3,0,1,1,-1,1,2,2,4,2,-3,3,6,1,5,47,-1,6,5,-16,0,-1,1,-1,-1,1,6,1
KR_6728748303,420,-3,11,-40,4,0,1,1,-1,2,3,-5,1,6,9,9,0,1,2,1,0,12,4,2,4,6,-2,0,-1,1,-1,-1,1,2,1
KR_6750097231,420,0,52,15,-3,-2,0,2,-1,5,6,2,6,4,-4,3,7,2,3,1,-1,-6,-9,-2,5,3,1,0,0,-1,1,1,-1,4,1
KR_6706773065,420,2,34,12,2,4,5,1,-2,0,2,-1,2,3,0,3,3,1,2,1,1,-5,75,3,5,8,20,0,2,1,1,1,1,5,1
KR_6604619564,420,1,89,12,4,-3,0,3,4,5,1,2,4,2,0,4,4,1,3,2,-1,2,20,-2,8,6,1,0,1,1,1,1,-1,6,1
KR_6755816194,420,3,70,17,12,0,1,1,8,9,1,-4,3,7,8,9,1,0,1,1,0,17,10,0,6,6,5,0,0,1,1,0,-1,1,1
KR_6765253772,420,3,4,-5,0,0,2,2,0,0,0,3,3,0,-2,2,4,-1,0,1,0,-1,-4,-4,6,2,4,0,1,-1,1,1,-1,3,1
KR_6752019089,420,2,-46,20,5,5,5,0,1,4,3,3,5,2,-2,1,3,-2,0,2,0,-1,114,-1,4,3,6,0,0,1,-1,0,1,4,1
KR_6766643283,440,2,-3,4,4,3,3,0,1,1,0,-3,1,4,5,8,3,-2,2,4,0,6,-212,0,2,2,3,0,0,1,1,0,-1,1,1
KR_6754360906,420,5,71,23,3,1,2,1,0,1,1,4,8,4,-2,1,3,0,0,0,1,3,-20,-3,5,2,-1,0,-1,1,-1,-1,1,3,1
KR_6764222509,420,1,93,-39,3,0,2,2,4,7,3,-1,1,2,-2,1,3,2,4,2,2,4,-4,2,1,3,1,0,1,0,0,1,1,0,1
KR_6558957675,420,2,15,-12,3,-1,4,5,0,0,0,6,9,3,-1,0,1,-1,0,1,0,5,11,3,1,4,-2,0,2,-1,0,1,1,6,1
KR_6720519866,440,2,36,16,5,8,8,0,5,7,2,-1,3,4,-1,3,4,-6,1,7,-1,1,28,0,3,3,-2,0,0,-1,1,1,-1,3,1
KR_6767667632,440,4,113,4,8,3,4,1,1,3,2,0,1,1,4,6,2,0,0,0,0,7,3,0,3,3,0,0,0,1,0,0,1,1,1
KR_6704994826,420,4,-9,32,2,0,1,1,0,2,2,2,4,2,0,2,2,0,0,0,0,5,91,-4,7,3,2,0,0,1,-1,0,-1,5,1
KR_6761157406,440,5,60,28,18,2,4,2,0,1,1,6,9,3,8,8,0,2,2,0,1,24,5,5,2,7,-1,0,1,-1,1,1,1,3,1
KR_6760231598,420,5,28,64,6,3,5,2,8,8,0,5,5,0,-4,1,5,-6,0,6,0,-1,-12,0,2,2,1,0,2,1,1,1,-1,4,1
KR_6515118969,420,4,13,4,7,-2,1,3,5,8,3,2,3,1,3,5,2,-1,1,2,-3,3,19,8,2,10,-5,0,1,1,1,1,-1,4,1
KR_6657712878,420,2,18,-12,-1,1,1,0,2,7,5,1,3,2,-2,2,4,-3,0,3,1,-2,22,4,0,4,-1,0,1,0,1,1,1,0,1
KR_6760219845,420,0,-8,15,3,-2,0,2,2,4,2,0,2,2,2,4,2,1,2,1,0,4,12,2,1,3,5,0,1,1,1,1,-1,3,1
KR_6724086328,420,3,41,20,8,1,1,0,0,2,2,6,8,2,0,4,4,1,1,0,0,-1,-373,1,4,5,0,0,1,-1,1,1,1,3,1
KR_6681238728,420,2,25,20,2,-1,1,2,5,5,0,-5,1,6,4,8,4,-1,0,1,-1,-9,-1,-1,4,3,1,0,1,1,1,1,-1,1,1
KR_6684677289,420,1,30,-24,6,-2,0,2,2,2,0,-1,4,5,5,5,0,2,2,0,0,9,18,0,8,8,-1,0,-1,-1,-1,1,1,1,1
KR_6765183265,420,0,-56,-4,0,-1,3,4,-4,0,4,0,1,1,5,7,2,0,0,0,1,4,-14,-6,8,2,5,0,-2,-1,-1,-1,1,4,1
KR_6712107662,440,0,21,-12,3,0,1,1,-3,2,5,4,4,0,2,3,1,0,2,2,0,10,8,1,5,6,-1,0,1,-1,1,1,-1,6,1
KR_6744214692,420,3,87,12,8,1,2,1,0,1,1,4,5,1,1,2,1,2,3,1,0,6,21,5,2,7,-5,0,1,1,1,1,1,5,1
KR_6736690786,420,-3,34,-4,-1,-2,1,3,-2,1,3,-1,4,5,5,7,2,-1,0,1,0,2,6,6,3,9,-4,0,0,1,-1,-1,1,6,1
KR_6763352633,420,2,31,32,2,-1,3,4,4,6,2,0,2,2,1,2,1,-2,1,3,0,-2,-1,2,3,5,1,0,0,1,-1,0,1,2,1
KR_6675671645,420,6,103,0,11,3,5,2,1,3,2,0,2,2,7,7,0,0,0,0,0,11,-37,1,4,5,16,0,2,1,1,1,-1,5,1
KR_6739581661,420,0,-23,-25,7,3,5,2,2,3,1,4,4,0,-1,7,8,-1,0,1,3,10,-1,1,6,7,-2,0,0,-1,1,-1,1,5,1
KR_6681230307,420,5,43,28,8,-4,1,5,6,11,5,1,2,1,4,6,2,1,2,1,0,12,2,0,5,5,4,0,0,1,-1,-1,-1,2,1
KR_6764662682,420,0,24,-8,1,0,1,1,-4,4,8,5,6,1,0,3,3,0,0,0,0,1,-7,-3,5,2,3,0,1,1,1,1,1,6,1
KR_6695305048,420,-3,15,24,-4,-3,1,4,5,5,0,-1,2,3,-4,3,7,-1,0,1,0,-6,0,-2,5,3,-6,0,-1,1,-1,-1,-1,3,1
KR_6760293772,420,3,-10,14,8,1,2,1,2,2,0,1,1,0,3,3,0,1,1,0,0,12,-6,0,3,3,4,0,0,1,-1,0,1,3,1
KR_6734564444,440,3,4,56,4,2,2,0,3,3,0,0,3,3,0,1,1,-1,0,1,-1,-3,-13,-4,5,1,3,0,1,1,1,1,-1,2,1
KR_6703197167,420,4,94,19,-5,0,2,2,1,1,0,-3,1,4,-2,4,6,-1,0,1,0,-17,2,4,1,5,2,0,2,1,1,1,-1,2,1
KR_6766040554,440,3,59,34,11,4,4,0,1,4,3,2,2,0,6,6,0,-2,1,3,0,15,-29,-1,4,3,17,0,1,1,-1,1,1,4,1
KR_6729686674,420,-2,-17,12,-2,-3,0,3,2,5,3,-1,3,4,-1,5,6,1,1,0,0,2,-9,-4,9,5,4,0,-1,1,-1,-1,-1,1,1
KR_6591887314,420,2,81,29,4,1,1,0,-1,3,4,8,10,2,-4,2,6,0,0,0,0,-9,114,1,4,5,6,0,0,1,1,0,-1,5,1
KR_6719352518,420,-2,-24,-42,-5,-3,0,3,-10,1,11,2,2,0,6,8,2,0,1,1,0,1,-102,5,2,7,-1,0,-1,-1,-1,-1,-1,3,1
KR_6735587610,420,-2,0,-14,-4,2,3,1,0,0,0,-6,1,7,-2,2,4,2,2,0,0,0,14,0,6,6,-1,0,0,-1,-1,0,1,2,1
KR_6760334246,420,3,13,-10,13,-2,1,3,2,3,1,2,3,1,10,11,1,1,1,0,1,9,-33,2,2,4,-2,0,1,1,1,1,1,6,1
KR_6615579961,420,3,26,20,6,-3,0,3,-1,2,3,-3,0,3,13,14,1,0,0,0,0,17,-1,-3,7,4,1,0,0,1,-1,1,-1,2,1
KR_6744323589,420,2,82,15,0,2,4,2,-1,3,4,3,4,1,-2,1,3,-2,2,4,0,-2,-55,4,4,8,-25,0,1,1,-1,1,-1,5,1
KR_6762281554,420,5,88,25,2,1,4,3,5,7,2,0,2,2,-2,2,4,-2,0,2,0,-4,8,4,1,5,-1,0,3,1,1,1,-1,6,1
KR_6547672295,420,-1,-14,-20,2,0,1,1,5,6,1,2,3,1,-3,0,3,-2,0,2,0,9,45,8,0,8,-25,0,0,-1,-1,1,-1,2,1
KR_6682375386,440,3,39,20,1,1,4,3,3,5,2,0,1,1,-3,3,6,0,0,0,0,-5,247,-4,4,0,0,0,0,1,-1,0,1,2,1
KR_6741292012,420,4,73,-48,14,11,12,1,-2,2,4,3,6,3,0,4,4,2,2,0,-1,3,2,0,3,3,-1,0,3,1,-1,1,-1,5,1
KR_6758342803,440,1,29,15,-7,-2,1,3,2,3,1,0,1,1,-8,0,8,1,3,2,0,-8,6,2,4,6,-3,0,0,1,-1,-1,-1,2,1
KR_6617653450,420,4,43,4,3,1,2,1,-6,0,6,3,7,4,5,7,2,0,1,1,0,-2,-10,5,1,6,6,0,4,1,1,1,1,1,1
KR_6747474329,420,0,-26,12,2,-1,0,1,0,2,2,2,3,1,-1,0,1,2,4,2,0,-2,-4,3,2,5,0,0,0,-1,1,0,1,5,1
KR_6726784006,420,-1,-13,-16,-3,-4,0,4,2,2,0,0,1,1,0,1,1,-1,0,1,0,-3,-42,3,3,6,0,0,0,-1,1,1,1,2,1
KR_6761628991,420,-2,-22,4,-5,1,3,2,0,5,5,-2,1,3,-3,2,5,-1,0,1,0,-7,3,7,4,11,0,0,0,1,-1,1,1,3,1
KR_6761157395,420,0,10,-4,-3,1,1,0,-2,2,4,3,5,2,-4,0,4,-1,0,1,0,-6,-242,-3,5,2,-1,0,0,-1,1,1,-1,4,1
KR_6766031373,420,3,22,25,10,1,1,0,1,2,1,2,4,2,5,7,2,1,2,1,0,9,-245,0,2,2,0,0,1,1,0,1,1,5,1
KR_6743171527,420,3,-36,-15,10,1,1,0,0,4,4,7,7,0,3,3,0,-1,1,2,0,8,-68,0,5,5,4,0,1,1,-1,-1,1,1,1
KR_6738326413,420,-1,8,4,-5,-6,1,7,3,5,2,-3,2,5,3,4,1,-2,0,2,0,-3,8,1,3,4,0,0,0,1,-1,-1,-1,3,1
KR_6653302283,420,2,25,7,5,1,1,0,2,3,1,0,2,2,3,4,1,-1,0,1,0,5,-4,0,4,4,1,0,0,1,1,0,1,5,1
KR_6754974946,420,1,45,-17,0,-1,0,1,-4,1,5,4,6,2,1,8,7,0,1,1,0,-2,6,1,5,6,-3,0,0,-1,1,1,-1,3,1
KR_6727785730,420,1,51,1,-3,1,3,2,-1,2,3,2,2,0,-6,2,8,1,1,0,1,1,-2,4,3,7,-4,0,0,0,1,0,1,0,1
KR_6758131339,420,-1,-64,4,-6,-3,0,3,-1,1,2,-5,4,9,3,7,4,0,0,0,-2,-4,8,5,7,12,-2,0,-1,-1,1,-1,-1,6,1
KR_6704874123,440,4,40,18,-1,0,4,4,1,2,1,-2,1,3,-3,5,8,3,3,0,-1,-3,-2,2,1,3,0,0,0,0,-1,1,-1,0,1
KR_6761202892,420,1,-30,12,5,10,10,0,-2,1,3,-1,3,4,-1,1,2,-1,1,2,0,-1,-5,-1,5,4,0,0,-1,1,1,-1,-1,6,1
KR_6749955198,420,4,68,15,12,-5,1,6,2,5,3,12,12,0,2,2,0,1,1,0,0,4,2,1,4,5,1,0,3,0,1,1,1,0,1
KR_6738582020,440,4,4,28,12,4,7,3,2,4,2,1,2,1,7,8,1,-2,1,3,1,21,13,4,2,6,-4,0,1,1,0,1,1,2,1
KR_6761400555,420,1,35,3,3,-2,0,2,-1,2,3,4,7,3,0,2,2,2,2,0,0,-4,-22,-4,8,4,5,0,3,0,1,1,-1,0,1
KR_6720097065,420,0,-21,1,-4,1,4,3,0,4,4,-3,1,4,-2,1,3,0,1,1,0,-1,-27,0,4,4,2,0,-1,-1,0,1,-1,4,1
KR_6751867893,420,2,51,-4,6,10,12,2,-1,0,1,-6,0,6,1,3,2,2,2,0,0,4,9,1,3,4,-6,0,0,-1,1,1,1,3,1
KR_6723215893,420,7,116,30,15,0,0,0,7,8,1,6,7,1,1,3,2,1,1,0,0,17,9,2,4,6,2,0,2,1,1,1,1,6,1
KR_6740005618,420,1,18,-16,2,1,4,3,3,3,0,1,4,3,-2,2,4,-1,1,2,0,4,-7,1,1,2,1,0,1,-1,1,1,1,2,1
KR_6759788872,420,-1,-16,-12,0,3,4,1,2,6,4,-2,2,4,-1,1,2,-2,1,3,0,1,3,2,5,7,-3,0,-1,0,-1,-1,1,0,1
KR_6756733161,420,0,8,-1,3,0,2,2,0,1,1,-1,1,2,-3,0,3,7,11,4,1,4,5,2,6,8,0,0,2,1,1,-1,1,2,1
KR_6728114245,440,5,87,52,3,1,1,0,-3,0,3,4,5,1,2,3,1,-1,3,4,0,0,38,1,4,5,-1,0,2,1,1,1,1,6,1
KR_6760031106,440,1,27,8,3,-2,1,3,0,3,3,-2,1,3,2,4,2,5,5,0,0,1,-12,-1,3,2,5,0,1,1,1,1,-1,3,1
KR_6754728120,420,2,13,-19,-3,-1,0,1,-4,1,5,1,1,0,1,3,2,0,0,0,0,-5,-6,-1,8,7,4,0,0,-1,-1,0,-1,4,1
KR_6704111295,420,2,38,12,5,5,5,0,-2,1,3,-1,2,3,2,2,0,1,1,0,0,6,-5,0,9,9,6,0,1,-1,1,1,1,5,1
KR_6632022106,420,5,13,0,8,-2,1,3,4,5,1,2,6,4,4,8,4,0,0,0,0,17,6,0,5,5,4,0,2,1,1,1,1,2,1
KR_6764124867,420,1,-47,24,6,-3,0,3,1,3,2,3,4,1,4,6,2,1,3,2,0,6,20,3,1,4,0,0,-1,-1,-1,-1,1,3,1
KR_6715440548,420,1,65,33,-3,0,2,2,-2,4,6,-3,3,6,2,3,1,0,0,0,0,1,-3,-3,5,2,0,0,1,-1,1,1,-1,6,1
KR_6740238340,420,0,-28,-24,5,-3,2,5,-1,2,3,5,5,0,4,4,0,0,2,2,0,12,2,0,3,3,-1,0,-1,0,-1,-1,-1,0,1
KR_6750769631,420,3,46,23,7,1,2,1,1,3,2,-1,2,3,1,2,1,5,5,0,2,21,150,1,3,4,-1,0,3,1,1,1,1,1,1
KR_6767551809,420,1,2,12,-2,-1,3,4,-3,3,6,4,4,0,-2,3,5,0,1,1,0,2,2,0,5,5,4,0,0,0,-1,-1,-1,0,1
KR_6754332444,420,2,-22,-4,3,5,5,0,-1,1,2,0,4,4,-4,2,6,3,6,3,0,7,69,3,4,7,-1,0,1,1,1,-1,-1,6,1
KR_6766961887,420,2,16,9,5,-2,0,2,1,4,3,1,2,1,3,5,2,2,2,0,0,5,18,-10,13,3,2,0,1,-1,1,1,1,6,1
KR_6575691424,420,1,75,13,1,2,4,2,0,5,5,-3,4,7,4,7,3,-2,0,2,-1,-9,3,-7,9,2,2,0,2,0,1,1,-1,0,1
KR_6715626803,440,0,62,24,-5,0,2,2,2,4,2,-3,3,6,-4,5,9,0,0,0,0,-7,5,0,6,6,3,0,0,1,-1,1,-1,6,1
KR_6732153028,420,-2,10,-25,-2,1,3,2,-3,2,5,2,2,0,-1,3,4,-1,0,1,-1,-4,6,5,3,8,-1,0,0,-1,1,1,-1,2,1
KR_6752957212,420,0,-85,20,8,1,2,1,1,4,3,3,3,0,4,6,2,-1,1,2,0,1,-6,-8,10,2,-2,0,0,1,1,0,1,6,1
KR_6762671812,440,5,116,4,6,4,6,2,-1,0,1,0,0,0,2,4,2,1,1,0,0,1,0,1,2,3,-1,0,1,1,1,1,1,3,1
KR_6724668961,420,6,100,7,15,5,7,2,-3,3,6,6,6,0,5,5,0,2,2,0,0,4,15,3,0,3,0,0,2,1,1,1,1,4,1
KR_6699387593,420,3,16,-15,7,-1,1,2,1,2,1,9,9,0,-2,1,3,0,2,2,0,6,4,3,1,4,0,0,0,1,0,0,1,5,1
KR_6761515463,420,6,118,16,18,5,5,0,6,6,0,7,8,1,0,1,1,0,0,0,0,13,37,4,1,5,0,0,2,1,1,1,1,3,1
KR_6649541525,420,-1,-32,-36,4,-1,0,1,0,4,4,0,1,1,3,3,0,2,2,0,0,4,3,4,3,7,-2,0,1,1,1,1,1,4,1
KR_6755646382,420,-2,-24,1,-1,1,1,0,-1,2,3,-4,2,6,2,3,1,1,2,1,1,3,32,-8,12,4,-35,0,1,0,1,1,1,0,1
KR_6761479393,440,3,81,0,1,3,3,0,1,2,1,-7,2,9,3,4,1,1,1,0,0,0,-12,2,4,6,1,0,2,0,1,1,-1,0,1
KR_6748903682,420,2,29,12,2,3,3,0,2,4,2,1,1,0,-2,3,5,-2,0,2,0,-2,5,-4,6,2,3,0,0,0,1,1,-1,0,1
KR_6740359484,420,-4,-11,21,-10,-6,0,6,3,5,2,1,2,1,-4,0,4,-4,0,4,-1,-5,-11,0,4,4,-3,0,0,-1,-1,1,-1,1,1
KR_6766452458,420,2,7,6,7,-1,2,3,2,3,1,3,3,0,4,8,4,-1,2,3,1,14,-14,1,2,3,4,0,1,-1,1,1,1,4,1
KR_6615646093,420,-1,43,-8,2,0,0,0,1,3,2,1,3,2,2,2,0,-2,0,2,0,7,0,2,3,5,4,0,0,1,-1,0,1,3,1
KR_6756315728,420,0,71,1,0,6,8,2,-1,2,3,-5,1,6,2,4,2,-2,1,3,-1,0,1,4,2,6,3,0,1,-1,1,1,-1,6,1
KR_6723268197,420,-3,-12,-20,1,1,2,1,-3,1,4,3,4,1,2,6,4,-2,1,3,1,0,31,-3,4,1,-6,0,-1,1,1,-1,1,5,1
KR_6757571132,420,3,63,12,6,0,1,1,-2,1,3,-1,3,4,10,10,0,-1,0,1,0,9,19,3,3,6,1,0,2,1,1,1,1,5,1
KR_6759375855,420,-1,-48,8,-5,-4,0,4,6,6,0,-3,2,5,-2,1,3,-2,0,2,-2,-9,6,1,3,4,-4,0,-1,1,-1,-1,-1,6,1
KR_6681689075,420,0,-8,-24,3,-2,1,3,4,5,1,-5,0,5,6,8,2,0,1,1,0,12,5,0,4,4,-2,0,0,-1,-1,-1,-1,5,1
KR_6763363212,420,-3,-31,-4,-8,-1,1,2,-1,0,1,-2,1,3,-3,1,4,-1,0,1,-1,-10,6,0,4,4,0,0,0,-1,1,0,-1,3,1
KR_6687919167,420,1,87,4,1,-2,2,4,1,3,2,0,2,2,0,1,1,2,3,1,0,-3,-41,-2,6,4,2,0,1,-1,1,1,-1,1,1
KR_6764547028,420,1,63,37,0,4,4,0,-5,0,5,0,4,4,0,1,1,1,2,1,0,-7,-214,-4,5,1,-1,0,1,0,-1,1,-1,0,1
KR_6726351440,440,2,12,16,5,3,4,1,-4,0,4,5,7,2,2,6,4,-1,1,2,0,9,-164,2,1,3,-3,0,1,1,-1,1,-1,6,1
KR_6693915850,420,-2,-55,14,3,-4,0,4,4,4,0,-1,2,3,3,3,0,1,1,0,0,9,-7,-1,4,3,-2,0,0,-1,-1,1,1,1,1
KR_6383928504,420,-4,-15,12,-8,1,3,2,0,1,1,-4,3,7,-4,0,4,-1,0,1,0,-7,-15,-1,2,1,5,0,0,-1,0,-1,-1,4,1
KR_6758726080,440,0,0,-7,-1,0,7,7,-1,1,2,0,7,7,1,1,0,-1,0,1,0,-9,8,-2,6,4,3,0,-1,0,-1,-1,-1,0,1
KR_6765464125,420,4,48,3,2,1,2,1,1,2,1,3,3,0,-2,4,6,-1,0,1,0,5,9,3,5,8,2,0,0,-1,-1,0,-1,4,1
KR_6760034384,420,2,61,16,2,8,8,0,-3,0,3,2,3,1,-2,3,5,-3,2,5,0,-8,-3,2,4,6,-1,0,2,-1,0,1,1,3,1
KR_6669323657,420,4,23,-13,5,0,2,2,3,4,1,4,5,1,-2,0,2,0,0,0,1,6,329,1,3,4,-4,0,1,1,1,1,1,3,1
KR_6706514551,420,2,21,42,2,2,2,0,3,4,1,1,2,1,-3,1,4,-1,2,3,0,-3,-6,2,1,3,-2,0,-1,0,1,-1,1,0,1
KR_6738574425,420,1,1,20,7,-1,1,2,7,8,1,2,4,2,0,2,2,-1,0,1,2,11,115,-1,5,4,-2,0,1,-1,-1,1,1,4,1
KR_6733912021,420,2,73,-18,6,5,5,0,4,4,0,-9,0,9,5,6,1,1,1,0,-1,4,-1,5,4,9,-4,0,3,1,1,1,-1,5,1
KR_6763708440,420,5,73,4,13,0,1,1,1,2,1,1,4,3,6,6,0,5,5,0,0,15,-9,0,4,4,2,0,0,-1,-1,1,-1,5,1
KR_6757489200,420,3,83,21,6,4,5,1,-4,2,6,2,3,1,6,8,2,-2,1,3,0,2,-37,-4,6,2,1,0,2,1,1,1,1,1,1
KR_6760740404,420,3,61,-24,6,2,4,2,1,6,5,0,5,5,3,4,1,0,0,0,1,2,-21,5,1,6,1,0,0,0,-1,1,1,0,1
KR_6764341275,420,1,-35,0,7,0,2,2,-1,1,2,0,0,0,9,9,0,-1,1,2,0,7,-7,0,3,3,-2,0,-2,1,-1,-1,-1,2,1
KR_6444354959,420,7,-14,54,16,1,3,2,6,6,0,1,2,1,2,4,2,6,7,1,0,14,15,0,6,6,0,0,4,0,1,1,1,0,1
KR_6729188885,440,6,131,20,16,4,5,1,7,8,1,3,4,1,3,4,1,-1,1,2,0,17,299,-5,8,3,6,0,4,1,0,1,1,5,1
KR_6709640349,420,7,143,29,16,2,2,0,0,0,0,8,10,2,6,8,2,0,1,1,0,10,-93,0,3,3,0,1,6,1,1,1,-1,4,1
KR_6747276848,440,5,-13,43,10,0,0,0,3,7,4,0,3,3,0,2,2,7,7,0,0,10,95,2,2,4,23,0,2,1,1,1,1,2,1
KR_6722393649,420,2,-25,4,1,2,3,1,0,3,3,0,1,1,0,3,3,-1,0,1,0,-3,82,-6,9,3,3,0,2,-1,1,1,-1,4,1
KR_6757963546,420,-1,55,-31,1,0,2,2,-2,3,5,1,2,1,3,4,1,-1,1,2,0,6,30,5,3,8,-2,0,0,-1,0,0,-1,5,1
KR_6762309356,420,3,38,41,-4,4,4,0,-2,1,3,0,2,2,-6,6,12,0,1,1,1,-6,1,-5,9,4,2,0,0,-1,0,0,1,1,1
KR_6765109742,420,5,29,28,10,-2,2,4,5,6,1,6,7,1,1,4,3,0,0,0,1,11,-1,0,3,3,0,0,1,1,-1,1,1,2,1
KR_6738366530,440,1,62,8,0,0,0,0,-2,0,2,3,4,1,0,4,4,-1,0,1,0,-3,-7,-2,5,3,-2,0,-1,-1,1,-1,-1,4,1
KR_6641968354,420,4,48,19,3,0,1,1,0,1,1,1,2,1,-1,1,2,3,3,0,-1,4,30,2,4,6,3,0,1,1,1,1,-1,4,1
KR_6762248688,420,3,49,7,10,3,4,1,4,7,3,-1,0,1,3,3,0,1,1,0,0,5,0,0,3,3,-1,0,2,1,1,1,1,6,1
KR_6710631362,420,1,61,9,-3,3,3,0,-3,2,5,-3,0,3,0,1,1,0,2,2,0,-2,26,3,5,8,-1,0,0,-1,1,1,1,3,1
KR_6627098589,420,-2,-32,-4,-1,4,4,0,-1,1,2,-7,0,7,4,4,0,-1,0,1,0,-1,4,0,3,3,-2,0,1,-1,-1,1,1,2,1
KR_6767786292,420,-5,24,-29,-11,-1,1,2,-3,2,5,-1,5,6,-5,1,6,-1,0,1,0,-12,0,4,5,9,-1,0,-1,1,1,1,-1,5,1
KR_6757403021,420,3,5,18,5,-1,1,2,4,4,0,-1,0,1,-1,2,3,4,4,0,-1,8,-14,-7,10,3,3,0,1,-1,1,1,-1,5,1
KR_6750152807,420,-4,30,-20,-7,0,1,1,-1,0,1,-1,1,2,-2,2,4,-3,2,5,0,-6,-14,-3,5,2,2,0,0,1,-1,-1,-1,6,1
KR_6703291359,420,-2,4,0,-7,-1,1,2,0,3,3,-3,2,5,-1,1,2,-2,2,4,0,-10,2,1,4,5,-3,0,-2,-1,1,-1,-1,1,1
KR_6732912224,420,2,-14,31,-1,-2,1,3,3,3,0,-2,1,3,0,2,2,0,0,0,0,-8,-2,-3,7,4,-4,0,1,-1,1,1,-1,1,1
KR_6746530367,420,2,38,5,8,4,5,1,0,4,4,2,4,2,3,7,4,-1,0,1,0,9,17,3,4,7,0,0,0,1,0,0,-1,5,1
KR_6522497189,420,7,63,24,24,1,4,3,4,8,4,8,8,0,10,11,1,1,1,0,4,39,3,-3,11,8,1,0,5,1,1,1,1,1,1
KR_6756739384,420,2,4,13,6,2,3,1,2,3,1,2,8,6,0,2,2,0,1,1,2,2,3,5,1,6,2,0,1,0,0,-1,1,0,1
KR_6712846828,420,0,-16,-46,-4,-1,2,3,-3,3,6,0,3,3,1,2,1,-1,0,1,0,0,0,-1,4,3,-1,0,-2,-1,-1,-1,-1,4,1
KR_6723625206,420,3,7,-12,8,-1,1,2,5,7,2,2,4,2,1,5,4,1,1,0,0,14,-45,-3,5,2,24,0,1,1,-1,1,-1,5,1
KR_6760861986,420,1,6,24,5,4,4,0,-1,4,5,1,2,1,-1,1,2,2,2,0,1,3,-13,0,4,4,-1,0,-1,1,-1,-1,1,3,1
KR_6738952586,420,-3,52,-2,-2,0,3,3,3,5,2,-1,1,2,-4,1,5,0,0,0,0,-1,165,6,1,7,1,0,1,-1,1,1,1,6,1
KR_6765133913,420,2,21,-20,8,-2,1,3,5,5,0,1,2,1,3,3,0,1,2,1,0,9,-16,2,2,4,3,0,1,1,-1,1,-1,4,1
KR_6728097116,420,1,-36,4,0,2,4,2,0,3,3,1,2,1,-4,1,5,1,1,0,0,5,-7,-3,4,1,0,0,-2,-1,-1,-1,-1,3,1
KR_6767015003,420,5,52,12,10,-2,1,3,1,3,2,8,8,0,3,4,1,0,1,1,1,6,-2,-1,6,5,2,0,1,1,-1,1,1,2,1
KR_6762360935,420,0,22,0,2,0,1,1,-1,1,2,4,5,1,-3,5,8,2,2,0,-1,11,4,0,4,4,3,0,0,1,1,0,-1,5,1
KR_6760312674,420,1,78,8,4,2,2,0,-4,0,4,-1,2,3,11,14,3,-4,0,4,0,-3,143,1,1,2,-6,0,0,0,-1,1,1,0,1
KR_6691008597,420,3,26,12,5,-1,4,5,1,2,1,0,1,1,1,3,2,4,4,0,0,2,0,-1,5,4,-1,0,0,1,-1,1,1,2,1
KR_6734617332,420,0,-9,-11,3,0,2,2,2,3,1,2,4,2,0,2,2,-1,1,2,0,2,8,6,2,8,-2,0,0,-1,1,0,1,3,1
KR_6663655019,420,2,77,8,-2,0,2,2,1,2,1,-1,3,4,0,2,2,-2,0,2,-1,2,-3,0,5,5,-3,0,0,0,-1,-1,-1,0,1
KR_6751758765,420,-1,-20,-20,3,2,3,1,0,4,4,-3,2,5,4,8,4,0,3,3,1,3,7,4,3,7,0,0,0,1,1,1,1,3,1
KR_6750218706,420,1,118,-39,3,-1,3,4,4,5,1,2,3,1,1,1,0,-3,0,3,0,1,6,7,0,7,-2,0,2,-1,0,1,1,2,1
KR_6687885317,420,7,29,27,8,6,6,0,6,8,2,-2,3,5,-2,3,5,0,1,1,-1,3,-1,2,3,5,-1,0,0,-1,1,1,-1,5,1
KR_6715359607,420,5,109,24,12,3,5,2,1,3,2,1,2,1,5,9,4,2,2,0,0,6,22,2,1,3,1,0,2,1,-1,1,1,2,1
KR_6754833336,420,-3,-64,0,-1,-7,0,7,1,5,4,1,2,1,-1,4,5,5,6,1,3,6,-56,-5,7,2,1,0,-2,-1,-1,-1,1,5,1
KR_6721349595,420,1,7,-2,4,4,4,0,2,4,2,-4,2,6,3,7,4,-1,0,1,0,2,1,5,1,6,-6,0,0,-1,1,1,-1,5,1
KR_6750014313,420,1,42,13,1,2,3,1,-2,2,4,-1,0,1,3,9,6,-1,2,3,1,-2,-1,-6,8,2,1,0,1,-1,0,1,1,2,1
KR_6758643653,420,4,8,44,11,0,0,0,4,4,0,1,2,1,5,6,1,1,1,0,1,18,-4,1,2,3,6,0,1,1,-1,1,1,6,1
KR_6646641511,440,0,29,-32,5,0,1,1,0,5,5,-2,2,4,3,6,3,4,5,1,2,8,1,5,5,10,-4,0,-1,1,1,-1,-1,4,1
KR_6754306644,420,2,44,21,0,-2,2,4,1,5,4,0,1,1,2,5,3,-1,1,2,0,6,-95,-1,6,5,-2,0,0,1,-1,1,1,5,1
KR_6641152540,420,0,58,-16,-2,0,2,2,0,3,3,2,3,1,-4,1,5,0,3,3,0,-3,13,5,2,7,-2,0,-1,-1,0,1,-1,2,1
KR_6730903818,420,5,29,-22,14,5,8,3,-2,0,2,11,11,0,2,5,3,-2,0,2,0,9,8,3,2,5,6,0,3,1,1,1,1,6,1
KR_6759891884,420,3,26,9,4,-3,0,3,0,4,4,3,4,1,5,8,3,-1,0,1,1,-2,-1,3,1,4,-3,0,0,0,-1,1,1,0,1
KR_6764618596,440,2,7,39,6,-4,2,6,6,6,0,2,2,0,1,2,1,1,1,0,0,12,1,-1,6,5,1,0,0,1,1,1,1,2,1
KR_6742407017,440,-1,-70,8,-3,0,4,4,-1,2,3,1,4,3,0,1,1,-3,0,3,-1,0,-11,-5,8,3,0,0,0,-1,-1,-1,-1,2,1
KR_6733385221,420,7,121,38,5,-1,2,3,0,2,2,4,4,0,2,2,0,0,1,1,0,2,6,4,3,7,1,0,2,1,1,1,-1,6,1
KR_6750725138,420,2,52,28,1,-3,0,3,-1,1,2,2,7,5,5,7,2,-2,0,2,0,8,-21,-10,10,0,-2,0,1,1,-1,1,1,2,1
KR_6699477297,420,1,93,-32,7,2,2,0,2,2,0,0,1,1,0,3,3,3,3,0,1,5,9,0,3,3,5,0,0,0,1,0,1,0,1
KR_6714371399,420,1,-45,9,1,1,1,0,-1,1,2,0,2,2,0,2,2,1,1,0,0,1,117,1,8,9,-5,0,0,1,-1,-1,-1,2,1
KR_6724568717,420,2,3,48,4,2,3,1,0,1,1,2,3,1,1,4,3,-1,1,2,0,-4,86,0,2,2,-1,0,0,1,1,1,1,5,1
KR_6641207190,420,1,8,-12,3,3,6,3,-3,1,4,0,1,1,0,2,2,3,3,0,-1,4,-6,-5,6,1,2,0,-1,1,-1,-1,-1,1,1
KR_6661379922,420,6,100,8,8,2,3,1,0,1,1,2,3,1,3,5,2,1,1,0,0,8,38,-2,5,3,-17,0,2,1,1,1,-1,4,1
KR_6759422327,420,-1,-56,4,3,4,4,0,2,5,3,4,5,1,-3,0,3,-4,0,4,0,-3,69,2,4,6,-5,0,1,1,1,1,1,6,1
KR_6726451062,420,2,-95,-8,7,-4,3,7,3,4,1,5,6,1,3,5,2,0,1,1,-1,15,9,0,4,4,-2,0,0,1,0,-1,-1,4,1
KR_6467636586,420,4,113,-32,2,3,4,1,0,1,1,-1,0,1,-1,1,2,1,1,0,-1,3,13,2,8,10,0,0,2,-1,1,1,-1,3,1
KR_6721386777,420,0,11,12,2,3,4,1,0,2,2,-4,0,4,3,5,2,0,0,0,-1,10,12,2,3,5,0,0,0,-1,1,1,-1,4,1
KR_6762470782,420,-1,52,20,0,0,3,3,1,3,2,0,2,2,-1,0,1,0,0,0,0,0,-5,0,5,5,-3,0,-1,1,1,1,-1,2,1
KR_6731936238,420,2,38,28,5,0,2,2,0,1,1,4,5,1,1,2,1,0,0,0,1,3,-2,3,1,4,0,0,2,1,1,1,1,3,1
KR_6719864609,420,-1,61,-26,-9,0,4,4,-3,1,4,-5,4,9,-1,1,2,0,1,1,1,-6,-21,-2,7,5,-3,0,0,1,1,0,-1,1,1
KR_6598097042,420,-1,-33,-27,3,3,3,0,-7,4,11,2,2,0,4,6,2,1,1,0,1,8,19,4,3,7,-5,0,-1,1,-1,-1,1,1,1
KR_6768248499,420,5,120,-3,17,5,5,0,2,5,3,3,4,1,7,10,3,0,1,1,1,20,8,3,0,3,-5,0,1,-1,1,1,1,3,1
KR_6722545922,440,2,64,16,10,5,6,1,0,3,3,1,3,2,6,8,2,-2,2,4,2,13,7,4,4,8,4,0,2,1,1,1,1,6,1
KR_6469546507,420,5,70,4,9,1,3,2,3,5,2,5,5,0,1,5,4,-1,2,3,0,9,-144,1,6,7,2,0,-1,1,1,-1,1,3,1
KR_6727248786,420,7,54,45,13,-5,0,5,5,6,1,3,6,3,8,8,0,2,3,1,1,19,-1,-4,7,3,0,0,1,1,-1,-1,1,5,1
KR_6730856833,420,-1,43,-26,1,-3,0,3,1,4,3,-2,1,3,2,4,2,3,3,0,0,5,-3,1,3,4,3,0,-1,-1,-1,-1,-1,5,1
KR_6760229128,420,8,85,12,18,10,11,1,1,1,0,2,3,1,5,6,1,0,0,0,0,8,115,2,2,4,3,0,5,1,-1,1,-1,3,1
KR_6746133942,420,3,22,0,3,5,5,0,1,1,0,2,3,1,-6,0,6,1,2,1,0,0,-44,-4,5,1,3,0,0,1,-1,-1,-1,4,1
KR_6647181833,440,3,85,8,9,2,3,1,3,3,0,5,7,2,-2,4,6,1,1,0,0,4,-2,3,2,5,-2,0,3,0,1,1,-1,0,1
KR_6728628235,420,2,12,11,3,0,0,0,0,2,2,2,4,2,1,2,1,0,3,3,0,8,2,3,1,4,4,0,1,1,1,1,1,6,1
KR_6635699970,420,2,28,-7,5,3,3,0,-4,4,8,2,2,0,2,4,2,2,3,1,-1,-2,-9,-7,9,2,10,0,3,-1,1,1,-1,5,1
KR_6765906503,420,0,40,4,-2,-2,2,4,1,3,2,-3,1,4,2,4,2,0,3,3,0,-2,21,-1,5,4,-2,0,2,0,1,1,1,0,1
KR_6757658288,420,5,0,8,10,3,4,1,1,3,2,4,4,0,1,3,2,1,2,1,0,5,-4,-1,4,3,2,0,1,1,1,1,-1,6,1
KR_6740318174,420,0,11,-4,-3,3,3,0,0,1,1,-2,0,2,-4,0,4,0,1,1,0,-3,4,1,3,4,2,0,-1,1,-1,-1,-1,1,1
KR_6763443938,420,-3,-60,-46,-6,0,1,1,-2,2,4,-3,1,4,1,1,0,-2,1,3,-2,-8,-9,3,2,5,1,0,0,1,-1,0,-1,1,1
KR_6759197450,420,7,94,16,16,8,8,0,1,1,0,1,1,0,6,6,0,0,1,1,0,11,-2,0,3,3,1,0,2,1,1,1,1,4,1
KR_6711374008,420,3,-2,10,16,8,9,1,-2,2,4,7,8,1,4,5,1,-1,0,1,0,5,-1,0,4,4,1,0,1,1,0,1,-1,4,1
KR_6624934501,420,-1,13,-24,-6,1,1,0,-2,1,3,-7,1,8,1,5,4,1,2,1,0,-5,16,-3,4,1,-17,0,-1,-1,-1,-1,1,6,1
KR_6695543425,420,3,8,52,7,0,1,1,5,5,0,0,5,5,2,3,1,0,1,1,0,5,37,1,4,5,-9,0,2,-1,1,1,1,5,1
KR_6759130885,420,0,-3,-12,3,0,1,1,2,2,0,3,4,1,-2,3,5,0,1,1,0,5,155,-1,3,2,0,0,0,-1,1,0,-1,6,1
KR_6731653788,420,3,14,27,4,3,3,0,0,2,2,-3,1,4,3,3,0,1,1,0,0,2,27,-4,6,2,1,0,0,-1,-1,0,-1,6,1
KR_6721300834,420,4,67,28,6,3,3,0,2,4,2,1,2,1,1,3,2,-1,0,1,0,2,54,0,5,5,16,0,1,1,0,1,1,1,1
KR_6746810312,420,3,23,32,1,1,2,1,3,3,0,-2,2,4,-1,5,6,0,0,0,0,1,7,3,1,4,0,0,1,1,1,1,-1,4,1
KR_6607581962,440,2,-5,24,6,-3,1,4,5,6,1,3,5,2,-1,2,3,2,2,0,0,13,6,2,5,7,-1,0,1,1,1,1,1,4,1
KR_6627166543,420,1,5,4,4,-1,0,1,1,3,2,0,1,1,4,4,0,0,1,1,0,6,-7,-1,4,3,6,0,1,1,-1,1,1,2,1
KR_6726883543,420,3,52,16,10,4,5,1,-4,0,4,3,5,2,6,7,1,1,3,2,0,7,-231,-2,4,2,5,0,0,1,1,1,1,6,1
KR_6755627632,440,1,5,24,0,1,2,1,0,1,1,-1,1,2,1,2,1,-1,0,1,0,-4,-2,-1,4,3,2,0,3,-1,1,1,-1,3,1
KR_6756751482,420,1,12,11,8,10,11,1,0,2,2,-4,3,7,1,2,1,1,1,0,0,-6,0,1,2,3,-1,0,0,-1,1,1,1,1,1
KR_6648837636,420,2,46,-8,8,0,1,1,0,0,0,5,5,0,4,5,1,-1,1,2,0,5,-45,1,3,4,-4,0,-1,1,0,-1,1,4,1
KR_6730481741,420,2,-56,-16,4,3,3,0,0,1,1,-8,0,8,5,6,1,4,5,1,0,9,18,-2,5,3,-1,0,0,1,-1,0,-1,2,1
KR_6765323640,420,1,45,36,4,3,5,2,3,4,1,0,3,3,1,3,2,-3,1,4,0,0,-4,3,2,5,0,0,1,1,-1,-1,1,2,1
KR_6765562813,420,-3,-79,-8,-2,-2,0,2,0,0,0,-2,1,3,2,2,0,0,0,0,0,3,72,0,7,7,-6,0,1,-1,1,1,1,1,1
KR_6732537881,440,5,129,8,17,1,1,0,0,2,2,3,4,1,1,3,2,12,12,0,0,12,6,4,0,4,-4,0,3,1,0,1,1,1,1
KR_6763745538,420,-1,30,4,-6,5,5,0,-5,2,7,-8,0,8,2,2,0,0,1,1,1,-8,14,5,2,7,-5,0,0,-1,-1,1,1,6,1
KR_6734526501,440,2,66,19,15,0,2,2,-1,0,1,5,7,2,9,9,0,2,3,1,0,10,-5,1,2,3,2,0,1,1,1,1,1,1,1
KR_6766946715,440,3,68,19,8,1,2,1,1,1,0,-1,1,2,3,3,0,4,4,0,0,6,107,2,4,6,0,0,3,0,1,1,1,0,1
KR_6662495488,420,0,-38,4,2,1,2,1,3,5,2,0,2,2,-2,0,2,0,0,0,0,3,-1,0,6,6,4,0,0,-1,1,0,-1,2,1
KR_6508579872,420,5,31,28,3,0,1,1,1,3,2,4,4,0,1,2,1,-3,1,4,0,-2,77,-1,2,1,-1,0,0,1,1,1,1,2,1
KR_6760419101,420,0,-62,-28,2,-2,1,3,0,2,2,5,5,0,-4,1,5,3,3,0,0,2,-1,1,2,3,-2,0,0,-1,-1,0,-1,1,1
KR_6764936931,420,3,57,16,-1,1,1,0,-1,5,6,-3,0,3,2,3,1,0,0,0,0,-3,10,5,3,8,-3,0,0,0,1,1,-1,0,1
KR_6742115695,440,0,21,-22,3,4,6,2,-1,0,1,-2,2,4,1,4,3,1,1,0,0,9,307,2,3,5,-1,0,0,1,1,0,1,6,1
KR_6765839077,420,1,85,16,-3,0,0,0,2,5,3,1,4,3,-6,0,6,0,1,1,-1,-7,27,-2,4,2,-22,0,0,-1,-1,0,-1,5,1
KR_6758768311,420,2,64,-2,5,-3,0,3,2,4,2,1,2,1,6,6,0,-1,0,1,-1,9,19,4,2,6,-3,0,1,1,1,1,-1,6,1
KR_6751946828,420,4,28,40,2,-5,1,6,3,4,1,1,3,2,-1,4,5,4,5,1,0,8,4,1,4,5,-2,0,1,-1,1,1,-1,6,1
KR_6760985675,420,1,92,5,6,4,4,0,-1,1,2,-1,1,2,3,5,2,1,2,1,0,2,9,4,2,6,2,0,2,1,1,1,1,4,1
KR_6691617611,440,0,102,-24,3,4,4,0,-1,3,4,0,2,2,1,7,6,-1,0,1,0,0,8,4,3,7,-1,0,0,1,-1,0,1,5,1
KR_6715816275,420,6,136,23,5,5,5,0,-1,0,1,-1,1,2,1,3,2,1,1,0,0,4,16,-4,9,5,3,0,3,1,1,1,1,4,1
KR_6762313231,420,3,51,23,12,1,2,1,3,3,0,0,9,9,2,3,1,6,6,0,0,7,-5,0,4,4,4,0,2,1,1,1,-1,6,1
KR_6711032498,420,3,63,28,1,1,4,3,-1,2,3,1,5,4,1,3,2,-1,1,2,0,-5,1,3,3,6,0,0,1,1,1,1,1,5,1
KR_6759469548,420,-1,54,19,9,4,4,0,-2,2,4,2,5,3,3,7,4,2,2,0,1,-1,-10,0,4,4,2,0,1,1,1,1,1,5,1
KR_6751266617,420,2,-31,25,1,1,2,1,1,4,3,3,4,1,-2,1,3,-2,1,3,-2,-1,-15,-3,5,2,1,0,-1,-1,1,-1,-1,4,1
KR_6610733129,440,-4,-67,-31,-4,-2,3,5,-1,2,3,-2,2,4,1,2,1,0,1,1,-1,-5,0,-4,6,2,0,0,-1,-1,-1,-1,-1,1,1
KR_6762223992,420,2,50,23,2,-6,1,7,6,6,0,0,1,1,1,2,1,1,1,0,0,5,25,1,4,5,-13,0,-1,1,1,-1,1,1,1
KR_6766876116,420,-1,-33,16,2,2,2,0,-3,0,3,1,2,1,2,2,0,0,0,0,0,-1,4,2,2,4,-5,0,0,1,1,1,1,6,1
KR_6719650510,440,6,22,0,11,1,1,0,1,4,3,4,4,0,5,5,0,0,0,0,0,18,37,-3,9,6,-5,0,1,1,-1,1,1,2,1
KR_6745494764,420,2,-19,3,0,5,5,0,0,1,1,2,3,1,-2,4,6,-5,2,7,0,-1,-11,-1,3,2,-3,0,1,-1,1,1,1,1,1
KR_6756705059,420,3,27,13,11,2,3,1,4,4,0,3,3,0,2,2,0,0,2,2,0,12,5,0,5,5,2,0,1,1,-1,1,1,4,1
KR_6732734813,420,-1,-28,16,-5,0,2,2,4,6,2,-2,1,3,-2,4,6,-5,0,5,0,-3,0,3,0,3,-1,0,0,1,1,0,1,5,1
KR_6741086803,420,4,1,19,3,-3,1,4,2,2,0,0,0,0,5,5,0,-1,1,2,0,8,4,2,4,6,5,0,1,1,-1,1,1,5,1
KR_6713593159,420,1,23,25,0,1,2,1,-1,1,2,6,6,0,-4,1,5,-2,0,2,0,-11,30,-4,7,3,-6,0,2,-1,1,1,-1,2,1
KR_6760619286,440,1,70,4,1,3,3,0,0,2,2,3,5,2,-2,3,5,-3,0,3,0,-8,0,3,0,3,0,0,0,-1,1,0,1,2,1
KR_6720421573,420,1,9,6,5,1,2,1,-1,1,2,4,4,0,1,1,0,0,1,1,0,6,2,0,2,2,-1,0,0,1,1,0,1,5,1
KR_6703509856,420,4,100,12,11,0,3,3,0,1,1,-1,3,4,11,12,1,1,3,2,-1,8,-6,2,0,2,1,0,5,1,1,1,-1,5,1
KR_6662176349,420,3,43,12,4,1,1,0,-2,1,3,4,5,1,2,6,4,-1,1,2,0,9,1,-2,6,4,-1,0,0,-1,1,0,-1,4,1
KR_6766607831,440,1,32,16,6,0,1,1,-4,0,4,3,3,0,3,7,4,4,5,1,0,5,10,2,1,3,-2,0,2,-1,1,1,1,3,1
KR_6764034104,420,4,9,19,4,2,2,0,-1,2,3,4,4,0,-1,1,2,0,0,0,0,2,4,-1,3,2,0,0,0,-1,1,-1,1,2,1
KR_6750712298,420,1,69,-8,-1,-1,3,4,2,3,1,-3,1,4,-1,2,3,2,2,0,0,2,-23,0,3,3,4,0,0,0,-1,0,-1,0,1
KR_6723264223,420,2,15,-4,5,0,4,4,1,2,1,1,4,3,1,2,1,2,2,0,-1,3,5,-5,7,2,3,0,1,0,1,1,-1,0,1
KR_6721428517,420,4,50,-4,7,3,5,2,1,5,4,-2,1,3,3,3,0,2,2,0,0,7,-11,0,3,3,12,0,2,0,-1,1,1,0,1
KR_6767169900,440,1,-19,0,-2,-6,0,6,2,2,0,1,1,0,0,2,2,1,1,0,0,3,-2,0,5,5,0,0,-1,1,1,-1,1,3,1
KR_6622767723,420,-1,-4,8,-2,-2,1,3,2,6,4,0,2,2,0,3,3,-2,0,2,0,2,3,4,1,5,-6,0,0,1,-1,0,1,6,1
KR_6759378301,440,1,7,-3,2,1,1,0,-4,0,4,3,6,3,2,2,0,0,1,1,0,-1,-27,5,3,8,21,0,0,-1,-1,1,1,2,1
KR_6763988677,420,2,-38,14,-1,-2,0,2,2,4,2,5,7,2,-3,1,4,-3,0,3,0,-6,-2,-1,4,3,2,0,0,1,-1,0,-1,2,1
KR_6729502624,420,1,9,52,4,1,4,3,3,4,1,-2,1,3,2,4,2,0,0,0,0,1,-10,-1,7,6,2,0,0,1,1,1,1,6,1
KR_6662306627,420,3,21,20,11,5,6,1,2,4,2,1,1,0,1,3,2,2,2,0,0,7,170,0,3,3,-1,0,0,1,1,0,1,6,1
KR_6570141702,420,0,-37,20,7,1,1,0,2,2,0,8,8,0,-2,4,6,-2,0,2,1,6,10,3,4,7,-2,0,0,1,1,1,1,1,1
KR_6598181475,440,4,37,13,12,-1,0,1,-1,2,3,2,4,2,7,7,0,5,5,0,0,11,30,-5,7,2,-16,0,2,-1,1,1,1,1,1
KR_6746095061,420,0,34,24,0,-1,2,3,1,1,0,3,5,2,-3,2,5,0,2,2,0,-4,-3,1,4,5,1,0,1,1,1,1,-1,3,1
KR_6747503948,440,4,-46,34,3,1,2,1,0,3,3,-1,1,2,0,2,2,3,5,2,0,1,1,-5,5,0,0,0,2,1,0,1,-1,5,1
KR_6752047363,420,0,74,8,-4,2,2,0,-2,3,5,-1,2,3,2,4,2,-5,2,7,0,3,42,-4,6,2,-23,0,0,-1,1,0,1,6,1
KR_6762755572,420,-2,39,-12,-2,2,2,0,-1,1,2,-4,0,4,1,5,4,0,0,0,0,-4,19,-3,6,3,-7,0,1,-1,0,1,-1,5,1
KR_6715695527,440,4,26,-28,10,10,11,1,2,8,6,0,1,1,-4,1,5,2,2,0,0,11,3,5,3,8,0,0,0,-1,1,-1,1,5,1
KR_6738331475,440,2,-27,28,16,10,11,1,-5,2,7,6,8,2,-2,1,3,7,7,0,-1,14,19,3,0,3,0,0,0,1,-1,1,-1,3,1
KR_6740433662,420,7,139,17,14,3,4,1,1,3,2,7,7,0,2,3,1,1,1,0,1,2,-5,8,1,9,-3,0,2,1,-1,1,1,5,1
KR_6750989284,420,2,4,-3,-1,1,1,0,0,1,1,2,3,1,-4,2,6,0,0,0,0,1,-19,0,1,1,18,0,0,0,1,0,1,0,1
KR_6743048899,420,-1,-40,11,-3,-1,0,1,1,2,1,3,3,0,-6,0,6,0,1,1,0,-1,-18,2,3,5,1,0,-2,1,-1,-1,-1,6,1
KR_6466407744,420,0,5,-32,2,2,3,1,0,4,4,-1,2,3,3,5,2,-2,0,2,0,-7,62,-1,5,4,20,0,0,1,-1,-1,1,5,1
KR_6752426193,440,5,65,56,10,-2,0,2,1,3,2,6,7,1,2,5,3,3,3,0,0,8,-51,0,3,3,16,0,1,1,1,1,-1,1,1
KR_6760241609,420,0,42,-4,-2,0,2,2,1,3,2,-2,2,4,-2,4,6,1,3,2,0,-8,3,-4,6,2,-2,0,2,-1,1,1,1,5,1
KR_6703295656,440,4,20,18,14,-2,2,4,6,8,2,6,7,1,5,7,2,-1,1,2,0,12,8,4,1,5,0,0,0,0,0,1,1,0,1
KR_6760433534,420,-2,-1,6,-7,-2,1,3,1,5,4,-3,1,4,-5,1,6,2,3,1,0,-4,-6,1,2,3,1,0,-1,0,0,-1,1,0,1
KR_6759728263,420,1,-48,-22,4,-1,1,2,-2,2,4,0,2,2,4,5,1,3,3,0,-1,5,129,3,2,5,0,0,0,0,-1,0,-1,0,1
KR_6699138426,420,2,46,31,1,3,4,1,-3,2,5,1,4,3,1,3,2,-1,1,2,1,3,-188,0,3,3,1,0,1,1,-1,1,1,2,1
KR_6700939146,420,6,14,40,11,4,4,0,6,6,0,4,4,0,-3,0,3,0,1,1,0,3,7,1,2,3,-2,0,1,1,1,1,-1,2,1
KR_6753032794,440,3,43,4,11,1,3,2,1,3,2,2,3,1,5,7,2,2,2,0,0,6,-8,-4,6,2,1,0,2,-1,1,1,-1,1,1
KR_6756082712,420,0,30,32,-4,-1,1,2,-2,3,5,-1,0,1,4,9,5,-4,0,4,0,-3,6,1,1,2,1,0,1,1,0,1,-1,3,1
KR_6737451474,420,1,11,-12,2,-2,2,4,-3,0,3,3,7,4,-7,0,7,11,11,0,-1,-2,4,-5,5,0,1,0,2,-1,1,1,-1,1,1
KR_6756988343,420,0,-54,-10,1,-1,0,1,2,4,2,-1,1,2,1,4,3,0,1,1,0,3,-13,-4,6,2,2,0,2,1,1,1,1,4,1
KR_6747553043,420,4,52,-40,12,1,1,0,2,2,0,1,1,0,4,5,1,4,4,0,0,13,27,-1,5,4,3,0,2,-1,-1,1,1,4,1
KR_6595142472,420,0,-37,-15,13,-1,2,3,6,8,2,3,5,2,8,10,2,-3,1,4,0,10,5,6,2,8,-3,0,1,1,1,1,-1,3,1
KR_6752604531,420,4,80,7,-1,-1,1,2,0,3,3,0,1,1,1,5,4,-1,1,2,-1,-2,344,0,4,4,-29,0,0,1,0,0,-1,3,1
KR_6721661649,440,3,15,-5,4,1,5,4,3,8,5,1,4,3,-2,4,6,1,4,3,-3,-3,10,2,4,6,3,0,-1,-1,-1,-1,-1,4,1
KR_6678492012,420,2,-1,18,1,7,8,1,-3,2,5,-3,1,4,1,3,2,-1,3,4,0,-5,-45,1,4,5,25,0,1,1,1,1,1,2,1
KR_6736842779,440,0,63,3,-3,4,7,3,-2,2,4,-2,0,2,-2,1,3,-1,3,4,1,-2,1,-2,5,3,2,0,0,-1,-1,0,1,1,1
KR_6662813050,420,5,97,14,8,4,4,0,5,6,1,-1,0,1,-1,0,1,1,1,0,0,9,-153,0,6,6,5,0,2,1,0,1,1,6,1
KR_6722994279,420,-2,93,0,-4,-1,1,2,0,1,1,1,1,0,-3,0,3,-1,1,2,0,-9,-37,2,4,6,-3,0,1,0,1,1,1,0,1
KR_6722376890,420,1,23,24,6,0,2,2,4,4,0,-1,3,4,-1,3,4,4,4,0,0,11,7,6,3,9,3,0,0,1,-1,0,1,4,1
KR_6724096576,420,-1,17,12,-5,3,5,2,-1,1,2,-5,2,7,-1,3,4,-1,2,3,0,-9,16,-1,3,2,-1,0,-1,1,-1,-1,-1,5,1
KR_6767337944,420,4,-15,-12,5,-2,0,2,-1,2,3,-3,0,3,8,8,0,3,4,1,0,9,-6,-4,8,4,2,0,0,1,-1,0,1,6,1
KR_6744455604,420,7,140,16,13,8,8,0,4,6,2,-1,0,1,2,3,1,0,0,0,0,3,-25,-1,4,3,2,0,2,0,0,1,1,0,1
KR_6746807166,420,4,54,24,5,6,7,1,2,5,3,4,5,1,-2,1,3,-5,2,7,0,1,6,0,1,1,-1,0,1,1,1,1,1,2,1
KR_6768093586,420,2,26,-32,10,8,8,0,3,3,0,4,5,1,-3,1,4,-2,0,2,0,5,268,0,4,4,1,0,1,1,1,1,1,3,1
KR_6765318600,420,1,-1,2,3,-4,0,4,2,5,3,4,7,3,4,5,1,-3,0,3,0,0,2,4,2,6,-3,0,0,1,0,-1,1,5,1
KR_6754480543,440,7,72,36,11,7,7,0,-4,0,4,4,4,0,6,7,1,-2,0,2,3,5,8,1,4,5,2,0,2,1,1,1,1,1,1
KR_6756819486,420,2,85,-44,5,5,6,1,2,2,0,-2,3,5,0,2,2,0,1,1,0,7,-113,-2,5,3,4,0,2,-1,1,1,1,6,1
KR_6763942793,420,2,37,1,10,0,3,3,3,5,2,-2,1,3,8,8,0,1,1,0,0,6,-4,1,3,4,3,0,1,1,1,1,1,4,1
KR_6690365855,420,2,-14,36,7,-3,3,6,0,4,4,4,4,0,3,4,1,3,4,1,1,3,23,3,3,6,-1,0,1,0,1,1,1,0,1
KR_6747919194,420,-1,-25,0,-2,-1,2,3,1,1,0,-1,0,1,-3,1,4,2,2,0,0,-1,11,5,2,7,-7,0,0,1,-1,0,1,1,1
KR_6723137149,420,1,21,0,8,0,0,0,1,6,5,6,6,0,-1,1,2,2,4,2,0,5,2,0,3,3,-1,0,1,0,1,1,-1,0,1
KR_6754879393,420,-2,34,-24,-2,0,2,2,-3,1,4,2,3,1,-3,1,4,2,2,0,1,-1,9,0,3,3,-1,0,1,-1,1,1,1,1,1
KR_6763345348,420,2,1,4,7,4,7,3,2,2,0,3,4,1,-1,4,5,-1,0,1,0,2,-20,-2,7,5,0,0,3,1,1,1,1,3,1
KR_6747501023,440,3,33,28,11,2,2,0,7,8,1,4,4,0,-5,0,5,3,7,4,0,8,-10,-3,7,4,1,0,0,1,0,0,1,4,1
KR_6751807208,420,-3,-54,-15,-10,-10,1,11,-1,1,2,-2,0,2,1,1,0,2,3,1,0,4,-4,-4,5,1,-1,0,-1,-1,1,-1,-1,6,1
KR_6699287563,420,5,55,32,14,3,4,1,8,8,0,4,6,2,-1,2,3,0,0,0,0,11,-7,1,3,4,2,0,0,1,1,1,-1,2,1
KR_6738664222,420,5,87,44,14,5,6,1,1,4,3,7,8,1,3,5,2,-2,0,2,0,5,37,-1,2,1,2,0,1,0,-1,1,1,0,1
KR_6739617945,420,5,1,124,13,-1,1,2,9,10,1,2,4,2,6,7,1,-3,2,5,0,12,6,6,1,7,-4,0,2,1,1,1,-1,2,1
KR_6615719692,420,0,9,36,2,-2,1,3,1,2,1,2,5,3,1,3,2,0,0,0,1,6,-131,3,1,4,4,0,1,1,1,1,1,4,1
KR_6752675425,420,3,3,32,5,1,2,1,4,8,4,2,7,5,-1,2,3,-1,3,4,0,6,39,-3,8,5,-16,0,1,-1,1,1,1,3,1
KR_6732060533,420,0,-2,24,9,0,1,1,2,2,0,-1,2,3,5,7,2,3,4,1,1,9,14,1,3,4,-1,0,1,-1,-1,1,1,5,1
KR_6759162603,420,6,18,10,26,4,8,4,6,7,1,5,6,1,7,7,0,4,4,0,0,16,14,7,0,7,-1,0,1,1,1,1,1,1,1
KR_6730787210,420,3,66,28,3,2,2,0,1,4,3,3,4,1,-2,0,2,-1,0,1,0,-5,-9,0,5,5,-1,0,1,1,-1,1,1,5,1
KR_6751290867,420,3,95,35,7,2,5,3,2,4,2,-1,5,6,5,6,1,-1,1,2,0,-6,0,2,1,3,4,0,2,1,0,1,1,3,1
KR_6695592081,420,9,136,30,23,7,7,0,0,2,2,9,10,1,6,7,1,1,1,0,1,14,224,0,4,4,1,0,1,1,1,1,1,1,1
KR_6768451253,420,4,28,16,1,1,3,2,-1,2,3,-6,0,6,6,7,1,1,1,0,0,-4,4,2,1,3,3,0,2,1,0,1,-1,1,1
KR_6767413728,420,1,-12,-33,5,-5,0,5,-3,1,4,3,3,0,1,3,2,9,11,2,0,15,42,0,5,5,-22,0,0,-1,-1,-1,1,1,1
KR_6761248508,420,2,32,18,0,0,1,1,0,2,2,2,3,1,-2,4,6,0,0,0,-1,-5,-2,-2,6,4,2,0,0,1,-1,0,-1,5,1
KR_6766369569,420,0,-24,6,-6,2,4,2,-3,0,3,1,2,1,-5,0,5,-1,1,2,0,-14,5,-2,4,2,-1,0,-1,1,-1,-1,-1,3,1
KR_6756398835,440,4,89,11,11,3,5,2,2,4,2,4,6,2,6,8,2,-4,2,6,1,2,2,2,4,6,5,0,2,-1,1,1,-1,3,1
KR_6764075456,420,1,12,2,3,1,2,1,0,1,1,-1,2,3,2,2,0,1,1,0,0,5,1,3,4,7,-1,0,0,0,1,0,-1,0,1
KR_6594818571,420,4,124,23,6,3,3,0,2,5,3,1,2,1,1,1,0,-1,0,1,1,4,-4,-2,5,3,0,0,1,-1,-1,1,-1,2,1
KR_6742577180,420,5,-4,-3,13,-1,3,4,3,3,0,2,4,2,8,9,1,1,2,1,0,14,4,7,1,8,0,0,1,-1,0,1,1,6,1
KR_6617758743,420,3,41,24,6,-1,0,1,2,5,3,3,4,1,2,3,1,0,2,2,0,3,-7,3,3,6,3,0,2,1,1,1,1,4,1
KR_6764447411,420,5,42,8,13,1,3,2,3,3,0,4,4,0,2,8,6,3,4,1,1,13,9,3,2,5,0,0,2,1,-1,1,1,4,1
KR_6755975300,420,-1,-34,-39,2,-2,2,4,1,1,0,5,5,0,-1,1,2,-1,0,1,0,5,5,0,4,4,-3,0,1,-1,0,1,-1,6,1
KR_6728634207,440,3,-55,5,5,2,3,1,6,10,4,-1,2,3,0,4,4,-2,1,3,1,0,-5,-5,5,0,1,0,-1,0,0,-1,1,0,1
KR_6485547019,420,1,-51,-32,-6,4,4,0,5,6,1,-2,1,3,-10,1,11,-3,3,6,-2,-10,-1,-1,5,4,-1,0,0,1,1,-1,-1,5,1
KR_6746702401,420,4,114,23,7,9,9,0,0,1,1,1,2,1,-5,2,7,2,2,0,0,5,-15,-2,5,3,1,0,2,1,1,1,1,2,1
KR_6752448093,420,3,33,6,6,0,2,2,2,3,1,-1,0,1,4,4,0,1,1,0,0,5,12,1,6,7,2,0,0,1,-1,0,1,3,1
KR_6760496642,420,-2,-48,11,-3,-4,1,5,2,3,1,0,2,2,-1,2,3,0,1,1,0,0,-1,-1,3,2,2,0,-1,-1,-1,-1,-1,4,1
KR_6641186470,420,0,55,-42,3,1,2,1,2,4,2,-2,4,6,0,1,1,2,3,1,0,-3,-1,0,4,4,5,0,-1,1,-1,-1,1,2,1
KR_6757569946,420,-2,17,-4,-3,-2,1,3,-1,1,2,2,6,4,-5,2,7,3,3,0,1,-6,20,1,4,5,-4,0,-1,-1,-1,-1,1,3,1
KR_6719750083,420,1,-14,-7,3,-7,0,7,3,3,0,-3,0,3,8,8,0,2,3,1,0,11,2,-1,3,2,3,0,1,1,1,1,1,3,1
KR_6760338879,420,-2,-55,-31,4,-3,1,4,1,1,0,3,3,0,1,3,2,2,2,0,1,10,-40,5,3,8,12,0,0,0,1,-1,1,0,1
KR_6647880491,420,5,-12,24,13,1,2,1,3,4,1,5,6,1,4,6,2,0,2,2,0,10,-7,-3,6,3,0,0,2,1,1,1,-1,5,1
KR_6704681774,440,4,-11,0,14,3,3,0,3,4,1,8,8,0,0,1,1,0,2,2,1,19,-6,1,3,4,2,0,0,-1,-1,0,1,1,1
KR_6749124902,420,1,1,12,1,5,5,0,-2,1,3,0,5,5,-2,1,3,0,1,1,1,3,-75,2,2,4,-4,0,0,1,1,-1,1,2,1
KR_6760505682,420,3,26,4,10,3,3,0,-1,0,1,1,3,2,4,5,1,3,4,1,1,13,8,-1,2,1,0,0,1,1,0,1,1,3,1
KR_6746792063,420,3,-27,-10,15,1,2,1,0,2,2,5,5,0,7,9,2,2,4,2,0,2,-17,0,5,5,3,0,1,1,1,1,1,3,1
KR_6750707173,420,0,3,24,2,1,2,1,-1,2,3,3,4,1,-2,1,3,1,1,0,0,0,2,-2,6,4,5,0,1,1,-1,1,1,1,1
KR_6766638044,420,-1,-38,12,3,-5,0,5,2,3,1,6,6,0,1,2,1,-1,1,2,0,3,0,1,5,6,1,0,1,1,0,1,1,5,1
KR_6765716388,420,5,0,44,4,1,3,2,6,8,2,2,3,1,-5,1,6,0,0,0,-1,5,12,0,4,4,0,0,1,-1,0,-1,-1,5,1
KR_6734708645,420,2,17,44,-1,-1,1,2,2,2,0,-1,2,3,0,2,2,-1,0,1,0,0,3,-3,7,4,-2,0,0,1,-1,-1,1,4,1
KR_6768458209,420,0,10,8,3,-1,2,3,1,5,4,0,1,1,5,6,1,-2,3,5,0,8,0,-1,4,3,5,0,1,1,-1,1,-1,2,1
KR_6755024730,420,3,29,23,6,0,2,2,-3,2,5,5,6,1,2,3,1,2,2,0,0,6,-241,-4,6,2,3,0,0,0,1,1,1,0,1
KR_6752290372,420,1,8,4,7,1,5,4,-1,5,6,4,4,0,5,6,1,-2,1,3,1,9,9,4,4,8,-3,0,0,1,-1,1,1,5,1
KR_6623903916,420,4,145,40,4,-1,0,1,1,3,2,0,2,2,0,1,1,4,4,0,0,3,3,4,2,6,0,0,2,1,1,1,1,3,1
KR_6726574927,420,2,82,-1,6,3,4,1,0,3,3,5,9,4,3,3,0,-5,0,5,0,-6,-2,-3,8,5,4,0,0,1,0,1,1,1,1
KR_6682739459,420,4,27,56,8,-3,2,5,5,7,2,7,10,3,-2,3,5,1,1,0,0,2,11,1,3,4,1,0,1,1,-1,1,1,1,1
KR_6724657625,440,-3,-25,24,-2,-1,1,2,-2,2,4,4,5,1,-1,4,5,-2,0,2,-2,4,3,3,1,4,0,0,-1,1,0,-1,-1,6,1
KR_6764658777,420,2,16,4,6,5,5,0,5,6,1,0,2,2,-4,4,8,0,0,0,0,2,3,-1,4,3,0,0,1,1,1,1,1,6,1
KR_6684674130,420,1,81,-4,4,5,7,2,-1,1,2,-3,0,3,4,4,0,-1,0,1,1,-2,2,2,4,6,5,0,1,-1,0,1,1,2,1
KR_6761953470,420,2,112,-4,-2,1,2,1,0,2,2,0,0,0,0,4,4,-3,1,4,-1,-3,39,2,5,7,-21,0,2,1,-1,1,-1,4,1
KR_6756667168,420,2,50,-19,6,2,3,1,-2,0,2,1,3,2,3,3,0,2,3,1,0,5,8,2,1,3,4,0,1,1,1,1,1,5,1
KR_6726657617,420,4,29,7,3,5,5,0,-2,1,3,3,4,1,-2,1,3,-1,0,1,0,-2,-6,0,4,4,1,0,1,-1,1,1,1,5,1
KR_6706111076,420,4,98,7,6,3,5,2,1,5,4,0,2,2,-1,1,2,3,3,0,0,-1,19,-5,6,1,9,0,3,1,1,1,1,3,1
KR_6762493813,420,3,81,19,-4,-1,1,2,-1,1,2,4,6,2,-4,1,5,-2,3,5,0,-3,8,5,3,8,1,0,0,1,1,1,-1,3,1
KR_6761319906,420,4,44,1,6,-1,1,2,5,7,2,0,0,0,3,6,3,-1,1,2,-2,4,7,9,1,10,-3,0,1,-1,1,1,-1,4,1
KR_6765275088,420,1,38,44,-2,1,2,1,-2,2,4,5,6,1,-5,1,6,-1,2,3,0,-10,18,-2,6,4,0,0,1,1,1,1,-1,4,1
KR_6691874072,420,7,108,20,18,8,8,0,4,6,2,-1,1,2,6,6,0,1,1,0,0,17,-13,4,6,10,-2,0,1,0,-1,1,-1,0,1
KR_6671425572,420,-1,-19,4,1,0,2,2,-4,1,5,2,5,3,3,4,1,0,1,1,0,0,184,2,3,5,-2,0,0,1,1,1,-1,2,1
KR_6763925271,420,7,44,-4,3,2,3,1,1,4,3,1,4,3,0,2,2,-1,0,1,1,-1,1,1,5,6,2,0,0,1,-1,0,1,2,1
KR_6752139746,440,3,50,-7,13,-1,1,2,7,7,0,-3,1,4,9,10,1,1,2,1,0,16,7,5,3,8,0,0,2,1,0,1,1,6,1
KR_6762627330,420,-1,57,-4,-5,0,1,1,-4,0,4,0,3,3,-2,0,2,1,2,1,0,-12,1,0,4,4,3,0,2,-1,1,1,1,6,1
KR_6764752668,440,0,-11,-23,4,-3,1,4,-5,0,5,2,4,2,8,11,3,2,3,1,0,1,-9,6,4,10,-6,0,0,1,-1,-1,1,2,1
KR_6762969123,420,5,11,8,12,6,8,2,0,3,3,1,3,2,1,6,5,4,5,1,-1,2,21,-5,6,1,-1,0,2,1,0,1,-1,5,1
KR_6569677923,440,3,32,31,5,-2,0,2,3,7,4,2,5,3,0,2,2,2,2,0,0,1,10,4,3,7,1,0,1,1,-1,1,-1,4,1
KR_6583951739,420,-1,0,17,-1,2,3,1,0,3,3,1,3,2,-2,1,3,-2,1,3,0,-4,-1,3,2,5,-1,0,1,1,-1,1,-1,4,1
KR_6751173114,420,1,34,8,0,1,1,0,0,1,1,-1,3,4,1,3,2,-1,0,1,1,4,131,-1,5,4,-3,0,0,0,0,0,1,0,1
KR_6665110516,420,-2,-28,1,0,0,3,3,3,3,0,0,5,5,-3,2,5,0,2,2,1,11,-6,-1,5,4,-1,0,-1,1,-1,-1,1,3,1
KR_6762420150,420,0,-24,28,-2,-4,0,4,0,3,3,2,3,1,0,2,2,0,1,1,0,-2,14,-1,9,8,2,0,0,1,1,1,1,1,1
KR_6720343893,420,3,17,40,7,5,5,0,5,5,0,-1,1,2,1,2,1,-3,0,3,0,3,-6,3,5,8,-3,0,0,1,1,0,1,4,1
KR_6765539109,420,2,7,-24,3,4,4,0,-1,3,4,0,1,1,0,5,5,0,0,0,1,-3,44,2,4,6,-9,0,0,-1,-1,1,1,2,1
KR_6703536729,420,8,134,76,12,1,2,1,0,1,1,6,7,1,6,7,1,-1,0,1,0,10,17,6,2,8,0,0,3,1,1,1,1,1,1
KR_6738150494,440,2,-11,-2,0,1,2,1,2,4,2,-2,2,4,-1,2,3,0,0,0,0,1,3,4,2,6,-3,0,-1,-1,1,-1,1,2,1
KR_6749969952,420,-3,-58,-13,-6,-7,0,7,-5,1,6,2,2,0,5,9,4,-1,1,2,0,5,-7,-6,9,3,6,0,-1,1,1,-1,1,3,1
KR_6758378791,440,0,13,22,4,1,2,1,2,2,0,-5,0,5,8,9,1,-2,1,3,0,4,-4,4,3,7,6,0,0,1,-1,1,1,2,1
KR_6609917619,420,0,-10,8,0,1,1,0,2,5,3,-1,0,1,-1,3,4,-1,1,2,0,-2,1,4,1,5,-4,0,0,1,0,0,1,5,1
KR_6758738081,420,4,102,52,4,0,2,2,2,5,3,-1,0,1,2,4,2,1,3,2,0,-3,0,-1,5,4,-4,0,1,-1,1,1,1,3,1
KR_6673936050,420,1,-40,0,1,4,6,2,-2,2,4,0,1,1,0,2,2,-1,0,1,1,-2,5,2,2,4,-5,0,0,1,1,0,1,4,1
KR_6766864298,420,-1,27,-22,4,-2,3,5,-2,0,2,0,2,2,4,5,1,4,4,0,0,5,0,3,1,4,0,0,1,1,-1,1,1,4,1
KR_6758448076,420,6,49,16,10,4,6,2,2,3,1,0,2,2,5,7,2,-1,0,1,0,5,-1,-4,4,0,1,0,1,1,-1,1,1,3,1
KR_6762054189,420,1,13,20,1,-1,2,3,1,1,0,0,0,0,-1,3,4,2,2,0,0,4,-168,-4,6,2,7,0,1,-1,1,1,-1,4,1
KR_6624676264,420,0,29,28,-2,1,1,0,-2,4,6,2,4,2,-1,6,7,-2,0,2,-1,-8,21,1,2,3,-4,0,0,1,0,0,-1,5,1
KR_6760547819,420,0,11,-20,-2,-3,1,4,-1,3,4,0,1,1,2,3,1,0,2,2,0,4,-247,0,5,5,1,0,0,1,0,-1,-1,3,1
KR_6724109203,420,-2,-28,-10,3,1,3,2,1,4,3,1,2,1,4,6,2,-4,1,5,0,5,13,6,2,8,-4,0,-2,-1,-1,-1,-1,5,1
KR_6623204518,420,2,22,24,3,1,1,0,-3,2,5,2,4,2,1,6,5,2,2,0,0,5,12,5,1,6,2,0,-1,1,-1,-1,1,4,1
KR_6730863773,420,8,77,36,20,0,0,0,4,5,1,4,5,1,8,8,0,4,4,0,0,14,2,4,2,6,5,0,1,1,0,1,1,5,1
KR_6573242327,420,0,40,-8,-1,2,2,0,-3,2,5,2,3,1,0,3,3,-2,1,3,0,-6,6,1,4,5,6,0,1,1,1,1,1,3,1
KR_6647324181,420,0,-63,20,0,1,2,1,-1,2,3,5,5,0,-2,0,2,-3,2,5,0,-7,-19,2,1,3,4,0,1,-1,1,1,1,1,1
KR_6758605696,420,2,64,12,4,0,1,1,2,5,3,1,3,2,0,2,2,1,1,0,0,5,6,1,3,4,0,0,1,1,1,1,1,4,1
KR_6765743434,420,5,-5,23,14,0,1,1,4,5,1,3,3,0,1,3,2,6,6,0,1,11,5,3,5,8,-2,0,2,1,1,1,1,1,1
KR_6722041325,420,-3,-36,-4,-6,-1,0,1,0,3,3,-3,1,4,-2,3,5,0,1,1,-1,-3,-3,-1,6,5,1,0,-1,0,-1,-1,-1,0,1
KR_6713487099,420,-3,-41,5,-4,2,2,0,-2,4,6,0,2,2,-1,0,1,-3,0,3,0,-3,-4,0,7,7,-5,0,-1,1,1,-1,-1,5,1
KR_6724026675,420,2,-19,4,1,0,2,2,0,5,5,3,5,2,-1,2,3,-1,2,3,0,9,22,4,2,6,2,0,0,1,-1,0,-1,6,1
KR_6762761283,420,3,38,-10,9,-2,3,5,3,6,3,4,5,1,1,3,2,3,3,0,0,12,-138,0,3,3,2,0,1,1,-1,1,-1,4,1
KR_6596676373,420,5,62,-12,6,-2,0,2,0,2,2,-2,3,5,6,6,0,4,4,0,0,6,36,-6,6,0,-15,0,2,1,-1,1,-1,3,1
KR_6754371680,420,0,71,16,5,0,3,3,-1,0,1,2,3,1,4,6,2,0,2,2,0,2,3,1,4,5,-2,0,3,-1,-1,1,1,6,1
KR_6754834702,420,3,60,44,8,2,5,3,3,4,1,1,5,4,1,2,1,1,1,0,0,6,-1,1,1,2,0,0,2,1,-1,1,1,2,1
KR_6671363576,420,3,9,-16,10,8,8,0,-2,0,2,2,4,2,3,4,1,-1,2,3,0,8,-21,1,2,3,-1,0,1,1,1,1,1,5,1
KR_6733601817,420,0,26,40,3,-1,1,2,-5,5,10,1,1,0,6,7,1,2,2,0,0,1,-1,5,5,10,0,0,3,1,1,1,-1,3,1
KR_6736989399,420,0,12,8,7,2,4,2,-3,1,4,7,9,2,-3,3,6,4,5,1,1,7,-2,-6,8,2,-3,0,1,-1,1,1,1,3,1
KR_6758120217,440,-1,69,6,-7,-1,0,1,1,2,1,2,2,0,-4,1,5,-5,0,5,0,-7,41,-2,5,3,-16,0,2,-1,1,1,-1,5,1
KR_6761569640,440,0,-14,-11,0,1,2,1,-2,3,5,-2,1,3,0,0,0,3,5,2,0,7,56,-3,8,5,-36,0,0,1,1,-1,-1,3,1
KR_6700518767,420,0,-30,23,3,-2,2,4,5,5,0,-1,2,3,2,5,3,-1,1,2,-1,3,-1,-5,8,3,0,0,-2,-1,-1,-1,-1,4,1
KR_6750578217,420,1,-10,-4,7,-1,1,2,3,4,1,3,5,2,1,5,4,1,3,2,0,1,6,-1,5,4,2,0,0,1,1,0,1,1,1
KR_6401596128,420,4,60,48,7,-2,0,2,6,8,2,2,2,0,0,7,7,1,4,3,0,7,5,-1,6,5,6,0,1,1,1,1,-1,4,1
KR_6767682756,440,3,37,4,-1,-3,3,6,0,2,2,0,0,0,0,2,2,2,2,0,0,0,83,-5,6,1,1,0,1,-1,1,1,1,2,1
KR_6752072504,420,2,21,-4,6,0,0,0,5,7,2,0,1,1,2,4,2,-1,1,2,0,3,-4,-3,8,5,3,0,0,1,1,0,1,6,1
KR_6727263787,420,3,97,20,7,1,1,0,3,4,1,1,3,2,2,2,0,0,0,0,0,4,-1,0,2,2,2,0,2,1,-1,1,1,2,1
KR_6763812502,440,-3,-16,-6,-4,2,4,2,1,5,4,-3,2,5,-5,0,5,1,2,1,0,-6,4,-2,5,3,4,0,-1,-1,1,-1,-1,4,1
KR_6594829977,420,5,83,-7,14,2,2,0,6,7,1,0,1,1,6,8,2,0,1,1,0,21,-19,4,6,10,23,0,2,1,1,1,1,2,1
KR_6731420948,420,4,93,16,11,8,8,0,2,3,1,-1,0,1,2,3,1,0,2,2,0,6,2,-2,5,3,2,0,1,-1,0,1,1,6,1
KR_6751061211,420,1,-69,-2,-3,-3,1,4,5,8,3,-5,2,7,-1,2,3,1,2,1,0,-9,1,-2,4,2,0,0,-2,-1,1,-1,-1,6,1
KR_6636143479,420,1,12,12,-1,-4,0,4,-1,3,4,-1,0,1,2,3,1,3,7,4,0,-2,-14,0,3,3,0,0,1,1,1,1,1,5,1
KR_6761701950,420,0,-8,-28,2,-2,1,3,-2,3,5,7,8,1,0,1,1,-1,1,2,0,-2,31,-1,6,5,-7,0,1,1,1,1,1,2,1
KR_6768470692,420,5,137,17,13,6,7,1,-1,0,1,2,4,2,3,5,2,3,5,2,0,7,-244,5,3,8,2,0,1,1,-1,1,1,4,1
KR_6761233732,420,-3,-61,-17,-5,0,4,4,1,3,2,-4,2,6,-5,2,7,3,4,1,-1,-5,-6,0,3,3,3,0,1,1,1,1,-1,2,1
KR_6760316284,420,9,95,14,17,0,3,3,1,1,0,6,8,2,6,11,5,4,5,1,-1,10,22,-2,4,2,-4,0,3,1,1,1,-1,4,1
KR_6739252018,420,3,35,51,6,-2,2,4,1,3,2,6,7,1,1,4,3,0,3,3,0,4,2,-1,3,2,3,0,1,1,0,1,1,2,1
KR_6755108771,420,5,93,0,5,0,2,2,-3,3,6,1,4,3,2,2,0,5,6,1,0,3,1,-11,11,0,3,0,0,0,-1,0,1,0,1
KR_6741123081,420,0,-9,4,0,-1,3,4,0,5,5,4,4,0,-2,3,5,-1,1,2,0,0,5,0,2,2,-1,0,0,-1,0,0,-1,2,1
KR_6755663280,440,-2,-22,3,1,-8,2,10,1,3,2,4,6,2,2,2,0,2,5,3,0,0,-3,-5,7,2,-5,0,0,0,1,0,1,0,1
KR_6760562844,420,2,63,-5,9,-3,1,4,-3,2,5,9,10,1,3,5,2,3,3,0,0,5,7,11,1,12,0,0,2,1,-1,1,1,5,1
KR_6625182295,420,0,20,-11,-2,-3,0,3,0,3,3,2,5,3,-1,1,2,0,1,1,0,0,221,1,4,5,-4,0,0,1,-1,0,1,6,1
KR_6482568841,420,-1,-6,8,2,0,1,1,-1,2,3,2,4,2,-1,1,2,2,2,0,0,2,46,-2,8,6,1,0,1,-1,0,1,-1,4,1
KR_6767808700,420,3,55,5,10,2,4,2,7,7,0,2,3,1,0,3,3,-1,0,1,1,9,0,-2,4,2,2,0,0,1,1,0,1,6,1
KR_6723574606,420,-1,42,-10,9,7,8,1,-3,2,5,0,1,1,3,4,1,2,2,0,2,20,-7,-2,6,4,-4,0,2,-1,1,1,1,3,1
KR_6768460908,420,3,-17,8,8,1,2,1,6,6,0,0,2,2,1,5,4,0,0,0,0,8,-9,-2,6,4,3,0,0,1,1,0,1,6,1
KR_6739887935,420,4,110,33,6,1,2,1,-4,2,6,0,1,1,10,12,2,-1,0,1,0,-6,4,8,0,8,-2,0,2,1,1,1,1,4,1
KR_6751059823,440,-2,-14,-6,0,0,0,0,0,2,2,-1,0,1,-3,1,4,4,4,0,0,-1,2,-1,10,9,0,0,0,1,-1,-1,-1,2,1
KR_6763298560,420,-1,-2,8,0,2,4,2,0,0,0,-2,4,6,0,2,2,0,0,0,0,-3,-96,-1,6,5,0,0,0,1,0,0,1,6,1
KR_6740094191,440,3,83,44,4,0,2,2,1,2,1,6,8,2,-6,2,8,3,3,0,1,0,12,4,4,8,1,0,0,-1,-1,0,1,3,1
KR_6689657920,420,3,102,23,6,1,3,2,2,3,1,-1,0,1,3,4,1,1,1,0,0,6,0,1,3,4,1,0,1,-1,-1,1,1,5,1
KR_6493316029,420,4,63,16,8,1,1,0,5,7,2,0,3,3,0,2,2,2,2,0,0,3,1,-1,3,2,1,0,-1,-1,1,1,1,6,1
KR_6751476412,440,0,-34,26,7,-4,1,5,7,9,2,2,6,4,2,5,3,0,2,2,-2,3,-16,2,4,6,0,0,0,1,-1,-1,-1,5,1
KR_6764751717,440,2,-15,16,0,4,4,0,-1,2,3,-3,2,5,-1,3,4,1,2,1,0,-3,-15,-2,6,4,10,0,0,0,1,0,-1,0,1
KR_6711292168,420,3,58,3,7,2,2,0,1,1,0,0,2,2,2,5,3,2,2,0,0,6,-8,-3,5,2,3,0,3,1,1,1,1,2,1
KR_6728880715,420,2,33,64,5,-1,0,1,3,4,1,0,2,2,2,6,4,1,4,3,0,3,2,2,3,5,4,0,1,1,1,1,1,6,1
KR_6693644940,420,1,-31,-4,12,3,4,1,5,6,1,4,5,1,-1,1,2,1,1,0,0,11,2,0,5,5,2,0,0,1,-1,0,1,5,1
KR_6764451330,420,3,79,8,9,1,1,0,9,9,0,-1,2,3,-1,2,3,1,2,1,0,5,-2,-1,4,3,0,0,1,1,1,1,1,6,1
KR_6766805290,420,-5,-65,-32,-5,-5,1,6,-3,2,5,1,3,2,1,3,2,1,2,1,0,-10,-8,-4,8,4,1,0,0,-1,-1,-1,1,1,1
KR_6767978816,420,0,-64,0,-3,1,2,1,-1,1,2,-3,1,4,0,1,1,0,1,1,0,-2,17,6,2,8,-5,0,-2,0,-1,-1,-1,0,1
KR_6678133321,420,-2,-22,-18,-5,0,1,1,-2,2,4,-5,1,6,3,4,1,-1,0,1,0,5,-3,-2,4,2,-2,0,0,-1,1,0,-1,6,1
KR_6756241235,420,7,2,24,21,-2,1,3,-1,1,2,9,9,0,9,9,0,6,6,0,1,17,-5,1,3,4,-1,0,3,1,-1,1,1,6,1
KR_6764132931,420,0,53,-12,1,-1,2,3,2,7,5,-3,2,5,3,4,1,0,0,0,1,13,-394,-1,4,3,4,0,-1,-1,-1,-1,1,6,1
KR_6631773940,420,-2,34,-20,-1,-1,1,2,2,3,1,-3,1,4,1,2,1,0,0,0,0,-3,-286,-4,6,2,-16,0,0,1,1,1,-1,2,1
KR_6706352108,420,3,52,4,4,-1,1,2,3,3,0,0,3,3,1,3,2,1,2,1,0,6,-12,4,2,6,4,0,0,1,0,0,1,5,1
KR_6768208756,420,2,41,-12,5,0,1,1,3,5,2,5,6,1,-2,1,3,-1,1,2,0,5,-14,0,3,3,1,0,0,1,-1,1,1,6,1
KR_6758191310,440,1,-35,4,6,1,3,2,1,3,2,-1,5,6,1,1,0,4,6,2,-1,12,-2,-1,3,2,-2,0,-1,1,-1,-1,-1,2,1
KR_6747391640,420,1,19,-12,3,4,5,1,0,0,0,0,2,2,1,4,3,-2,1,3,0,5,-36,0,4,4,15,0,0,-1,-1,-1,-1,3,1
KR_6573195848,420,7,93,58,21,11,11,0,-3,3,6,5,6,1,7,9,2,1,6,5,3,17,20,4,0,4,5,0,1,1,1,1,1,6,1
KR_6668562069,420,4,77,-4,6,4,5,1,1,5,4,1,2,1,1,5,4,-1,2,3,1,0,2,4,6,10,1,0,0,-1,-1,1,1,5,1
KR_6721775494,440,1,10,1,0,2,6,4,0,4,4,0,2,2,1,1,0,-3,0,3,0,-1,1,1,3,4,2,0,2,1,1,1,1,3,1
KR_6743972889,420,5,82,7,12,3,4,1,4,5,1,0,6,6,3,3,0,2,2,0,0,12,10,1,3,4,-1,0,3,1,0,1,1,6,1
KR_6766093754,420,4,73,-2,9,7,7,0,-2,3,5,5,5,0,-1,1,2,0,0,0,0,7,-4,2,3,5,4,0,2,1,1,1,1,5,1
KR_6764367424,420,4,42,16,8,2,2,0,2,2,0,1,2,1,3,6,3,0,0,0,0,12,-17,-1,5,4,-2,0,0,1,1,-1,-1,6,1
KR_6758940007,440,-2,-16,-8,-6,-2,4,6,3,5,2,-8,0,8,-1,4,5,2,3,1,0,2,-47,0,3,3,29,0,-1,-1,1,-1,1,2,1
KR_6767406509,420,2,56,5,1,2,4,2,1,2,1,1,1,0,-2,2,4,-1,1,2,0,-4,-147,-1,4,3,-2,0,-1,-1,1,-1,1,4,1
KR_6761205895,440,2,-3,16,2,2,4,2,-1,3,4,1,2,1,0,0,0,0,1,1,0,3,1,-1,6,5,3,0,0,-1,1,0,1,4,1
KR_6733864090,420,3,-21,46,9,0,3,3,3,6,3,5,5,0,-1,1,2,2,4,2,0,11,4,-1,6,5,-5,0,0,1,0,1,1,5,1
KR_6719262058,420,5,105,20,7,1,2,1,1,4,3,3,4,1,2,3,1,0,1,1,0,4,28,-4,7,3,2,0,2,1,1,1,1,5,1
KR_6744305798,420,-1,-53,27,-3,1,2,1,-1,2,3,-1,1,2,0,2,2,-2,1,3,0,-8,-4,2,3,5,-3,0,0,0,1,0,1,0,1
KR_6727627235,420,-1,9,20,-8,-3,2,5,-3,0,3,1,1,0,1,1,0,-4,1,5,0,-11,10,-2,4,2,-4,0,-1,1,-1,-1,-1,5,1
KR_6757727320,420,3,12,-7,2,0,3,3,0,2,2,3,4,1,-2,0,2,1,1,0,0,-7,3,-1,5,4,4,0,1,-1,-1,1,1,6,1
KR_6706820596,420,-2,24,-4,0,-1,3,4,0,1,1,1,3,2,-1,3,4,1,2,1,0,3,25,-1,4,3,-5,0,-1,1,-1,-1,1,1,1
KR_6767978087,420,0,-26,-8,4,0,2,2,2,5,3,4,4,0,-4,1,5,2,5,3,0,-2,1,2,4,6,2,0,-1,1,1,-1,1,2,1
KR_6751938042,420,2,54,-15,4,5,5,0,-1,3,4,-6,1,7,4,5,1,2,3,1,0,0,-247,5,1,6,1,0,1,-1,-1,1,1,3,1
KR_6764827868,440,-1,-3,-3,-7,-1,1,2,-3,0,3,-2,0,2,0,2,2,-1,2,3,0,-8,-61,0,5,5,2,0,-1,-1,1,-1,-1,1,1
KR_6766656805,420,1,-9,28,5,-2,1,3,2,3,1,-1,0,1,4,5,1,2,3,1,0,8,11,3,4,7,-4,0,1,1,-1,1,1,6,1
KR_6724935163,420,-1,2,26,-5,0,3,3,1,4,3,-6,0,6,-1,2,3,1,2,1,-1,-5,13,-4,6,2,2,0,0,-1,0,1,-1,4,1
KR_6763721717,420,-3,-9,-4,-6,-7,0,7,1,2,1,-4,2,6,1,3,2,3,3,0,0,8,-10,-3,5,2,0,0,-1,-1,1,-1,-1,1,1
KR_6735908454,440,5,136,0,14,3,4,1,7,8,1,1,3,2,2,6,4,1,1,0,1,14,-5,-2,6,4,-3,0,3,1,1,1,1,2,1
KR_6744959480,420,6,35,24,12,9,9,0,3,7,4,1,4,3,-2,0,2,1,3,2,0,6,2,3,2,5,0,0,2,-1,1,1,-1,1,1
KR_6626387985,420,0,-15,23,0,-2,1,3,6,7,1,-6,3,9,0,4,4,2,4,2,-1,1,-5,-3,3,0,0,0,-1,-1,0,-1,1,5,1
KR_6764015289,420,4,-4,6,8,1,2,1,1,3,2,-1,1,2,2,5,3,5,5,0,2,10,-30,0,2,2,3,0,1,1,-1,1,1,2,1
KR_6752328717,420,0,31,12,-3,-6,0,6,-1,2,3,2,4,2,2,2,0,0,3,3,0,-6,24,-4,5,1,0,0,2,-1,1,1,1,1,1
KR_6757956570,420,3,28,16,4,0,1,1,5,6,1,-2,1,3,0,4,4,1,1,0,0,5,-3,4,3,7,5,0,1,1,0,1,-1,2,1
KR_6745474839,420,0,23,12,-1,-2,1,3,-2,0,2,-4,3,7,4,5,1,3,3,0,0,6,-6,0,3,3,1,0,0,1,-1,-1,-1,6,1
KR_6767615970,420,2,89,-20,12,-2,1,3,7,7,0,4,5,1,4,4,0,-1,1,2,0,9,49,5,3,8,-17,0,2,1,-1,1,1,5,1
KR_6751653754,420,5,21,60,10,1,2,1,2,2,0,3,4,1,3,4,1,1,2,1,0,9,-1,-2,4,2,5,0,1,1,1,1,1,2,1
KR_6679521102,420,-1,-8,-16,-1,-2,0,2,4,4,0,3,3,0,-1,0,1,-5,1,6,-1,-9,-83,-4,7,3,-3,0,0,1,1,-1,-1,3,1
KR_6760645060,420,2,8,24,-1,-2,0,2,0,4,4,-3,1,4,1,4,3,3,3,0,0,-3,-2,-3,6,3,1,0,-1,0,-1,-1,1,0,1
KR_6755059829,420,0,8,-4,0,3,4,1,0,0,0,1,1,0,-3,0,3,-1,1,2,0,-7,5,5,3,8,1,0,1,0,1,1,1,0,1
KR_6760251287,420,1,-28,-41,5,1,3,2,5,5,0,-2,1,3,-1,1,2,2,2,0,1,10,9,6,2,8,0,0,2,-1,1,1,1,3,1
KR_6731469374,420,2,2,12,12,3,4,1,-2,1,3,3,3,0,2,4,2,6,6,0,0,13,-1,3,6,9,2,0,1,-1,1,1,-1,6,1
KR_6726003436,440,-4,-51,-18,-2,-1,1,2,-2,2,4,3,4,1,1,3,2,-3,0,3,0,2,116,1,4,5,0,0,0,1,1,1,1,5,1
KR_6762213429,420,-1,-61,-4,2,-1,2,3,3,4,1,-5,2,7,2,3,1,3,4,1,0,11,-23,-2,4,2,0,0,-3,1,-1,-1,1,4,1
KR_6758792169,440,4,26,-15,12,-1,4,5,1,5,4,5,7,2,4,6,2,3,3,0,0,12,30,1,2,3,1,0,-1,-1,-1,-1,1,6,1
KR_6766791452,420,4,8,-8,9,1,1,0,1,3,2,4,8,4,6,6,0,-3,1,4,0,13,8,3,3,6,-2,0,0,1,-1,0,-1,2,1
KR_6768410465,420,-1,-47,-20,0,-4,1,5,-6,1,7,7,7,0,2,5,3,1,1,0,2,10,-13,-1,6,5,-2,0,0,-1,1,-1,1,6,1
KR_6727652401,420,0,53,0,3,0,1,1,2,7,5,1,3,2,1,2,1,-1,1,2,1,7,-19,-1,6,5,-6,0,0,1,-1,0,1,6,1
KR_6508691331,420,0,25,-13,3,0,0,0,5,7,2,-2,0,2,0,1,1,0,1,1,1,13,38,1,3,4,-2,0,0,1,1,0,1,3,1
KR_6654592757,420,5,-8,20,7,3,4,1,-1,2,3,6,6,0,-2,2,4,1,1,0,0,2,117,-2,6,4,1,0,1,1,1,1,1,3,1
KR_6749289909,420,-1,19,-8,-2,1,4,3,-1,6,7,0,0,0,-1,2,3,-1,2,3,0,-5,-234,0,3,3,-2,0,-1,1,-1,-1,-1,6,1
KR_6765724732,440,2,7,-9,6,0,2,2,6,6,0,1,2,1,-1,5,6,0,1,1,0,6,204,4,3,7,2,0,0,1,1,0,-1,3,1
KR_6757072971,420,0,40,-5,3,4,4,0,1,2,1,2,4,2,-1,6,7,-3,0,3,1,4,31,9,0,9,-1,0,0,0,1,-1,1,0,1
KR_6611865045,440,2,56,0,6,4,5,1,0,5,5,3,4,1,-2,0,2,1,1,0,0,-1,14,5,3,8,1,0,1,1,1,1,1,5,1
KR_6688488334,420,3,48,-24,8,3,3,0,-2,1,3,2,2,0,5,5,0,0,1,1,0,6,-6,0,7,7,8,0,1,-1,1,1,1,6,1
KR_6748675017,420,2,59,11,6,3,4,1,1,1,0,3,6,3,0,4,4,-1,0,1,1,0,0,-1,5,4,1,0,0,0,-1,0,1,0,1
KR_6759032184,440,3,30,16,5,-1,0,1,2,2,0,6,6,0,0,6,6,-2,0,2,0,0,37,6,1,7,1,0,1,1,0,1,-1,6,1
KR_6767383855,420,0,28,20,0,-4,1,5,3,5,2,5,5,0,-5,0,5,1,1,0,0,-1,-67,1,3,4,1,0,0,1,1,0,-1,1,1
KR_6768301677,420,3,43,16,5,0,1,1,-1,1,2,1,2,1,6,7,1,-1,0,1,0,4,38,1,4,5,-26,0,0,-1,1,0,-1,1,1
KR_6761045210,420,3,16,9,11,1,3,2,0,2,2,1,2,1,7,9,2,2,3,1,0,9,159,2,4,6,-20,0,0,0,0,1,1,0,1
KR_6692409267,420,-3,-26,-17,-10,-5,0,5,1,2,1,-4,0,4,-3,1,4,1,1,0,0,-12,3,2,2,4,2,0,-1,0,1,-1,-1,0,1
KR_6759097537,420,4,67,34,7,0,2,2,-1,2,3,4,6,2,5,6,1,-1,4,5,1,-3,1,-3,7,4,2,0,0,1,1,1,1,6,1
KR_6745809451,420,5,70,18,5,-1,1,2,-4,0,4,3,6,3,5,6,1,2,4,2,0,6,12,5,1,6,1,0,2,1,0,1,-1,3,1
KR_6765691758,420,1,10,23,4,1,2,1,2,4,2,1,4,3,1,3,2,-1,1,2,0,2,-22,-3,6,3,-2,0,1,0,0,1,1,0,1
KR_6701240415,420,5,105,-4,18,3,5,2,5,6,1,6,7,1,5,7,2,-1,1,2,1,12,5,2,3,5,2,0,4,1,1,1,1,3,1
KR_6755313129,420,3,106,8,9,-1,1,2,1,3,2,9,10,1,7,7,0,-7,1,8,0,10,4,2,6,8,7,0,1,1,-1,1,1,3,1
KR_6639889456,420,2,51,0,8,1,2,1,2,4,2,2,2,0,1,1,0,2,2,0,0,4,32,1,4,5,4,0,2,-1,1,1,1,3,1
KR_6638973222,420,4,32,-3,14,3,5,2,-1,1,2,0,4,4,9,10,1,3,3,0,0,16,10,5,2,7,0,0,2,-1,1,1,1,1,1
KR_6610629161,440,1,66,16,-2,1,1,0,-5,2,7,-1,4,5,3,3,0,0,0,0,0,-2,5,2,2,4,2,0,0,1,1,1,-1,5,1
KR_6749089848,420,-1,43,-12,-14,-2,1,3,0,2,2,-4,3,7,-7,2,9,-1,1,2,-1,-24,17,-1,8,7,1,0,-2,-1,-1,1,-1,1,1
KR_6768377701,420,-2,-63,-8,-7,0,1,1,-1,4,5,-1,4,5,-2,2,4,-3,1,4,0,-7,15,-1,5,4,-5,0,-1,0,-1,-1,-1,0,1
KR_6753750472,420,3,77,4,0,1,2,1,1,1,0,-2,0,2,0,1,1,0,0,0,1,-4,7,-3,5,2,4,0,0,1,1,0,1,1,1
KR_6709063784,420,0,-23,20,0,4,6,2,0,4,4,-2,2,4,-3,2,5,1,1,0,0,-3,-43,0,5,5,13,0,2,-1,1,1,1,2,1
KR_6709539777,420,-1,-52,3,1,0,2,2,6,7,1,-2,1,3,-2,2,4,-1,0,1,0,1,-5,0,7,7,0,0,0,-1,1,0,1,5,1
KR_6645293529,420,7,91,-4,16,6,6,0,3,5,2,0,2,2,5,7,2,2,2,0,0,14,0,-1,7,6,0,0,1,0,0,1,1,0,1
KR_6768456415,420,0,-28,35,4,-7,0,7,3,3,0,0,0,0,7,7,0,1,2,1,-1,14,9,-2,7,5,5,0,2,1,1,1,-1,5,1
KR_6693647477,420,1,48,17,-2,2,2,0,-2,2,4,-3,3,6,1,4,3,0,0,0,1,-12,2,-1,2,1,0,0,1,-1,0,1,1,1,1
KR_6662387756,420,3,33,20,6,0,1,1,2,2,0,0,1,1,2,2,0,2,3,1,0,7,102,-2,5,3,1,0,1,0,0,1,1,0,1
KR_6739819106,420,-1,59,-29,-6,1,4,3,-8,0,8,-1,0,1,4,4,0,-2,0,2,0,-8,9,4,5,9,-1,0,1,-1,-1,1,-1,1,1
KR_6683092466,420,1,-52,4,10,0,2,2,1,3,2,10,11,1,-2,2,4,1,1,0,0,11,3,-2,4,2,1,0,1,1,0,1,1,2,1
KR_6606709236,420,3,45,6,8,-1,2,3,1,3,2,8,9,1,-2,3,5,2,2,0,-1,0,-214,1,3,4,1,0,1,1,0,1,-1,6,1
KR_6758445310,420,-1,29,1,-3,2,5,3,-4,0,4,-1,4,5,1,3,2,-1,1,2,0,-4,-8,-5,7,2,0,0,1,1,-1,1,-1,4,1
KR_6765690515,420,3,45,-6,13,-3,1,4,5,6,1,1,3,2,8,9,1,2,3,1,0,8,3,-2,5,3,3,0,1,1,-1,1,1,2,1
KR_6753351032,420,4,43,24,8,-1,0,1,4,4,0,2,3,1,2,3,1,1,1,0,0,11,16,1,5,6,-4,0,3,-1,1,1,1,2,1
KR_6704452750,420,5,109,-19,3,2,2,0,-1,3,4,1,1,0,4,4,0,-3,0,3,0,11,-35,-2,6,4,0,0,1,1,-1,1,1,6,1
KR_6210652980,420,1,69,-4,5,1,3,2,0,2,2,0,0,0,6,6,0,-2,0,2,1,7,-66,3,4,7,30,0,1,1,0,1,1,3,1
KR_6764178716,420,-1,45,-49,-2,3,3,0,-2,3,5,-5,0,5,-2,2,4,4,5,1,-1,-4,-8,2,4,6,-5,0,1,-1,1,1,-1,3,1
KR_6765558789,420,-3,-65,-2,2,2,3,1,0,3,3,0,3,3,-3,1,4,3,3,0,0,1,2,-4,5,1,2,0,-1,-1,0,-1,-1,2,1
KR_6706197158,420,3,75,12,5,2,4,2,-1,1,2,2,3,1,1,5,4,1,1,0,0,1,7,2,4,6,-2,0,-1,1,-1,-1,1,5,1
KR_6762204767,420,1,-13,11,-2,-2,1,3,3,5,2,-1,0,1,-1,2,3,-1,0,1,0,-5,-47,-4,8,4,23,0,-1,1,-1,-1,-1,6,1
KR_6739335176,420,5,67,19,13,0,2,2,6,8,2,4,4,0,2,6,4,1,2,1,0,14,-63,1,7,8,12,0,1,1,1,1,1,5,1
KR_6444431648,420,2,-74,0,4,0,1,1,3,3,0,1,2,1,0,2,2,0,1,1,0,6,-110,-3,6,3,2,0,0,0,0,0,1,0,1
KR_6760924573,420,1,-35,8,-2,-3,1,4,1,1,0,-5,1,6,1,2,1,4,5,1,0,-2,5,1,6,7,-2,0,0,1,-1,0,-1,4,1
KR_6644655113,420,4,26,0,4,-1,2,3,1,8,7,-3,0,3,4,7,3,3,3,0,0,9,3,2,5,7,0,0,0,1,1,0,-1,2,1
KR_6738545472,420,3,61,-16,9,-2,0,2,2,3,1,1,2,1,6,9,3,2,2,0,0,9,-23,2,2,4,4,0,2,1,1,1,1,6,1
KR_6766525069,420,1,-43,-22,8,-1,3,4,6,6,0,6,8,2,0,3,3,-3,0,3,1,15,11,-2,6,4,3,0,0,1,1,1,1,3,1
KR_6754119850,420,1,68,-5,2,-6,0,6,-2,0,2,6,6,0,0,2,2,4,4,0,0,-2,-2,-3,4,1,4,0,1,0,1,1,1,0,1
KR_6743693649,420,-1,95,3,8,0,1,1,-2,2,4,1,2,1,8,10,2,1,2,1,0,6,2,4,0,4,2,0,1,1,-1,1,1,2,1
KR_6766900815,420,2,14,28,0,1,2,1,3,3,0,2,6,4,-2,1,3,-4,0,4,-2,-3,18,-7,11,4,-18,0,0,1,1,1,-1,6,1
KR_6717922451,420,-1,49,-15,-3,-1,0,1,-4,0,4,2,2,0,0,1,1,0,0,0,0,-8,13,2,2,4,0,0,1,1,1,1,-1,5,1
KR_6711055469,420,4,65,11,5,1,2,1,5,6,1,-1,1,2,0,1,1,0,0,0,0,6,1,0,5,5,2,0,2,1,1,1,1,3,1
KR_6762689451,420,-1,30,4,0,-1,5,6,1,1,0,-1,5,6,0,4,4,1,1,0,1,5,260,-3,4,1,0,0,-2,1,0,-1,1,4,1
KR_6647600144,420,1,-6,-17,0,1,2,1,-3,0,3,5,5,0,-3,0,3,0,0,0,0,-5,45,4,2,6,-1,0,-1,1,1,-1,1,6,1
KR_6689156444,420,0,53,-19,0,3,4,1,-3,1,4,-3,1,4,5,6,1,-2,0,2,-1,0,6,2,3,5,-5,0,0,1,0,0,-1,3,1
KR_6747626080,420,0,-10,5,-2,1,3,2,3,6,3,-4,3,7,-3,2,5,1,2,1,0,-4,-32,0,3,3,19,0,0,1,-1,0,-1,2,1
KR_6596402156,420,1,-21,41,4,-2,1,3,3,6,3,5,6,1,-3,3,6,1,3,2,0,-4,-6,1,5,6,-5,0,-1,-1,0,-1,1,1,1
KR_6768337887,440,3,11,9,4,-1,0,1,1,2,1,1,2,1,3,4,1,0,0,0,0,10,6,-2,6,4,5,0,0,-1,1,0,-1,3,1
KR_6768094739,440,-2,-22,16,-8,-2,2,4,1,6,5,2,2,0,-5,1,6,-4,0,4,0,-6,27,0,1,1,-4,0,0,1,-1,-1,-1,3,1
KR_6754303666,420,1,5,-28,-1,2,4,2,-2,2,4,-4,1,5,1,4,3,2,2,0,-2,-3,1,-3,4,1,-4,0,0,0,1,0,-1,0,1
KR_6761333699,420,2,-40,40,5,-2,0,2,4,6,2,3,4,1,2,5,3,-2,1,3,1,5,-6,6,2,8,-1,0,1,-1,1,1,1,3,1
KR_6765164405,420,3,117,6,4,3,5,2,0,3,3,3,3,0,0,3,3,-2,1,3,0,-3,-25,-3,7,4,3,0,2,1,1,1,-1,3,1
KR_6754069918,420,5,19,4,9,5,6,1,-1,2,3,-2,0,2,6,7,1,1,2,1,0,8,131,1,3,4,5,0,2,0,-1,1,-1,0,1
KR_6711602089,440,-3,-93,12,-4,-2,2,4,-1,3,4,-1,1,2,-3,1,4,3,6,3,1,1,42,0,5,5,-1,0,-1,1,-1,-1,1,4,1
KR_6688990941,420,1,43,12,4,-3,0,3,-1,3,4,2,5,3,4,6,2,2,4,2,0,5,13,3,4,7,1,0,0,-1,-1,1,1,6,1
KR_6768306647,440,1,20,-28,10,-3,1,4,7,9,2,2,2,0,3,4,1,1,3,2,0,12,-122,2,3,5,-3,0,2,1,-1,-1,1,2,1
KR_6758843428,420,1,18,-20,2,2,5,3,-5,0,5,2,2,0,2,3,1,1,1,0,0,1,-15,-3,4,1,2,0,1,-1,1,1,1,4,1
KR_6755309212,440,5,113,38,9,1,3,2,3,3,0,0,3,3,2,3,1,3,4,1,0,14,158,-4,7,3,3,0,4,1,1,1,1,5,1
KR_6679278871,420,3,15,40,1,2,2,0,4,5,1,0,3,3,-3,0,3,-2,0,2,0,4,6,4,2,6,-2,0,0,1,-1,-1,1,1,1
KR_6602313539,420,3,28,61,9,-3,1,4,-1,4,5,0,4,4,15,16,1,-2,2,4,-1,-7,10,2,1,3,-4,0,2,0,1,1,-1,0,1
KR_6749056390,420,-1,17,-1,0,5,7,2,0,2,2,0,1,1,-3,0,3,-2,2,4,-1,-6,2,3,2,5,-3,0,0,-1,1,-1,-1,6,1
KR_6707270385,420,4,40,8,15,3,4,1,-1,2,3,0,2,2,6,6,0,7,7,0,0,15,3,1,4,5,2,0,3,1,0,1,1,6,1
KR_6761687371,420,1,26,-20,-3,1,3,2,-4,1,5,0,3,3,1,2,1,-1,1,2,0,-7,1,-6,9,3,4,0,0,-1,-1,-1,-1,4,1
KR_6673496214,420,-1,-37,-14,-2,1,1,0,-3,0,3,-3,2,5,0,4,4,3,4,1,0,0,4,-2,5,3,0,0,0,-1,-1,0,-1,2,1
KR_6734921148,420,0,-11,-17,5,0,3,3,-2,2,4,2,5,3,4,5,1,1,4,3,0,11,-3,4,4,8,3,0,0,-1,-1,1,1,4,1
KR_6757569417,420,0,47,25,5,3,3,0,0,2,2,-1,3,4,1,4,3,2,2,0,0,7,3,2,5,7,4,0,0,1,1,0,1,1,1
KR_6764532584,420,1,-59,16,7,3,3,0,-1,3,4,4,6,2,2,3,1,-1,1,2,0,6,2,0,4,4,0,0,1,-1,-1,1,-1,5,1
KR_6710115647,420,0,33,-5,-3,0,2,2,-1,0,1,-5,4,9,2,4,2,1,3,2,4,-6,6,-2,9,7,-4,0,0,1,-1,-1,-1,6,1
KR_6630902362,420,-1,19,-4,7,-1,1,2,-4,0,4,1,2,1,12,12,0,-1,2,3,0,12,178,0,3,3,3,0,0,1,-1,1,1,6,1
KR_6559709011,420,3,45,-2,9,-2,2,4,1,4,3,3,3,0,4,4,0,3,4,1,0,6,-62,-8,12,4,34,0,2,1,1,1,-1,4,1
KR_6768327665,420,3,30,-12,10,3,3,0,-2,1,3,8,9,1,1,2,1,0,1,1,0,11,9,3,1,4,0,0,2,-1,1,1,1,2,1
KR_6752716498,420,0,11,-9,-1,0,3,3,-1,0,1,-2,0,2,1,1,0,1,1,0,0,1,-28,-3,4,1,13,0,0,-1,-1,0,-1,4,1
KR_6717866886,420,2,-25,40,5,1,1,0,1,2,1,0,1,1,2,5,3,1,3,2,0,-2,14,2,2,4,2,0,0,0,1,0,1,0,1
KR_6759183164,420,3,-9,37,5,-2,1,3,0,1,1,7,9,2,-1,3,4,1,1,0,2,6,129,3,2,5,-1,0,0,1,1,1,1,6,1
KR_6754906634,420,-1,11,-8,3,-1,3,4,3,5,2,1,1,0,0,0,0,0,1,1,0,4,223,1,3,4,18,0,-1,1,1,-1,-1,4,1
KR_6707879764,440,2,93,8,0,2,3,1,-2,3,5,1,4,3,0,4,4,-1,0,1,-2,1,6,-3,8,5,-1,0,0,1,-1,1,-1,3,1
KR_6729742419,420,7,47,67,8,-3,1,4,1,2,1,3,3,0,1,2,1,6,6,0,0,6,16,0,2,2,3,0,2,-1,-1,1,1,4,1
KR_6580007482,420,1,-38,20,6,1,1,0,3,3,0,0,2,2,3,4,1,-1,0,1,1,8,-7,-4,6,2,21,0,0,-1,1,0,1,5,1
KR_6764066358,420,-2,-34,-36,-3,-2,0,2,2,4,2,-3,1,4,0,2,2,0,0,0,0,-1,-87,3,4,7,-1,0,0,0,1,0,-1,0,1
KR_6719331432,420,7,74,29,14,1,3,2,4,4,0,3,5,2,4,5,1,2,2,0,1,7,2,-1,6,5,0,0,1,1,1,1,1,3,1
KR_6749608113,420,1,52,5,1,1,2,1,2,2,0,-3,2,5,4,4,0,-3,0,3,0,-2,9,5,2,7,0,0,0,-1,-1,1,1,2,1
KR_6751794634,420,5,127,3,24,7,7,0,1,2,1,12,13,1,2,3,1,2,5,3,1,27,49,4,2,6,-16,0,1,1,1,1,1,3,1
KR_6617691351,420,1,56,0,0,9,9,0,-1,2,3,-3,0,3,-2,3,5,-3,0,3,0,-6,101,3,3,6,-1,0,1,-1,1,1,1,4,1
KR_6726820189,420,1,25,0,2,0,1,1,1,2,1,1,2,1,0,3,3,0,1,1,0,1,-15,3,3,6,-4,0,0,1,-1,0,1,3,1
KR_6762810717,420,-3,-32,-16,-1,0,0,0,-1,1,2,2,6,4,-1,4,5,-1,2,3,0,-6,-17,-5,9,4,3,0,0,1,1,0,1,6,1
KR_6758867796,440,2,77,-17,5,1,2,1,-2,1,3,-3,3,6,9,9,0,0,1,1,1,3,-4,-1,5,4,0,0,1,-1,0,1,1,4,1
KR_6763239752,420,1,-6,29,3,0,3,3,-2,0,2,3,3,0,-1,4,5,3,3,0,0,3,-4,-1,4,3,1,0,2,-1,-1,1,1,5,1
KR_6661523671,420,0,-54,-4,5,0,2,2,-3,0,3,5,8,3,3,5,2,0,0,0,0,6,0,1,5,6,2,0,0,1,0,0,1,1,1
KR_6661976446,420,0,37,6,3,0,2,2,2,5,3,3,6,3,1,1,0,-3,1,4,0,-1,5,1,5,6,2,0,-1,1,-1,-1,1,5,1
KR_6742597112,420,0,36,-8,-2,1,2,1,-6,1,7,3,5,2,0,2,2,0,2,2,0,-7,-40,-2,7,5,7,0,1,-1,1,1,1,4,1
KR_6752671672,420,2,44,-3,9,5,7,2,-1,4,5,2,2,0,6,7,1,-3,0,3,0,6,-2,-3,7,4,2,0,1,0,-1,1,1,0,1
KR_6652886027,420,2,-25,38,3,-3,3,6,3,4,1,1,1,0,2,2,0,0,2,2,0,-3,6,0,5,5,1,0,0,-1,1,0,-1,1,1
KR_6733724411,420,-1,-28,-20,1,0,1,1,0,4,4,3,3,0,-4,0,4,2,5,3,0,-1,248,0,6,6,-1,0,0,1,-1,-1,1,5,1
KR_6745679789,420,3,31,-16,18,2,4,2,2,4,2,3,7,4,10,13,3,1,1,0,2,29,6,3,0,3,-2,0,1,1,0,1,1,3,1
KR_6768125955,420,1,-43,7,-3,-1,0,1,0,2,2,-1,1,2,-1,1,2,0,2,2,0,0,-8,-5,10,5,1,0,0,-1,1,-1,-1,1,1
KR_6763133781,420,-2,24,-16,-1,1,1,0,-5,1,6,2,2,0,1,1,0,0,1,1,0,-5,40,0,4,4,-22,0,0,-1,1,1,1,5,1
KR_6756156403,420,1,23,9,2,-4,0,4,1,2,1,2,5,3,5,6,1,-2,1,3,0,13,-23,1,4,5,3,0,1,1,1,1,1,5,1
KR_6584035160,420,5,-2,37,10,1,2,1,6,10,4,2,3,1,1,5,4,0,0,0,-1,11,50,6,2,8,-31,0,2,1,1,1,-1,4,1
KR_6767250290,420,-4,-70,-8,-1,1,3,2,-2,4,6,2,2,0,-1,3,4,-1,1,2,0,-1,34,-1,5,4,-2,0,0,1,1,0,1,1,1
KR_6647548214,420,2,5,17,12,1,2,1,4,6,2,7,8,1,0,2,2,0,2,2,1,14,5,0,1,1,2,0,2,1,1,1,1,3,1
KR_6745504020,420,1,67,-4,-1,-1,1,2,4,6,2,-4,1,5,0,1,1,0,2,2,0,-1,-1,0,4,4,3,0,1,1,1,1,-1,3,1
KR_6765673852,440,1,119,16,-6,-2,0,2,-2,1,3,1,2,1,-2,5,7,-1,2,3,0,-4,0,-6,7,1,3,0,0,1,-1,1,-1,5,1
KR_6487134550,420,1,-28,-21,5,-3,0,3,-2,3,5,5,5,0,1,1,0,4,5,1,0,5,7,-3,5,2,8,0,0,-1,0,0,-1,3,1
KR_6693526556,420,0,27,-8,7,2,3,1,-1,3,4,3,3,0,2,2,0,1,1,0,0,5,-78,1,4,5,1,0,1,1,1,1,1,2,1
KR_6700529902,420,3,30,43,2,-1,2,3,-1,1,2,2,2,0,2,3,1,0,4,4,0,-1,-10,-1,4,3,-2,0,1,1,-1,1,1,2,1
KR_6732660687,420,2,14,13,4,0,1,1,-1,1,2,2,5,3,0,4,4,3,3,0,1,5,3,-5,6,1,1,0,0,-1,1,0,1,6,1
KR_6680315780,420,7,82,6,14,2,3,1,2,4,2,5,5,0,5,9,4,0,1,1,1,18,10,-5,6,1,1,0,1,1,-1,1,1,3,1
KR_6718088858,420,5,-13,36,13,0,1,1,3,4,1,0,3,3,9,10,1,1,1,0,1,18,185,0,4,4,-1,0,0,-1,-1,1,1,6,1
KR_6703424730,420,0,-5,-19,-2,1,2,1,2,3,1,-4,1,5,1,4,3,-2,1,3,1,1,-264,-2,7,5,1,0,0,1,-1,0,1,5,1
KR_6764954937,420,-6,-61,-34,-13,-9,0,9,2,4,2,0,0,0,-5,1,6,-1,1,2,0,-6,-1,1,2,3,-1,0,-1,-1,-1,-1,1,3,1
KR_6721930596,440,3,61,20,16,3,3,0,4,5,1,7,9,2,1,3,2,1,1,0,0,11,49,0,5,5,3,0,2,1,1,1,1,1,1
KR_6763959838,420,1,-8,43,9,1,2,1,0,1,1,5,5,0,0,2,2,3,4,1,0,0,2,2,4,6,-1,0,0,1,0,0,1,3,1
KR_6767508899,420,1,21,28,4,1,4,3,2,5,3,-1,5,6,-1,3,4,3,4,1,0,5,-32,-3,5,2,3,0,1,1,0,1,-1,4,1
KR_6724174284,420,-1,-18,-23,-1,3,4,1,-1,3,4,-2,1,3,-1,1,2,0,0,0,0,4,-1,3,2,5,-4,0,0,1,-1,-1,1,6,1
KR_6755437747,420,2,105,8,3,0,0,0,-2,0,2,4,6,2,-1,4,5,2,2,0,3,2,-3,-1,5,4,7,0,2,1,-1,1,1,3,1
KR_6762881689,420,-1,-21,0,-7,3,4,1,-2,3,5,-1,1,2,-6,0,6,-1,0,1,-3,-6,-2,-3,4,1,-1,0,0,1,1,1,1,1,1
KR_6707049905,420,6,52,33,3,-1,1,2,0,1,1,6,6,0,-4,1,5,2,2,0,0,-3,-170,0,3,3,-4,0,2,-1,1,1,-1,6,1
KR_6743947228,440,1,33,0,-5,1,3,2,0,1,1,-3,2,5,0,0,0,-3,1,4,0,-5,5,-1,5,4,0,0,1,-1,-1,1,-1,3,1
KR_6627083909,420,0,-10,-4,-5,-1,1,2,0,2,2,-5,0,5,1,4,3,0,1,1,0,-6,-49,-5,5,0,26,0,0,1,1,0,-1,4,1
KR_6493791349,420,5,41,8,19,1,1,0,2,2,0,5,5,0,4,7,3,7,7,0,0,19,-185,-3,7,4,-24,0,1,1,-1,1,-1,6,1
KR_6712228060,440,7,103,4,17,3,4,1,4,5,1,3,3,0,7,7,0,0,1,1,0,10,-1,4,1,5,0,0,1,0,-1,1,1,0,1
KR_6767140146,420,3,-4,0,11,1,1,0,3,3,0,-1,3,4,5,6,1,3,4,1,0,18,-3,0,3,3,3,0,1,1,1,1,-1,3,1
KR_6750688132,420,11,88,52,25,5,5,0,4,4,0,9,11,2,4,4,0,3,3,0,1,14,129,5,3,8,3,0,4,1,1,1,1,2,1
KR_6745232014,420,1,6,27,0,3,3,0,-1,4,5,1,2,1,-4,6,10,1,1,0,0,-5,3,0,8,8,1,0,0,-1,-1,1,1,2,1
KR_6762567699,420,1,-6,8,4,-3,1,4,4,6,2,-3,0,3,4,7,3,2,2,0,0,9,9,-3,5,2,1,0,0,1,1,1,-1,5,1
KR_6664652836,440,3,102,13,7,0,2,2,1,3,2,-3,1,4,7,7,0,2,2,0,1,7,5,3,1,4,1,0,2,0,-1,1,1,0,1
KR_6661688237,420,4,53,30,14,0,3,3,1,3,2,5,7,2,6,7,1,2,3,1,2,5,-30,4,1,5,17,0,2,1,1,1,1,1,1
KR_6639011662,420,4,76,4,8,3,3,0,6,8,2,-1,2,3,0,1,1,0,0,0,0,5,13,2,4,6,1,0,1,1,1,1,1,2,1
KR_6757861018,420,6,27,62,6,-1,4,5,2,3,1,4,4,0,0,2,2,1,1,0,0,5,12,0,2,2,-1,0,2,1,-1,1,1,2,1
KR_6714568282,420,2,-10,-7,10,-2,1,3,2,3,1,2,3,1,8,11,3,0,2,2,0,18,4,6,1,7,0,0,2,1,1,1,1,6,1
KR_6759753976,420,4,72,-8,15,-3,0,3,6,6,0,-2,4,6,10,12,2,4,4,0,2,21,42,7,3,10,-14,0,2,0,1,1,1,0,1
KR_6759497310,420,2,31,-8,5,3,4,1,1,2,1,-2,2,4,4,6,2,-1,1,2,0,2,-35,4,5,9,17,0,0,1,1,1,-1,1,1
KR_6713867293,420,5,82,46,15,1,3,2,5,6,1,1,6,5,6,9,3,2,3,1,0,10,-7,-6,8,2,0,0,1,1,-1,1,1,1,1
KR_6764777230,420,2,63,12,15,4,5,1,2,2,0,3,3,0,5,5,0,1,1,0,1,23,13,0,4,4,1,0,0,1,1,1,1,4,1
KR_6767189975,420,1,67,0,1,-1,2,3,4,4,0,0,3,3,-2,1,3,0,1,1,0,2,50,5,3,8,-28,0,1,1,1,1,1,5,1
KR_6628326264,420,3,-12,18,7,0,1,1,2,4,2,1,2,1,3,3,0,1,1,0,0,11,-3,1,3,4,-2,0,0,0,1,0,1,0,1
KR_6727493123,420,8,76,13,16,3,3,0,0,5,5,2,2,0,5,6,1,6,7,1,2,21,6,1,8,9,-1,0,2,1,-1,1,1,2,1
KR_6759928802,420,4,60,4,13,2,4,2,1,6,5,4,5,1,5,6,1,1,1,0,0,10,-3,-2,5,3,0,0,1,1,1,1,1,6,1
KR_6688854517,420,-1,88,-23,1,0,3,3,3,4,1,2,2,0,2,2,0,-6,1,7,0,-6,0,1,6,7,0,0,2,1,-1,1,-1,6,1
KR_6493608164,420,-2,-49,-12,1,-6,0,6,0,1,1,1,1,0,-1,2,3,7,7,0,0,3,-3,0,4,4,5,0,-1,1,-1,-1,-1,3,1
KR_6732761516,440,4,75,8,4,3,3,0,4,4,0,-8,1,9,5,6,1,0,0,0,0,6,8,-1,4,3,-2,0,1,-1,-1,1,-1,3,1
KR_6561967700,420,1,0,-11,3,-1,1,2,-3,4,7,-1,1,2,2,2,0,6,7,1,0,3,22,-2,5,3,3,0,0,1,-1,0,1,1,1
KR_6723613973,420,4,-13,-16,8,2,3,1,8,9,1,-1,2,3,2,5,3,-3,2,5,0,10,6,3,0,3,-3,0,-1,1,1,-1,-1,1,1
KR_6738832935,420,4,26,5,4,2,3,1,2,2,0,4,7,3,-3,1,4,-1,0,1,0,1,-7,3,2,5,-1,0,0,1,1,1,-1,1,1
KR_6756171462,420,0,20,36,-2,3,3,0,-3,0,3,-8,2,10,7,7,0,-1,1,2,0,-1,4,-6,7,1,-1,0,1,1,1,-1,1,6,1
KR_6650488910,420,1,12,-13,5,3,4,1,2,5,3,1,2,1,1,1,0,-2,0,2,0,1,2,0,2,2,0,0,1,1,1,1,-1,1,1
KR_6740021323,420,2,108,-1,5,2,2,0,-1,6,7,-1,2,3,2,2,0,3,3,0,0,5,9,4,0,4,-2,0,2,1,-1,1,1,4,1
KR_6756816044,420,1,98,-27,7,1,3,2,0,4,4,-1,1,2,7,7,0,0,2,2,1,11,4,1,3,4,2,0,1,1,-1,1,1,2,1
KR_6701535827,440,7,145,39,25,2,3,1,10,10,0,-1,5,6,10,12,2,4,5,1,0,21,28,1,2,3,0,1,5,1,0,1,1,4,1
KR_6616532784,420,2,-26,-4,8,2,4,2,1,3,2,-1,1,2,6,6,0,0,1,1,0,10,2,-2,6,4,0,0,-2,-1,-1,-1,1,3,1
KR_6702379661,420,0,-8,-48,4,2,2,0,-1,1,2,-1,0,1,1,5,4,3,5,2,0,12,-54,-1,7,6,31,0,0,0,1,-1,1,0,1
KR_6762750920,420,4,114,17,8,0,1,1,-3,2,5,1,2,1,8,9,1,2,2,0,0,9,11,2,3,5,0,0,2,1,-1,1,-1,4,1
KR_6746200099,420,5,61,34,14,0,0,0,2,3,1,9,9,0,2,2,0,1,1,0,0,9,-23,6,2,8,23,0,2,1,1,1,1,5,1
KR_6768351002,420,1,51,20,1,1,3,2,-1,1,2,-3,1,4,1,4,3,3,3,0,0,-2,5,-2,4,2,3,0,0,1,-1,0,-1,2,1
KR_6720717260,440,-4,-11,-32,-6,2,4,2,-7,0,7,-2,0,2,2,5,3,-1,3,4,2,-7,-12,-3,6,3,0,0,0,-1,-1,0,1,3,1
KR_6761816612,440,-2,-9,-11,-6,-7,3,10,-1,2,3,2,4,2,-1,4,5,1,1,0,1,-6,3,-6,11,5,4,0,-1,-1,-1,-1,-1,3,1
KR_6647681484,420,0,44,21,-4,-6,0,6,2,3,1,-4,1,5,2,3,1,2,3,1,0,2,-6,-4,9,5,1,0,-1,1,-1,1,1,5,1
KR_6606634131,420,9,78,30,12,-2,1,3,3,4,1,3,5,2,7,7,0,1,2,1,0,15,-247,-2,3,1,-2,0,1,-1,0,-1,-1,5,1
KR_6758676453,420,3,33,-12,9,4,5,1,4,7,3,1,2,1,2,3,1,-2,1,3,0,-3,-116,5,1,6,20,0,0,1,1,1,1,4,1
KR_6763918859,420,0,11,4,-2,-2,1,3,-4,4,8,1,1,0,1,3,2,2,3,1,0,2,115,0,2,2,-1,0,-1,1,1,-1,-1,6,1
KR_6705333129,440,2,-25,-14,11,-2,2,4,1,3,2,-1,3,4,9,9,0,4,4,0,2,14,-7,3,3,6,1,0,1,1,1,1,1,6,1
KR_6734739112,420,1,33,3,2,2,3,1,-4,1,5,-3,0,3,5,5,0,2,3,1,0,2,2,-1,5,4,-3,0,1,-1,-1,1,1,1,1
KR_6356040803,420,4,107,-16,4,-4,2,6,-1,2,3,2,2,0,8,9,1,-1,0,1,0,9,0,0,0,0,-5,0,-1,1,-1,-1,1,5,1
KR_6652703449,420,7,125,101,1,0,0,0,0,0,0,-2,0,2,2,4,2,1,1,0,0,2,11,3,0,3,-4,1,6,-1,1,1,1,2,1
KR_6765904202,420,1,-12,4,5,1,1,0,0,1,1,2,5,3,2,3,1,0,0,0,0,4,-11,-5,7,2,6,0,0,1,1,1,1,4,1
KR_6711349219,420,-3,13,4,-4,1,2,1,1,6,5,-4,2,6,-1,0,1,-1,1,2,0,-3,13,5,2,7,-1,0,0,-1,1,0,-1,6,1
KR_6694730517,420,5,24,16,10,4,4,0,4,7,3,0,3,3,2,3,1,0,0,0,0,9,-22,2,1,3,-2,0,2,1,1,1,1,5,1
KR_6702881607,420,2,-4,-3,0,3,5,2,5,7,2,-4,1,5,-4,0,4,0,1,1,-2,-6,-1,-1,5,4,4,0,0,1,0,0,-1,2,1
KR_6689104730,420,-2,-25,-40,-2,-5,1,6,3,5,2,0,1,1,-1,2,3,1,2,1,2,6,112,-2,5,3,-3,0,-1,1,-1,-1,1,3,1
KR_6756091364,440,5,70,42,12,5,5,0,5,5,0,0,0,0,3,4,1,-1,0,1,0,5,35,1,2,3,4,0,1,0,-1,1,-1,0,1
KR_6756599571,440,4,110,44,-4,1,1,0,0,4,4,-5,2,7,-2,4,6,2,2,0,0,-2,-3,2,1,3,-1,0,1,-1,1,1,1,4,1
KR_6765657961,420,0,-16,-1,-4,2,3,1,1,1,0,-4,1,5,3,4,1,-6,1,7,0,-1,-1,-1,3,2,-1,0,0,-1,1,1,1,3,1
KR_6765827905,440,1,-49,-16,4,-1,1,2,6,7,1,-1,2,3,0,0,0,0,0,0,0,14,3,4,2,6,4,0,0,1,1,0,1,3,1
KR_6762427057,420,2,18,-3,6,5,6,1,-2,2,4,3,3,0,4,7,3,-4,1,5,0,9,2,3,3,6,1,0,0,0,1,1,-1,0,1
KR_6753371618,420,4,64,9,12,6,7,1,6,6,0,0,3,3,1,3,2,-1,1,2,0,14,6,1,3,4,-1,0,0,1,-1,0,1,6,1
KR_6736672098,420,2,-5,22,-2,4,6,2,0,4,4,0,3,3,-4,1,5,-2,0,2,0,-2,-9,2,1,3,-2,0,1,1,1,-1,-1,4,1
KR_6743669748,420,-1,-6,-12,3,3,4,1,5,7,2,-1,2,3,0,1,1,-4,0,4,0,6,-6,5,1,6,3,0,0,-1,1,0,1,5,1
KR_6731711714,420,5,88,-10,1,6,7,1,-2,0,2,-1,1,2,0,2,2,-2,0,2,0,-7,0,0,4,4,0,0,1,-1,-1,1,1,6,1
KR_6710571136,420,0,8,-8,-3,3,3,0,-9,0,9,3,4,1,0,2,2,0,0,0,0,-3,-238,2,2,4,4,0,-1,1,-1,-1,1,5,1
KR_6680016039,420,1,-43,-41,6,-1,1,2,3,6,3,1,2,1,1,2,1,2,2,0,0,9,6,1,4,5,-1,0,-1,1,0,-1,-1,4,1
KR_6602978434,420,1,40,-5,3,-3,2,5,2,4,2,1,2,1,1,6,5,2,3,1,0,5,7,0,5,5,-6,0,0,1,-1,0,1,4,1
KR_6674977530,420,1,-11,8,-3,-1,2,3,-5,0,5,2,2,0,1,3,2,0,2,2,0,-8,-27,2,5,7,1,0,1,0,1,1,1,0,1
KR_6763136133,420,1,43,4,5,4,5,1,1,4,3,0,4,4,2,6,4,-2,1,3,1,-5,-230,3,2,5,0,0,1,1,1,1,1,6,1
KR_6764408582,420,-2,0,-22,-5,-2,0,2,0,2,2,-3,1,4,0,0,0,0,0,0,0,1,-239,7,2,9,-3,0,-1,-1,-1,-1,-1,6,1
KR_6764167175,420,7,30,16,11,8,9,1,0,4,4,1,2,1,1,3,2,1,2,1,1,-2,-72,-6,8,2,1,0,2,-1,1,1,1,2,1
KR_6647601349,420,-5,-36,4,-12,1,4,3,-5,0,5,-4,3,7,-2,1,3,-2,1,3,0,-14,1,0,2,2,1,0,0,-1,1,1,1,4,1
KR_6725142648,420,2,41,16,-2,2,3,1,0,1,1,3,6,3,-4,0,4,-3,3,6,0,-4,24,4,3,7,2,0,0,1,1,1,1,1,1
KR_6767355177,420,1,-60,6,8,-2,0,2,2,4,2,-3,2,5,6,7,1,5,5,0,0,19,30,0,0,0,-16,0,4,1,1,1,1,2,1
KR_6764193873,420,-2,-31,-40,5,2,2,0,4,6,2,-3,2,5,4,6,2,-2,0,2,0,8,97,-1,3,2,0,0,-1,0,-1,-1,1,0,1
KR_6644679987,420,5,70,14,13,8,8,0,0,1,1,1,6,5,3,5,2,1,2,1,0,0,2,0,5,5,4,0,3,0,1,1,1,0,1
KR_6651072825,420,-2,5,-20,-2,0,1,1,1,4,3,-5,2,7,2,3,1,0,0,0,0,6,1,-4,7,3,2,0,1,1,1,1,1,4,1
KR_6538158781,420,4,48,4,6,3,6,3,1,3,2,2,5,3,-1,2,3,1,1,0,0,3,45,3,2,5,-7,0,1,1,1,1,-1,3,1
KR_6662128907,420,3,53,66,3,2,4,2,3,5,2,1,1,0,-2,2,4,-1,0,1,0,-2,4,3,1,4,-4,0,1,1,1,1,1,1,1
KR_6758075942,440,5,78,-16,12,3,4,1,-3,1,4,2,4,2,8,11,3,2,3,1,0,9,-4,0,3,3,3,0,1,1,1,1,1,2,1
KR_6764062825,420,2,8,13,3,1,1,0,1,2,1,2,2,0,-1,2,3,0,1,1,0,3,-300,1,4,5,1,0,-1,-1,1,1,1,3,1
KR_6738691655,440,-1,75,-24,-4,3,5,2,-2,1,3,-6,0,6,3,4,1,-2,0,2,0,3,4,1,3,4,-1,0,0,1,1,1,-1,6,1
KR_6730673493,420,3,73,15,7,2,3,1,3,4,1,-1,2,3,3,3,0,0,0,0,0,7,-5,1,4,5,5,0,0,1,-1,-1,1,4,1
KR_6631057756,420,0,23,36,-5,-2,0,2,-2,1,3,-1,3,4,0,0,0,0,0,0,0,-8,6,1,5,6,-3,0,-1,1,0,-1,-1,1,1
KR_6726203585,420,-3,-29,-12,-6,1,1,0,-4,1,5,3,4,1,-6,2,8,0,1,1,-1,-10,-60,-6,7,1,2,0,0,-1,1,1,-1,6,1
KR_6722415335,420,0,0,18,-2,4,6,2,-7,1,8,0,0,0,1,4,3,0,2,2,0,-4,-5,-3,5,2,4,0,-1,1,-1,-1,-1,2,1
KR_6759805520,420,-2,-39,-28,-2,-3,1,4,5,7,2,0,1,1,-5,5,10,1,1,0,0,3,14,0,5,5,3,0,0,1,-1,-1,-1,3,1
KR_6709270707,420,4,17,31,0,-2,2,4,-2,1,3,3,4,1,3,4,1,-2,1,3,-2,-11,16,-1,3,2,0,0,0,1,-1,-1,-1,6,1
KR_6739797496,420,4,18,28,8,1,1,0,0,1,1,-2,0,2,6,6,0,3,3,0,0,7,-15,4,3,7,4,0,1,1,-1,1,1,4,1
KR_6699749691,420,2,85,-4,4,-3,3,6,0,1,1,5,5,0,1,4,3,1,1,0,1,12,-1,3,1,4,1,0,2,1,1,1,1,6,1
KR_6766886449,420,4,86,12,11,1,2,1,6,8,2,0,3,3,2,5,3,2,3,1,-1,15,-10,-3,7,4,7,0,0,1,0,0,-1,6,1
KR_6643141253,420,0,-1,14,0,6,6,0,0,1,1,0,1,1,-6,2,8,0,1,1,1,-1,-9,6,0,6,2,0,1,1,1,1,1,3,1
KR_6764870030,420,2,38,8,4,-2,3,5,2,2,0,1,4,3,3,5,2,0,0,0,0,1,4,1,2,3,-4,0,1,1,0,1,-1,5,1
KR_6482602210,420,-3,-12,-5,-3,-1,0,1,-2,3,5,-4,2,6,2,3,1,2,3,1,0,-2,-50,-3,6,3,1,0,0,0,-1,-1,-1,0,1
KR_6705766381,420,-2,-35,19,2,0,4,4,0,4,4,3,4,1,-4,4,8,3,5,2,-1,-1,-24,0,3,3,2,0,0,1,1,1,-1,6,1
KR_6734368071,440,-1,-47,-18,-3,4,4,0,-1,0,1,3,4,1,-10,2,12,1,1,0,0,-12,15,0,5,5,-5,0,0,-1,-1,-1,-1,6,1
KR_6672635756,440,5,116,5,1,-1,2,3,-2,4,6,6,7,1,-1,2,3,-1,0,1,0,6,1,1,1,2,2,0,1,-1,0,1,-1,4,1
KR_6757456602,420,-2,-26,-12,-1,-1,2,3,-4,2,6,-2,2,4,4,5,1,2,3,1,1,3,1,-4,6,2,2,0,0,1,0,1,1,6,1
KR_6760417196,420,1,35,-8,-1,1,3,2,-1,0,1,2,3,1,-2,0,2,-1,0,1,0,-10,-3,3,3,6,-1,0,0,-1,0,0,-1,2,1
KR_6673773170,420,3,-49,46,1,0,1,1,3,3,0,2,3,1,-4,0,4,0,1,1,0,2,20,3,4,7,-2,0,0,1,0,0,1,1,1
KR_6752749995,420,0,36,4,1,3,3,0,-1,3,4,-3,0,3,1,5,4,1,3,2,0,-3,14,-3,4,1,5,0,-1,1,0,-1,1,2,1
KR_6762751389,420,-1,14,-25,1,3,4,1,4,7,3,-9,0,9,-1,1,2,4,4,0,1,6,-35,-6,9,3,10,0,-1,0,1,-1,1,0,1
KR_6751805926,420,1,-20,-12,2,-2,0,2,0,1,1,-1,2,3,3,3,0,2,2,0,0,6,6,-2,7,5,3,0,0,-1,-1,-1,-1,2,1
KR_6720746730,440,2,-18,3,12,4,6,2,0,1,1,4,4,0,1,1,0,3,4,1,2,22,-4,3,1,4,1,0,1,1,1,1,1,1,1
KR_6767217210,440,6,-9,39,3,3,4,1,-1,2,3,0,4,4,3,4,1,-2,0,2,0,9,95,-3,8,5,-4,0,2,1,1,1,-1,3,1
KR_6765286623,420,-3,60,-10,1,-1,2,3,0,3,3,-4,0,4,4,4,0,2,2,0,0,4,-5,-6,7,1,1,0,0,-1,1,1,-1,6,1
KR_6750969449,440,0,5,56,1,4,5,1,1,2,1,-3,1,4,0,5,5,-1,0,1,1,2,6,4,4,8,-6,0,1,1,1,1,-1,6,1
KR_6760645587,420,3,20,-12,3,0,2,2,5,5,0,-3,0,3,1,2,1,0,0,0,-1,3,-21,3,2,5,-4,0,1,1,-1,1,-1,4,1
KR_6735945431,420,1,-26,28,-3,-1,0,1,-1,1,2,-3,1,4,6,7,1,-4,0,4,0,-2,16,-1,4,3,-6,0,0,1,-1,0,1,6,1
KR_6618089365,420,-1,-1,16,-1,3,4,1,-1,4,5,-1,1,2,-1,2,3,-1,2,3,0,-6,409,-3,6,3,2,0,0,-1,1,1,1,4,1
KR_6744336414,420,1,78,6,8,3,3,0,2,4,2,-2,0,2,6,6,0,-1,0,1,0,11,0,-1,4,3,-1,0,2,1,-1,1,1,3,1
KR_6712783348,420,1,7,5,1,-3,1,4,0,4,4,-3,1,4,3,3,0,4,7,3,-1,-1,-11,-3,8,5,3,0,2,-1,1,1,-1,3,1
KR_6747549899,440,-1,22,-36,-3,3,3,0,-2,2,4,0,2,2,-5,1,6,1,1,0,0,-3,-11,2,2,4,-2,0,0,1,1,0,1,1,1
KR_6584554347,420,-1,46,13,-5,-1,2,3,0,2,2,-2,0,2,-1,2,3,-1,0,1,0,-2,5,3,4,7,-5,0,1,1,1,1,1,1,1
KR_6521173481,420,1,34,19,-3,-3,0,3,-3,2,5,-1,2,3,4,5,1,0,2,2,0,0,-19,3,6,9,1,0,0,1,-1,1,1,4,1
KR_6744911492,420,-5,-35,-8,-11,0,1,1,-3,2,5,-5,1,6,-1,3,4,-2,1,3,-1,-6,9,3,6,9,-4,0,0,-1,1,0,-1,4,1
KR_6741022726,420,2,49,20,-1,2,2,0,-7,1,8,2,3,1,4,5,1,-2,1,3,0,-8,23,2,1,3,0,0,2,0,1,1,1,0,1
KR_6757685324,420,0,61,21,5,8,9,1,3,5,2,-6,0,6,2,4,2,-2,1,3,0,-3,-2,-1,4,3,1,0,3,-1,1,1,1,2,1
KR_6628590550,420,6,22,57,9,2,3,1,3,3,0,5,5,0,2,3,1,-3,1,4,0,3,-110,-1,2,1,0,0,2,1,1,1,1,3,1
KR_6656829146,420,1,0,-32,1,-2,0,2,4,8,4,2,3,1,-3,1,4,0,3,3,0,0,118,3,2,5,-1,0,0,-1,1,0,1,4,1
KR_6635277378,420,0,23,4,6,0,1,1,6,8,2,-3,1,4,1,2,1,2,3,1,0,9,7,-5,6,1,4,0,2,1,1,1,-1,3,1
KR_6756351564,420,3,32,-18,7,5,5,0,0,2,2,0,4,4,4,5,1,-2,1,3,1,6,4,0,3,3,-1,0,0,-1,0,0,1,1,1
KR_6639528361,420,4,34,36,5,3,4,1,0,2,2,1,7,6,1,2,1,0,1,1,0,0,1,4,4,8,3,0,1,-1,1,1,-1,2,1
KR_6748614711,420,0,12,-25,-6,-8,0,8,-1,2,3,0,3,3,4,6,2,-1,3,4,0,-1,66,-2,7,5,5,0,-1,-1,0,-1,1,3,1
KR_6458883125,420,-3,49,-16,-4,0,1,1,-8,0,8,0,2,2,2,2,0,2,2,0,0,-5,23,3,3,6,-1,0,1,-1,-1,1,-1,4,1
KR_6759704519,420,0,80,1,-1,1,2,1,-4,0,4,3,3,0,0,2,2,-1,3,4,0,-2,-54,0,1,1,1,0,0,0,0,0,1,0,1
KR_6759091585,420,-2,-19,28,-2,0,5,5,-1,2,3,3,4,1,-6,2,8,2,3,1,-2,-7,5,-5,9,4,3,0,-1,1,1,-1,-1,4,1
KR_6446427320,420,0,18,17,-2,-1,1,2,2,3,1,0,2,2,-2,0,2,-1,0,1,0,-7,-49,-4,8,4,0,0,1,1,-1,1,-1,3,1
KR_6765768036,420,3,22,31,-2,0,1,1,1,2,1,2,3,1,-3,3,6,-2,0,2,0,-13,-1,-1,7,6,1,0,0,1,0,0,-1,3,1
KR_6681784018,420,2,20,20,0,2,3,1,1,6,5,-2,1,3,0,2,2,-1,1,2,0,2,-22,1,4,5,3,0,0,-1,1,1,-1,2,1
KR_6759761817,440,0,74,5,3,-1,1,2,-1,4,5,-1,0,1,4,5,1,2,4,2,0,-2,2,-1,6,5,-4,0,1,1,1,1,1,1,1
KR_6747899474,420,1,7,8,6,3,4,1,0,4,4,3,3,0,0,1,1,0,1,1,0,1,-27,-3,6,3,0,0,0,-1,-1,0,-1,1,1
KR_6758761324,420,1,-6,-11,4,0,3,3,-1,3,4,2,6,4,0,2,2,3,3,0,0,-1,9,3,0,3,1,0,0,0,0,0,1,0,1
KR_6617444965,420,4,-28,36,9,1,1,0,1,2,1,2,4,2,4,5,1,1,3,2,0,6,-7,0,2,2,0,0,1,1,1,1,-1,4,1
KR_6744829412,420,-1,-69,32,-2,-2,1,3,1,5,4,0,0,0,0,4,4,-1,1,2,0,-2,25,1,1,2,0,0,-1,-1,-1,-1,1,4,1
KR_6762095884,420,0,-23,8,-1,3,5,2,-1,1,2,-2,0,2,-2,2,4,1,2,1,0,-2,-13,-3,5,2,3,0,1,-1,1,1,1,2,1
KR_6752830651,440,2,14,-20,15,5,5,0,1,4,3,4,5,1,9,9,0,-4,0,4,2,18,0,-1,2,1,1,0,1,1,1,1,1,2,1
KR_6547584473,420,1,41,4,7,-2,0,2,3,4,1,2,5,3,5,6,1,-1,1,2,0,11,-48,2,4,6,24,0,2,-1,1,1,1,6,1
KR_6768368278,420,1,53,-12,-5,-2,2,4,-4,2,6,-1,1,2,1,3,2,1,2,1,0,-6,-17,-1,5,4,2,0,0,-1,1,0,1,2,1
KR_6758782397,420,-1,-90,-11,6,2,3,1,3,3,0,8,10,2,-3,2,5,-4,0,4,0,-2,-11,-1,5,4,2,0,-1,-1,1,1,1,2,1
KR_6570067937,420,1,-15,-6,4,1,1,0,-1,1,2,0,2,2,3,4,1,1,1,0,0,2,-35,-3,8,5,6,0,1,-1,1,1,1,1,1
KR_6742297065,420,-5,-109,-40,-4,-5,3,8,0,1,1,6,6,0,-4,0,4,-1,1,2,0,-3,-2,-1,2,1,-4,0,-1,-1,-1,-1,-1,4,1
KR_6766950613,420,3,49,8,10,1,3,2,3,7,4,3,3,0,1,3,2,2,3,1,1,17,273,-1,3,2,-4,0,1,1,1,1,1,5,1
KR_6763007481,420,3,81,6,7,-1,1,2,2,6,4,2,4,2,3,4,1,1,2,1,1,10,111,3,1,4,5,0,1,1,1,1,1,2,1
KR_6765180138,420,0,49,-24,3,0,2,2,3,4,1,0,3,3,0,1,1,0,1,1,0,3,-8,-1,6,5,3,0,-1,0,-1,-1,1,0,1
KR_6766082481,420,2,20,9,1,0,2,2,-7,1,8,5,6,1,0,2,2,3,3,0,0,-1,-82,-2,3,1,2,0,1,0,0,1,1,0,1
KR_6747288539,420,8,78,19,18,6,8,2,-1,2,3,2,3,1,8,8,0,3,3,0,5,20,3,3,0,3,1,0,2,1,1,1,1,1,1
KR_6763177594,440,1,31,2,3,4,4,0,1,3,2,0,6,6,-2,0,2,0,1,1,0,0,-4,-1,5,4,5,0,3,1,1,1,-1,3,1
KR_6756866876,420,1,-10,-4,5,-2,1,3,1,2,1,4,6,2,2,2,0,0,2,2,0,10,14,4,3,7,-1,0,1,-1,1,1,-1,3,1
KR_6768275896,420,3,24,20,1,-2,0,2,-1,2,3,4,4,0,-1,1,2,1,1,0,0,4,-7,-5,7,2,0,0,0,1,1,0,1,3,1
KR_6645514646,420,-1,-2,30,1,4,4,0,1,5,4,-1,1,2,-5,1,6,2,3,1,0,1,-121,-1,6,5,-1,0,0,0,0,0,1,0,1
KR_6764053621,420,2,57,-16,4,1,3,2,-6,1,7,1,1,0,5,5,0,3,3,0,0,1,4,3,1,4,1,0,2,-1,-1,1,-1,1,1
KR_6765928872,420,0,17,-4,5,2,3,1,6,6,0,1,3,2,-4,1,5,0,4,4,0,3,-25,-2,4,2,-3,0,-1,0,-1,-1,-1,0,1
KR_6752357857,440,4,59,19,4,2,3,1,-2,1,3,-1,0,1,2,3,1,3,4,1,0,3,-8,-2,7,5,4,0,2,-1,-1,1,1,1,1
KR_6723018499,440,1,121,12,7,2,5,3,-4,5,9,5,5,0,2,3,1,2,2,0,0,14,-20,-3,4,1,2,0,1,1,0,1,1,4,1
KR_6736880935,440,4,45,20,5,-4,1,5,2,3,1,-4,0,4,10,10,0,1,1,0,1,10,-4,-2,5,3,-1,0,2,1,1,1,1,4,1
KR_6760559711,440,-1,-43,-8,1,6,6,0,-5,0,5,0,1,1,0,1,1,0,0,0,0,-6,18,5,3,8,-1,0,-1,0,-1,-1,1,0,1
KR_6744945774,420,3,16,8,5,5,5,0,3,3,0,0,0,0,-4,2,6,1,1,0,0,0,4,3,3,6,-4,0,0,1,-1,1,1,2,1
KR_6671318521,420,-1,-30,-12,0,-1,0,1,3,3,0,2,2,0,-3,6,9,-1,2,3,-1,7,-181,0,4,4,-2,0,-1,-1,1,-1,-1,2,1
KR_6729760257,420,1,10,37,-1,0,2,2,-3,1,4,2,4,2,0,1,1,0,1,1,0,-6,30,0,5,5,-3,0,1,-1,1,1,-1,5,1
KR_6762264140,420,0,4,8,-3,2,4,2,-6,1,7,0,2,2,0,0,0,1,1,0,1,-2,14,-4,7,3,1,0,0,-1,1,1,1,3,1
KR_6746761169,420,2,-21,12,-3,-1,2,3,3,5,2,-3,1,4,-3,2,5,1,1,0,0,-2,1,4,5,9,-4,0,0,-1,1,-1,-1,2,1
KR_6669316655,420,-1,52,-37,-7,-5,1,6,-1,2,3,1,1,0,-3,4,7,1,2,1,0,1,-18,-1,6,5,1,0,2,-1,1,1,1,4,1
KR_6752595259,420,2,-7,-18,3,3,3,0,1,1,0,0,2,2,-1,3,4,0,0,0,0,2,-9,-3,4,1,0,0,0,-1,1,1,-1,3,1
KR_6756282095,420,0,-49,-4,-1,1,3,2,-2,0,2,0,2,2,-3,0,3,3,3,0,0,-8,2,-3,9,6,1,0,0,-1,1,0,-1,4,1
KR_6750488279,440,1,42,41,-5,0,1,1,0,1,1,1,3,2,-8,1,9,2,2,0,0,-15,-5,0,6,6,0,0,0,-1,-1,0,1,6,1
KR_6688522457,420,2,43,-12,9,2,4,2,3,4,1,-2,3,5,1,6,5,5,6,1,0,8,-8,-3,6,3,2,0,0,-1,0,0,1,3,1
KR_6638209122,440,-4,-24,-23,-8,-2,1,3,-3,1,4,-2,1,3,0,1,1,-1,2,3,0,-10,37,-1,3,2,-23,0,0,-1,-1,0,-1,1,1
KR_6717398842,440,2,20,14,3,1,3,2,2,2,0,1,1,0,1,2,1,-2,0,2,0,6,0,1,2,3,-2,0,1,1,-1,1,-1,1,1
KR_6682357507,440,4,68,9,2,-4,3,7,-2,4,6,4,4,0,2,3,1,2,3,1,0,-5,18,-2,6,4,0,0,1,-1,1,1,-1,2,1
KR_6747433169,440,2,-6,0,2,-1,0,1,2,6,4,1,4,3,0,2,2,0,1,1,0,8,4,0,4,4,-1,0,1,1,0,1,-1,4,1
KR_6627550353,420,3,32,-32,10,7,7,0,2,3,1,-1,2,3,1,5,4,1,4,3,0,11,4,4,4,8,3,0,0,1,-1,1,-1,5,1
KR_6723690364,420,0,-10,27,1,-5,2,7,2,2,0,1,3,2,1,3,2,2,3,1,0,0,-6,-5,8,3,4,0,-1,1,1,-1,1,4,1
KR_6724022480,420,1,37,8,-5,-4,1,5,-1,1,2,0,1,1,-1,2,3,1,1,0,0,-1,6,-1,4,3,0,0,1,-1,1,1,-1,4,1
KR_6742414301,420,2,-22,11,8,4,4,0,2,5,3,1,3,2,1,3,2,0,2,2,0,5,-9,-3,7,4,4,0,0,0,-1,1,1,0,1
KR_6724870100,440,0,-12,-4,-2,0,1,1,2,3,1,4,6,2,-7,1,8,-1,0,1,0,-5,46,0,3,3,1,0,-1,1,1,-1,-1,5,1
KR_6762224253,420,2,82,24,3,-3,2,5,1,2,1,6,10,4,-3,1,4,2,3,1,0,-3,6,2,1,3,-2,0,2,-1,-1,1,1,4,1
KR_6663845908,420,3,19,-16,4,-3,1,4,-1,4,5,4,4,0,4,6,2,0,1,1,2,6,-1,2,4,6,0,0,1,-1,-1,1,1,1,1
KR_6757680126,420,0,68,-10,-9,0,1,1,-6,0,6,0,4,4,-3,1,4,0,1,1,-2,-3,41,-1,6,5,-15,0,2,1,1,1,-1,4,1
KR_6764685088,420,4,20,-8,7,2,3,1,-1,1,2,0,1,1,6,6,0,0,0,0,0,6,7,-1,3,2,0,0,1,1,0,1,1,5,1
KR_6763282002,420,2,74,-11,3,5,6,1,0,1,1,-1,1,2,3,3,0,-4,0,4,0,-1,41,0,5,5,-17,0,1,1,-1,1,-1,4,1
KR_6671322449,420,0,-21,20,9,2,5,3,1,5,4,5,7,2,-1,1,2,2,3,1,2,9,237,-4,5,1,5,0,-1,1,-1,-1,1,5,1
KR_6700637588,420,7,58,-19,20,4,4,0,1,3,2,10,10,0,3,6,3,2,3,1,0,20,-15,-3,5,2,2,0,2,1,1,1,1,3,1
KR_6757241771,420,2,41,-8,6,1,2,1,2,2,0,-4,0,4,5,5,0,2,2,0,0,10,10,4,3,7,-2,0,0,1,1,0,1,4,1
KR_6760081676,420,-2,-17,24,-2,3,3,0,-2,1,3,-3,0,3,-1,1,2,1,1,0,0,-1,150,2,2,4,-1,0,3,1,1,1,-1,5,1
KR_6727220304,420,-4,-69,-24,-13,0,2,2,-1,5,6,-1,3,4,-2,2,4,-9,0,9,-2,-16,15,0,3,3,-2,0,0,-1,1,-1,-1,6,1
KR_6346008802,420,7,-15,29,13,-1,1,2,1,1,0,8,10,2,4,6,2,1,1,0,0,18,91,-3,7,4,1,0,1,1,1,1,1,6,1
KR_6765469619,420,-2,-129,-21,6,2,2,0,1,1,0,1,4,3,2,3,1,0,0,0,0,12,-4,-3,6,3,5,0,-2,0,-1,-1,-1,0,1
KR_6723241370,420,1,35,4,3,0,1,1,1,4,3,-2,2,4,3,4,1,1,1,0,0,4,-2,1,4,5,1,0,-1,1,-1,-1,1,2,1
KR_6767318467,420,-1,12,28,-4,-2,1,3,-2,2,4,-1,1,2,1,2,1,0,0,0,0,-5,226,-4,7,3,-12,0,-1,1,-1,-1,-1,3,1
KR_6691788113,420,1,15,45,1,2,4,2,-1,1,2,2,2,0,-1,2,3,-1,0,1,0,-2,2,1,4,5,1,0,1,1,1,1,1,2,1
KR_6763868867,420,-3,-24,-17,-2,4,5,1,-2,0,2,-2,2,4,0,2,2,-2,0,2,0,-7,10,1,3,4,-5,0,0,0,0,0,1,0,1
KR_6758019468,420,1,81,32,7,2,3,1,-1,2,3,3,5,2,2,2,0,1,1,0,1,8,4,1,2,3,3,0,0,0,0,0,1,0,1
KR_6704923293,420,3,30,-19,7,2,3,1,-3,1,4,2,3,1,4,4,0,2,2,0,0,12,-10,-2,8,6,0,0,-1,1,-1,-1,-1,6,1
KR_6742264519,420,1,-28,-3,1,-3,0,3,2,4,2,1,6,5,-1,5,6,2,4,2,-2,4,16,5,3,8,-3,0,-1,-1,1,-1,-1,6,1
KR_6688827042,420,1,77,-11,8,2,2,0,1,1,0,4,9,5,-1,4,5,2,4,2,1,9,-26,1,4,5,1,0,0,1,-1,1,1,2,1
KR_6716154159,420,0,46,8,1,3,5,2,-1,1,2,-7,0,7,5,5,0,1,3,2,0,4,-1,-6,6,0,4,0,1,0,1,1,1,0,1
KR_6672099378,420,8,67,107,16,-1,0,1,8,10,2,5,7,2,1,2,1,3,4,1,0,9,10,0,0,0,-1,0,4,1,1,1,1,5,1
KR_6755558209,420,3,60,24,13,4,4,0,-1,1,2,5,7,2,6,10,4,-1,0,1,0,10,22,1,5,6,7,0,2,1,-1,1,1,6,1
KR_6756893946,420,4,102,25,4,0,0,0,3,3,0,0,1,1,3,4,1,-2,1,3,0,3,6,4,6,10,-5,0,0,-1,1,1,-1,2,1
KR_6666751128,420,0,-17,28,-6,1,4,3,2,3,1,1,3,2,-11,2,13,1,1,0,0,-13,195,3,3,6,-4,0,0,1,1,-1,-1,4,1
KR_6722780494,420,0,17,1,0,2,3,1,2,4,2,-2,2,4,-2,0,2,0,0,0,0,1,-18,-3,8,5,7,0,0,1,-1,0,1,3,1
KR_6756554154,420,2,57,19,8,8,9,1,-2,4,6,-2,0,2,1,2,1,3,5,2,0,2,4,-1,4,3,-1,0,1,1,0,1,1,5,1
KR_6761616405,420,6,28,18,7,1,3,2,2,4,2,2,5,3,1,3,2,1,1,0,0,6,-1,2,3,5,1,0,1,1,-1,1,-1,4,1
KR_6742135720,440,0,-3,19,2,-1,1,2,1,1,0,2,4,2,1,2,1,-1,1,2,-1,-4,-1,-2,5,3,2,0,0,0,0,0,-1,0,1
KR_6662691429,420,4,78,-5,8,-1,0,1,0,2,2,3,5,2,4,5,1,2,2,0,0,12,-18,1,5,6,-1,0,0,-1,-1,1,-1,5,1
KR_6683019636,440,1,16,1,-1,3,4,1,1,4,3,0,1,1,-6,0,6,1,1,0,0,-1,-1,-2,3,1,2,0,1,0,0,1,1,0,1
KR_6741130124,420,1,-84,25,0,-1,3,4,0,2,2,2,4,2,-1,2,3,0,1,1,0,5,-229,-1,3,2,-1,0,-2,1,-1,-1,-1,4,1
KR_6710878822,420,2,88,12,6,0,3,3,0,2,2,0,1,1,4,6,2,2,2,0,1,10,1,0,3,3,1,0,1,1,1,1,1,6,1
KR_6758963489,420,2,22,30,-1,2,3,1,1,3,2,-1,3,4,0,1,1,-3,1,4,0,-8,-18,-3,4,1,-7,0,0,-1,1,1,-1,6,1
KR_6289262150,440,-2,-47,-23,-3,1,2,1,0,4,4,-1,4,5,0,3,3,-3,1,4,-1,-5,-28,1,2,3,2,0,1,-1,1,1,-1,6,1
KR_6643775422,420,3,29,7,3,-7,0,7,5,5,0,-1,0,1,4,5,1,2,5,3,-1,5,-10,-1,3,2,5,0,0,-1,0,1,-1,4,1
KR_6730419697,440,1,51,-20,13,3,7,4,3,3,0,0,2,2,4,4,0,3,3,0,1,17,0,0,2,2,-3,0,1,1,-1,1,1,6,1
KR_6741656423,420,1,25,-12,6,-1,1,2,2,4,2,1,1,0,3,4,1,1,1,0,0,7,-47,2,4,6,22,0,1,-1,1,1,-1,2,1
KR_6707154956,420,1,67,-20,5,3,5,2,-1,0,1,2,3,1,1,1,0,0,2,2,1,7,17,3,4,7,-1,0,1,1,-1,1,1,1,1
KR_6713881484,420,-1,-16,0,0,-1,1,2,1,3,2,3,5,2,-2,0,2,-1,0,1,0,-2,1,5,3,8,-6,0,0,1,1,0,1,6,1
KR_6401507195,440,3,107,34,2,-2,3,5,1,3,2,2,5,3,1,5,4,0,1,1,0,-8,0,-1,4,3,7,0,1,1,1,1,1,1,1
KR_6767685450,440,0,-1,-4,2,-5,0,5,1,8,7,-1,0,1,5,8,3,2,4,2,2,15,24,0,4,4,-2,0,0,-1,1,1,1,5,1
KR_6674512327,440,3,52,1,5,-2,0,2,0,0,0,4,7,3,2,3,1,1,2,1,0,7,-9,-2,7,5,6,0,1,1,-1,1,1,3,1
KR_6494616858,420,6,74,20,11,-1,2,3,7,8,1,3,5,2,5,5,0,-3,1,4,0,8,-21,2,4,6,4,0,1,1,1,1,-1,3,1
KR_6764335767,420,-3,-55,5,-7,-1,0,1,-1,3,4,-4,0,4,0,5,5,-1,1,2,0,-4,-22,-2,5,3,5,0,-1,1,-1,-1,-1,5,1
KR_6760327066,420,3,6,20,7,-1,1,2,-1,0,1,1,4,3,2,2,0,6,7,1,0,5,10,0,4,4,2,0,0,1,1,0,1,1,1
KR_6635663810,420,1,48,-16,-1,-1,1,2,-2,2,4,1,1,0,-1,1,2,2,5,3,-2,-6,-8,-1,8,7,2,0,0,1,1,0,-1,5,1
KR_6746638326,420,-5,-53,11,-16,-10,0,10,0,2,2,1,6,5,-7,0,7,0,1,1,0,-21,-10,-8,9,1,0,0,-1,-1,-1,-1,-1,6,1
KR_6762222442,420,1,79,-8,3,1,2,1,3,3,0,2,3,1,-1,1,2,-2,0,2,0,-6,-11,-1,5,4,4,0,-1,-1,1,-1,-1,1,1
KR_6733167795,440,3,38,0,0,-4,2,6,0,1,1,2,3,1,4,5,1,-2,2,4,0,2,-15,0,1,1,1,0,3,1,1,1,-1,6,1
KR_6607867681,420,1,11,-12,2,-2,2,4,-2,1,3,2,2,0,0,0,0,4,4,0,0,1,11,8,1,9,-2,0,1,1,1,1,-1,5,1
KR_6761678465,420,-1,-44,18,0,-1,1,2,2,5,3,3,4,1,-6,0,6,2,2,0,0,5,-31,4,3,7,11,0,-1,1,1,-1,1,5,1
KR_6767275389,440,2,84,-9,6,1,2,1,1,1,0,-2,4,6,3,4,1,3,3,0,0,15,7,5,0,5,3,0,1,-1,1,1,1,5,1
KR_6698702184,440,7,37,28,14,8,9,1,1,2,1,1,3,2,3,4,1,1,3,2,-1,16,-237,2,5,7,2,0,3,0,1,1,-1,0,1
KR_6764101637,420,-1,-12,17,-2,-2,2,4,3,5,2,0,3,3,-3,2,5,0,1,1,2,6,31,1,5,6,-5,0,0,-1,1,-1,1,3,1
KR_6657796837,420,-2,27,12,0,-1,3,4,-1,2,3,1,1,0,0,0,0,1,1,0,0,0,1,1,3,4,-1,0,0,1,1,-1,1,4,1
KR_6592137239,420,1,30,30,-1,0,1,1,-2,1,3,0,2,2,2,5,3,-1,1,2,0,-2,0,3,1,4,2,0,0,1,-1,-1,1,2,1
KR_6663437639,420,2,-61,-12,4,-3,0,3,6,14,8,-1,0,1,1,2,1,1,2,1,0,7,3,3,2,5,2,0,2,-1,1,1,-1,1,1
KR_6723636141,420,0,-26,18,-2,1,2,1,-1,4,5,-2,3,5,-1,5,6,1,2,1,-2,-10,7,-5,6,1,5,0,0,1,-1,0,-1,3,1
KR_6711592594,420,-1,-65,-45,4,0,0,0,-4,1,5,2,4,2,6,6,0,0,1,1,0,4,1,-3,7,4,0,0,-1,0,1,-1,-1,0,1
KR_6676871026,420,1,15,-8,4,5,7,2,0,2,2,0,3,3,-3,1,4,2,2,0,0,2,1,-2,4,2,-1,0,2,1,1,1,-1,4,1
KR_6741677737,420,0,28,28,9,7,8,1,-1,1,2,-2,3,5,5,7,2,0,3,3,1,6,-10,-4,8,4,7,0,1,1,1,1,1,3,1
KR_6751745330,420,-2,-16,8,-4,-3,1,4,2,2,0,-1,2,3,1,4,3,-3,1,4,0,0,9,0,4,4,0,0,-1,0,-1,-1,-1,0,1
KR_6735623076,440,5,39,29,12,4,5,1,6,9,3,5,7,2,-3,3,6,0,0,0,1,15,4,-1,5,4,1,0,1,1,1,1,1,1,1
KR_6745987005,420,1,-29,4,0,-1,0,1,-1,5,6,4,5,1,-1,2,3,-1,1,2,0,3,-2,4,4,8,-1,0,0,0,-1,0,-1,0,1
KR_6734606898,440,2,95,0,5,-7,0,7,3,3,0,-1,1,2,7,7,0,3,6,3,1,5,24,3,0,3,-3,0,1,-1,1,1,1,3,1
KR_6662143070,420,3,38,20,2,3,4,1,-2,3,5,0,1,1,0,3,3,1,3,2,0,-1,2,0,4,4,5,0,1,-1,1,1,-1,2,1
KR_6710620211,420,6,76,24,11,0,2,2,3,6,3,8,9,1,0,2,2,0,1,1,-1,4,0,-2,4,2,1,0,1,-1,1,1,-1,4,1
KR_6627110620,420,2,1,-16,2,1,2,1,2,3,1,0,1,1,-4,3,7,3,4,1,0,5,-240,5,2,7,0,0,0,-1,1,0,-1,5,1
KR_6693201905,420,-3,-24,-24,3,2,3,1,-2,2,4,1,4,3,5,5,0,-3,3,6,0,10,-518,1,1,2,3,0,-1,-1,-1,-1,1,6,1
KR_6715088239,420,0,18,17,-1,-2,3,5,2,5,3,2,4,2,-2,0,2,-1,0,1,0,-6,-11,1,0,1,0,0,0,1,1,0,1,4,1
KR_6761203346,420,3,44,-16,5,4,4,0,0,3,3,-2,2,4,4,6,2,-1,0,1,0,7,-37,0,4,4,4,0,-1,1,-1,-1,-1,6,1
KR_6764996511,420,1,0,-4,-1,1,3,2,1,2,1,2,3,1,-3,2,5,-2,1,3,0,3,-2,1,3,4,-2,0,0,-1,1,0,-1,4,1
KR_6759877182,420,-2,9,0,1,1,2,1,-3,1,4,3,3,0,2,4,2,-2,0,2,0,1,22,6,3,9,-3,0,0,1,0,0,1,2,1
KR_6646091550,420,-2,-19,16,2,0,0,0,-1,1,2,1,2,1,1,1,0,1,1,0,0,2,8,3,5,8,1,0,0,-1,-1,0,1,5,1
KR_6694005767,420,1,-12,-32,1,0,1,1,4,4,0,2,4,2,-1,4,5,-4,0,4,0,-1,5,2,3,5,-5,0,0,-1,-1,0,-1,2,1
KR_6724851872,420,6,53,28,8,0,2,2,1,3,2,8,8,0,-3,0,3,2,5,3,0,1,-5,1,3,4,5,0,2,1,1,1,-1,1,1
KR_6712578303,420,-2,-59,14,-1,-2,1,3,3,4,1,-3,1,4,-2,1,3,3,4,1,0,0,2,0,5,5,-1,0,0,1,-1,-1,-1,3,1
KR_6754403976,420,4,55,24,3,-3,0,3,0,1,1,7,9,2,2,5,3,-3,0,3,-1,2,-1,4,3,7,0,0,-1,1,1,-1,-1,6,1
KR_6563151768,440,2,17,-25,12,4,6,2,1,8,7,0,4,4,3,3,0,4,4,0,0,15,-1,-1,3,2,0,0,-1,-1,-1,-1,1,3,1
KR_6624096481,420,-1,-89,40,-2,-4,0,4,3,3,0,4,5,1,-5,0,5,0,1,1,0,-5,-4,-1,5,4,-1,0,0,0,1,0,-1,0,1
KR_6713786665,440,5,109,-7,9,4,4,0,1,4,3,3,5,2,0,2,2,1,1,0,1,10,1,3,4,7,4,0,3,1,1,1,1,2,1
KR_6622836229,420,2,2,16,5,-2,1,3,2,4,2,5,6,1,-4,3,7,4,4,0,-1,4,-4,-2,5,3,-2,0,0,1,-1,0,-1,2,1
KR_6755694733,420,-3,-96,-11,-5,0,2,2,-1,2,3,4,5,1,-8,2,10,0,1,1,1,1,-13,4,1,5,-1,0,-1,-1,-1,-1,1,3,1
KR_6747319235,420,4,57,20,14,1,4,3,3,4,1,10,10,0,0,4,4,0,2,2,1,9,0,-2,6,4,2,0,2,1,1,1,1,2,1
KR_6724014210,420,-5,-94,-24,-3,-5,0,5,-2,2,4,2,5,3,1,4,3,1,1,0,0,5,-8,2,2,4,-2,0,0,1,0,-1,-1,6,1
KR_6687170796,420,0,44,0,0,6,6,0,-1,1,2,-5,1,6,-2,2,4,2,2,0,0,-11,-15,1,4,5,-1,0,2,1,-1,1,1,6,1
KR_6766105275,420,-2,-6,-16,-2,-2,1,3,4,7,3,-3,2,5,-2,3,5,1,2,1,-1,-3,-1,-6,9,3,2,0,0,1,0,0,-1,3,1
KR_6757796100,420,1,40,10,9,-1,3,4,-1,0,1,5,7,2,6,6,0,0,1,1,1,-1,18,0,4,4,5,0,1,1,-1,1,1,2,1
KR_6767212886,420,4,38,12,13,1,1,0,3,4,1,7,8,1,2,3,1,0,0,0,0,6,10,-3,7,4,-2,0,1,1,1,1,1,5,1
KR_6612405935,420,-2,61,-52,-1,-2,2,4,0,1,1,3,5,2,-2,1,3,0,1,1,0,-8,-182,1,3,4,2,0,1,1,1,1,1,6,1
KR_6688465099,420,-2,-8,-33,0,5,6,1,0,1,1,-2,1,3,-1,2,3,-2,0,2,0,-3,-11,1,3,4,1,0,1,-1,1,1,1,5,1
KR_6715800108,420,2,44,-6,10,1,1,0,1,3,2,3,4,1,4,7,3,1,3,2,0,9,203,-1,8,7,6,0,3,-1,1,1,1,1,1
KR_6540991635,420,5,100,11,5,-5,1,6,2,2,0,-1,0,1,5,5,0,4,4,0,0,7,22,0,4,4,1,0,2,1,-1,1,-1,5,1
KR_6684145261,420,4,-16,12,9,1,3,2,4,5,1,2,4,2,2,4,2,0,0,0,0,13,24,2,3,5,-5,0,0,-1,1,0,-1,6,1
KR_6750609838,420,1,15,24,4,1,2,1,0,4,4,3,5,2,-2,2,4,2,4,2,0,1,-2,0,4,4,2,0,0,0,0,1,1,0,1
KR_6737384928,420,2,69,4,9,6,6,0,3,5,2,1,4,3,-2,0,2,1,2,1,0,4,-1,5,2,7,-2,0,0,1,-1,1,1,1,1
KR_6679290007,420,-3,-97,28,-9,0,1,1,5,5,0,-9,4,13,-3,1,4,-2,0,2,0,-8,237,7,5,12,-6,0,-1,1,1,1,-1,2,1
KR_6752527281,420,2,-35,11,0,-3,0,3,2,5,3,2,2,0,0,2,2,-1,0,1,0,2,22,1,4,5,1,0,1,-1,1,1,-1,3,1
KR_6765885175,440,3,56,40,5,2,3,1,-2,4,6,4,4,0,2,4,2,-1,0,1,1,2,3,5,3,8,1,0,2,0,1,1,1,0,1
KR_6687202860,420,4,77,12,9,4,5,1,0,2,2,3,3,0,1,1,0,1,1,0,0,7,-5,-4,5,1,-3,0,0,1,-1,1,-1,2,1
KR_6758879457,420,8,109,29,10,1,3,2,2,8,6,5,7,2,2,3,1,0,0,0,1,14,34,5,0,5,-2,0,2,1,-1,1,1,3,1
KR_6732162977,420,2,-16,19,9,1,5,4,6,6,0,2,2,0,2,5,3,-2,0,2,0,4,5,1,4,5,0,0,1,1,1,1,1,3,1
KR_6384380143,420,7,72,-4,5,-1,0,1,-1,3,4,7,7,0,1,4,3,-1,1,2,0,-1,-13,-4,7,3,4,0,0,1,1,1,-1,4,1
KR_6766540715,420,2,84,-8,9,-2,0,2,-1,1,2,7,9,2,3,4,1,2,4,2,3,12,-2,3,2,5,4,0,0,1,1,1,-1,2,1
KR_6734258853,420,-1,36,-27,2,1,3,2,1,1,0,-1,2,3,2,2,0,-1,2,3,0,6,-6,-2,9,7,0,0,0,1,-1,-1,1,1,1
KR_6449072092,420,1,42,9,3,1,1,0,2,3,1,-1,1,2,1,4,3,0,1,1,0,3,-115,-2,4,2,-7,0,0,0,-1,0,1,0,1
KR_6745721437,420,0,18,0,-1,1,3,2,1,4,3,-3,0,3,0,0,0,0,0,0,0,0,-159,2,3,5,1,0,0,1,-1,0,1,3,1
KR_6717416675,420,3,-17,-5,6,2,5,3,2,4,2,-4,2,6,2,3,1,4,5,1,0,9,-6,-7,7,0,1,0,0,0,0,1,1,0,1
KR_6749382498,420,5,83,28,13,10,13,3,2,4,2,1,2,1,1,5,4,-1,1,2,0,4,162,6,1,7,0,0,2,0,1,1,1,0,1
KR_6745850080,420,0,-30,5,6,1,4,3,4,6,2,-1,4,5,1,1,0,1,2,1,0,3,-12,5,2,7,0,0,1,-1,1,1,-1,1,1
KR_6756412164,420,0,-79,8,0,0,1,1,1,7,6,-1,0,1,0,3,3,0,1,1,0,3,-19,-4,7,3,5,0,0,1,1,0,1,4,1
KR_6685074187,420,5,81,7,14,9,9,0,4,5,1,-1,3,4,2,2,0,0,1,1,0,4,-10,1,3,4,2,0,3,1,1,1,1,1,1
KR_6760532905,420,-3,-40,6,-3,-1,1,2,0,2,2,-1,4,5,3,3,0,-4,1,5,0,-3,-8,-2,5,3,3,0,0,-1,1,-1,-1,1,1
KR_6759618444,440,1,70,-17,1,1,2,1,0,0,0,-2,0,2,2,5,3,0,0,0,0,0,8,6,1,7,0,0,1,-1,1,1,1,2,1
KR_6737810128,420,4,78,0,7,2,2,0,-1,1,2,9,10,1,-1,1,2,-2,1,3,0,1,-239,4,2,6,-2,0,2,-1,1,1,1,6,1
KR_6618345218,420,0,26,6,-7,1,4,3,-2,2,4,-7,0,7,1,3,2,0,1,1,0,-17,1,-6,6,0,0,0,0,1,-1,-1,-1,5,1
KR_6760592726,420,6,7,9,11,-3,1,4,0,1,1,8,8,0,3,5,2,3,3,0,0,8,-4,3,3,6,3,0,0,1,1,-1,1,1,1
KR_6729657134,420,-1,4,16,-4,-1,0,1,3,5,2,-1,3,4,-5,1,6,0,1,1,1,4,4,5,4,9,1,0,1,-1,1,1,1,2,1
KR_6767361929,420,-5,-28,-16,-15,3,5,2,-11,1,12,-4,1,5,-2,1,3,-1,4,5,0,-20,6,-2,7,5,-1,0,0,1,1,1,-1,4,1
KR_6567904230,420,-3,-10,-18,-6,0,2,2,0,3,3,-1,1,2,-4,1,5,-1,0,1,0,-6,-1,0,6,6,-4,0,0,-1,1,1,-1,5,1
KR_6703634177,420,5,67,16,13,3,5,2,9,9,0,-2,2,4,0,3,3,3,4,1,0,25,9,-3,5,2,-1,0,4,-1,1,1,1,2,1
KR_6747866844,440,5,4,0,19,3,3,0,8,8,0,3,5,2,4,5,1,1,1,0,0,19,12,4,0,4,2,0,0,1,0,1,1,3,1
KR_6720193428,420,3,12,13,7,8,8,0,0,3,3,2,4,2,-2,0,2,-1,0,1,0,8,4,-2,5,3,5,0,2,1,1,1,-1,3,1
KR_6663420787,420,1,77,4,-4,0,0,0,0,5,5,-1,3,4,-2,2,4,-1,1,2,0,-1,15,-4,6,2,2,0,0,1,1,0,-1,5,1
KR_6754462112,420,4,122,18,-2,2,3,1,1,7,6,-4,2,6,0,3,3,-1,0,1,0,0,9,2,3,5,-1,0,2,1,1,1,-1,1,1
KR_6627294252,420,3,35,6,-1,-3,0,3,-1,1,2,2,4,2,3,8,5,-2,1,3,0,-1,-168,-1,9,8,3,0,-1,1,1,-1,-1,2,1
KR_6740084280,420,2,42,-23,8,-3,1,4,5,6,1,3,3,0,4,6,2,-1,0,1,0,15,6,3,3,6,0,0,2,1,1,1,1,6,1
KR_6676150874,440,1,-53,12,-3,0,1,1,3,4,1,-5,1,6,0,3,3,-1,0,1,0,-5,-5,8,2,10,2,0,1,-1,-1,1,1,5,1
KR_6764500709,420,-1,-33,-4,-2,-3,0,3,0,1,1,-4,0,4,6,7,1,-1,0,1,0,3,40,-3,7,4,2,0,-1,1,-1,1,1,6,1
KR_6705535367,420,1,-7,44,2,-2,1,3,2,4,2,-4,0,4,2,3,1,4,4,0,0,5,24,-3,7,4,-15,0,1,1,1,1,-1,5,1
KR_6662273270,440,6,101,3,10,0,1,1,-4,0,4,8,9,1,6,6,0,0,1,1,0,0,-3,0,2,2,2,0,2,-1,-1,1,-1,6,1
KR_6709352046,420,5,38,11,15,1,1,0,3,5,2,6,8,2,7,8,1,-2,1,3,0,12,10,5,3,8,2,0,0,-1,-1,-1,-1,2,1
KR_6658630952,420,-2,-32,-8,-2,-4,0,4,5,6,1,-2,0,2,-2,0,2,1,1,0,0,4,229,-2,5,3,0,0,-2,1,0,-1,1,2,1
KR_6621459840,420,4,113,3,11,9,9,0,5,9,4,-2,3,5,-1,1,2,0,2,2,0,10,-105,-6,12,6,6,0,2,-1,1,1,-1,1,1
KR_6763088290,420,1,37,-18,4,0,1,1,6,9,3,1,1,0,-1,4,5,-2,0,2,0,11,-4,2,5,7,2,0,1,-1,1,1,-1,1,1
KR_6308934198,440,2,-8,44,0,1,3,2,4,5,1,0,1,1,-5,1,6,0,1,1,0,-7,-2,5,1,6,-4,0,0,1,1,1,1,6,1
KR_6756855880,420,0,11,-34,1,-1,0,1,-1,2,3,1,3,2,1,2,1,1,2,1,0,2,38,-2,5,3,-24,0,1,1,-1,1,1,5,1
KR_6745045019,440,5,60,28,4,-1,0,1,2,7,5,0,1,1,1,1,0,2,3,1,0,2,65,-3,9,6,-2,0,1,-1,1,1,-1,5,1
KR_6743031545,420,3,14,44,4,-1,2,3,0,1,1,0,3,3,5,6,1,0,1,1,0,4,-253,-1,7,6,-1,0,-1,1,-1,-1,1,4,1
KR_6762040025,420,0,56,-20,-5,-1,1,2,-1,1,2,-4,1,5,4,5,1,-3,2,5,0,-2,-5,-1,5,4,-2,0,0,1,0,0,1,4,1
KR_6720322163,420,1,67,10,-1,3,4,1,-1,0,1,-1,2,3,-2,0,2,0,1,1,0,-1,7,-1,6,5,9,0,0,-1,1,1,-1,4,1
KR_6734856376,420,-3,52,-45,-6,-2,2,4,-2,2,4,1,3,2,-3,0,3,0,2,2,0,-4,95,0,4,4,4,0,0,1,-1,0,-1,6,1
KR_6692280704,420,10,109,25,15,3,3,0,0,1,1,3,6,3,10,11,1,-1,1,2,-1,21,3,3,4,7,5,0,3,1,1,1,-1,6,1
KR_6700988225,420,3,-7,8,4,2,3,1,1,2,1,5,6,1,-3,2,5,-1,1,2,-1,2,-1,-1,7,6,2,0,0,-1,-1,1,-1,3,1
KR_6750665239,420,1,82,4,3,1,3,2,-2,2,4,-1,1,2,5,7,2,0,0,0,0,1,-19,-2,3,1,-2,0,0,-1,-1,-1,1,6,1
KR_6703407646,420,-2,-13,21,1,-6,1,7,8,12,4,-1,1,2,0,2,2,0,4,4,0,1,1,0,6,6,-3,0,0,1,0,0,1,3,1
KR_6729715893,440,3,-51,15,3,0,2,2,-4,1,5,0,1,1,1,4,3,6,6,0,0,4,-3,1,3,4,5,0,-1,1,-1,-1,-1,3,1
KR_6749297141,420,6,116,9,10,2,3,1,1,3,2,5,7,2,3,6,3,-1,0,1,2,11,-5,1,4,5,1,0,1,1,1,1,1,1,1
KR_6755031470,420,0,110,-32,0,-3,1,4,0,2,2,0,3,3,5,5,0,-2,0,2,0,3,3,3,1,4,5,0,0,1,-1,1,1,1,1
KR_6742502914,420,3,-27,36,2,0,0,0,2,3,1,2,3,1,-3,3,6,1,3,2,0,-2,4,0,2,2,2,0,0,1,1,0,1,4,1
KR_6380902054,420,-2,-2,-12,-6,2,2,0,-7,0,7,-2,1,3,3,5,2,-2,0,2,0,-6,32,-1,6,5,-16,0,0,-1,1,1,-1,3,1
KR_6766725280,420,6,55,-16,5,2,4,2,0,1,1,5,5,0,-3,2,5,1,4,3,0,3,7,0,5,5,2,0,2,1,1,1,1,2,1
KR_6767088499,420,2,-5,14,0,1,1,0,-2,0,2,4,5,1,0,2,2,-3,0,3,0,-3,1,1,6,7,-1,0,1,-1,1,1,-1,1,1
KR_6737209951,440,4,36,4,10,8,9,1,-2,0,2,3,3,0,1,4,3,0,0,0,0,10,0,2,4,6,0,0,2,1,1,1,1,2,1
KR_6703710116,420,7,88,109,1,-2,1,3,1,2,1,6,7,1,-4,5,9,0,0,0,0,-7,1,3,4,7,-4,0,2,0,1,1,-1,0,1
KR_6764393739,420,3,48,16,8,0,3,3,4,4,0,3,3,0,1,1,0,0,0,0,0,6,12,1,2,3,2,0,0,1,-1,1,1,3,1
KR_6737555496,420,-1,-98,-16,6,0,0,0,4,5,1,-1,3,4,1,3,2,2,2,0,0,16,200,0,6,6,-4,0,-1,0,-1,-1,1,0,1
KR_6748120399,420,5,81,-8,5,4,6,2,0,2,2,-1,1,2,2,4,2,0,0,0,-2,-4,322,4,6,10,1,0,0,1,0,1,-1,5,1
KR_6640686660,420,2,-9,4,-1,0,1,1,-4,1,5,2,3,1,3,4,1,-2,0,2,-1,-7,-8,-1,5,4,-1,0,0,1,1,0,-1,6,1
KR_6722442545,440,2,-37,21,8,1,2,1,4,4,0,4,5,1,-3,0,3,2,2,0,0,11,25,2,1,3,-5,0,1,-1,1,1,1,6,1
KR_6755740475,420,2,17,19,10,0,1,1,0,2,2,2,4,2,4,6,2,4,5,1,-1,-1,1,-3,7,4,3,0,1,0,0,1,-1,0,1
KR_6762142943,420,1,24,-4,2,2,4,2,0,4,4,2,2,0,-4,2,6,2,4,2,0,1,10,-1,5,4,0,0,1,1,-1,1,1,2,1
KR_6520224922,420,-1,-55,23,-3,-2,2,4,3,6,3,1,1,0,-3,0,3,-2,1,3,0,-11,20,-2,6,4,-2,0,-1,1,-1,-1,1,3,1
KR_6633211516,440,7,131,5,12,6,6,0,0,0,0,3,4,1,3,3,0,0,0,0,0,10,17,3,3,6,5,0,2,1,1,1,1,5,1
KR_6760385423,420,6,126,-15,24,4,6,2,3,3,0,12,12,0,6,6,0,-1,4,5,0,10,0,2,1,3,2,0,1,1,1,1,1,4,1
KR_6657695717,420,5,38,21,7,1,1,0,-2,4,6,3,3,0,3,4,1,2,4,2,0,6,6,3,5,8,0,0,0,-1,1,1,1,2,1
KR_6765479902,420,3,3,29,4,4,6,2,0,3,3,0,1,1,-2,4,6,2,2,0,0,-2,-45,-1,3,2,27,0,1,1,1,1,1,4,1
KR_6631690978,420,4,-1,38,8,4,4,0,3,3,0,1,3,2,-1,3,4,1,1,0,0,5,-4,-1,4,3,-2,0,2,1,1,1,-1,1,1
KR_6740101363,420,3,-3,7,8,4,4,0,4,5,1,-3,0,3,-1,1,2,4,5,1,-1,5,-27,-1,4,3,0,0,1,-1,1,1,-1,1,1
KR_6597116901,420,0,13,12,-1,3,4,1,0,1,1,0,0,0,-4,0,4,0,0,0,0,-2,1,-1,6,5,-2,0,0,-1,1,0,1,2,1
KR_6734893609,420,2,-4,-8,2,1,4,3,0,1,1,7,9,2,-8,0,8,2,4,2,1,7,46,-2,9,7,0,0,-1,1,0,-1,1,3,1
KR_6751766067,420,2,52,20,7,0,0,0,6,7,1,-1,2,3,0,3,3,2,3,1,0,6,9,1,1,2,2,0,1,1,1,1,1,4,1
KR_6514228980,420,8,118,34,26,2,4,2,9,10,1,5,13,8,6,7,1,4,4,0,1,22,152,8,0,8,0,0,4,0,1,1,1,0,1
KR_6765663560,420,-5,7,10,-6,-4,1,5,2,3,1,-2,2,4,2,7,5,-4,1,5,0,1,-17,1,2,3,-2,0,-1,1,-1,-1,1,5,1
KR_6740877842,420,2,11,48,1,-1,1,2,-2,1,3,4,5,1,0,5,5,0,0,0,0,-1,-6,2,3,5,5,0,0,1,1,0,1,4,1
KR_6729410974,420,6,92,16,15,-2,0,2,1,3,2,3,3,0,14,15,1,-1,0,1,0,10,-9,-2,4,2,5,0,5,1,1,1,1,4,1
KR_6666058315,420,2,130,9,4,1,3,2,2,3,1,-1,0,1,0,1,1,2,2,0,0,5,-11,-4,8,4,4,0,2,-1,1,1,1,2,1
KR_6638374106,420,2,-51,48,4,3,3,0,1,2,1,1,5,4,1,3,2,-2,0,2,2,4,8,5,1,6,-3,0,0,0,1,0,1,0,1
KR_6765938282,420,-2,-7,17,-4,-1,1,2,-2,2,4,-7,0,7,4,7,3,2,2,0,0,-10,-3,-3,6,3,0,0,-1,-1,-1,-1,1,2,1
KR_6764986743,420,2,-20,16,-1,-1,2,3,-2,1,3,4,5,1,-2,0,2,0,3,3,0,0,8,3,4,7,-4,0,1,-1,1,1,-1,4,1
KR_6767929965,420,1,97,28,1,1,1,0,4,6,2,-1,1,2,-2,3,5,-1,0,1,2,5,48,7,1,8,0,0,1,1,1,1,1,3,1
KR_6713869246,440,0,-37,-12,-1,-3,1,4,4,6,2,-4,2,6,0,0,0,2,2,0,0,3,9,-7,9,2,-1,0,1,-1,1,1,1,5,1
KR_6609644895,420,1,-30,12,5,0,0,0,6,8,2,-3,1,4,1,3,2,1,3,2,0,8,1,4,3,7,-1,0,1,-1,1,1,1,2,1
KR_6712329314,420,-1,50,-3,0,-4,3,7,2,2,0,2,8,6,0,2,2,0,0,0,0,2,4,-2,6,4,3,0,1,-1,1,-1,1,6,1
KR_6628485118,420,0,43,24,2,2,5,3,0,4,4,2,4,2,0,3,3,-2,0,2,0,-9,-1,-1,4,3,0,0,1,1,0,1,1,5,1
KR_6759236253,420,0,34,8,-5,2,2,0,0,1,1,-5,1,6,0,2,2,-2,1,3,0,-9,-202,-4,7,3,1,0,0,1,-1,0,-1,2,1
KR_6739399646,420,2,53,-3,12,6,6,0,6,10,4,0,2,2,2,2,0,-2,0,2,0,14,159,0,2,2,21,0,1,0,0,1,1,0,1
KR_6721979446,440,1,31,28,1,1,3,2,3,4,1,-1,0,1,-1,1,2,-1,0,1,0,-4,0,-3,8,5,3,0,-1,-1,1,1,-1,3,1
KR_6767380968,420,4,40,0,19,5,5,0,2,3,1,-1,3,4,11,11,0,2,2,0,0,16,-5,-3,4,1,-4,0,1,-1,1,1,-1,4,1
KR_6738546588,420,5,-1,38,9,3,4,1,0,2,2,2,3,1,5,8,3,-1,1,2,0,10,-4,-1,5,4,7,0,1,-1,1,-1,-1,1,1
KR_6765517183,420,4,37,24,11,3,4,1,2,3,1,0,1,1,5,5,0,1,4,3,2,17,8,4,2,6,-2,0,2,1,1,1,1,2,1
KR_6751048889,440,-4,-56,12,0,1,1,0,-2,3,5,-1,2,3,0,2,2,2,4,2,1,4,0,2,5,7,2,0,-1,1,0,-1,1,5,1
KR_6706669473,420,2,28,-1,2,-1,1,2,4,4,0,-5,1,6,1,3,2,3,3,0,-1,3,-44,4,2,6,14,0,0,1,-1,-1,-1,2,1
KR_6755210424,420,1,7,12,1,0,0,0,2,2,0,-2,0,2,0,2,2,1,1,0,0,3,-2,0,4,4,0,0,0,1,1,0,1,1,1
KR_6744741980,420,2,89,-4,-1,-2,0,2,6,7,1,-7,1,8,2,4,2,0,0,0,0,2,-3,3,2,5,-2,0,-1,-1,-1,-1,1,5,1
KR_6675654808,420,1,-8,20,0,-2,0,2,4,6,2,1,4,3,-3,3,6,0,0,0,0,3,0,-1,6,5,-1,0,-1,1,-1,-1,-1,1,1
KR_6727530882,420,4,-24,39,7,1,2,1,2,4,2,4,5,1,1,7,6,-1,2,3,-1,0,7,2,6,8,-1,0,1,1,1,1,-1,6,1
KR_6718565781,440,1,29,-4,-2,4,4,0,-2,0,2,-1,0,1,1,2,1,-4,3,7,0,-6,-21,0,3,3,5,0,1,-1,-1,1,-1,6,1
KR_6755473277,420,4,-11,31,8,1,2,1,9,10,1,6,6,0,-6,1,7,-2,1,3,0,6,-450,-3,3,0,2,0,1,1,0,1,-1,2,1
KR_6755669260,420,-1,-25,-28,1,-2,0,2,-1,2,3,2,5,3,-1,4,5,3,3,0,-2,-2,126,1,5,6,-11,0,0,1,-1,0,-1,4,1
KR_6711260178,420,5,44,29,8,1,3,2,1,4,3,5,6,1,1,2,1,0,1,1,0,-2,9,-2,2,0,-2,0,2,1,1,1,1,4,1
KR_6703576704,420,1,-57,-1,2,2,3,1,1,2,1,0,5,5,1,1,0,-2,0,2,0,-2,-115,1,4,5,1,0,0,1,1,-1,1,6,1
KR_6717225926,420,0,21,-21,2,2,4,2,0,1,1,-1,0,1,0,0,0,1,1,0,0,1,-3,1,5,6,4,0,0,-1,1,0,-1,5,1
KR_6724367378,440,4,45,-10,14,0,1,1,1,3,2,8,9,1,5,6,1,0,1,1,0,8,62,4,1,5,-3,0,2,1,1,1,1,4,1
KR_6565347449,420,-3,-29,4,1,-1,1,2,-4,0,4,0,1,1,6,8,2,0,0,0,0,5,2,3,6,9,2,0,1,1,1,1,-1,6,1
KR_6713927033,420,1,42,-9,6,5,5,0,-2,1,3,0,0,0,2,3,1,1,1,0,2,8,-293,0,5,5,4,0,1,1,1,1,1,6,1
KR_6754869165,420,3,40,38,14,-2,1,3,3,5,2,2,3,1,10,12,2,1,2,1,0,12,-3,-2,5,3,2,0,2,1,0,1,1,1,1
KR_6561798637,420,2,50,3,-3,1,3,2,-7,2,9,1,2,1,1,5,4,1,4,3,1,-1,0,1,5,6,2,0,0,1,0,0,1,6,1
KR_6744955241,420,0,-13,-8,3,0,1,1,6,8,2,1,3,2,-1,1,2,-3,3,6,0,3,7,1,2,3,-1,0,0,-1,-1,-1,1,6,1
KR_6665104321,420,0,-7,-8,-3,1,4,3,0,3,3,-2,1,3,-3,0,3,1,5,4,0,1,5,-5,7,2,2,0,-1,1,-1,-1,-1,5,1
KR_6746595060,420,0,113,-20,1,-2,0,2,1,6,5,3,3,0,-1,2,3,0,2,2,1,4,-13,-1,4,3,0,0,0,1,1,0,1,5,1
KR_6767227317,420,4,-2,24,9,4,4,0,3,5,2,-3,1,4,1,3,2,4,4,0,0,1,-7,2,2,4,1,0,1,1,0,1,-1,3,1
KR_6625038237,420,4,71,20,8,6,6,0,3,6,3,0,2,2,0,0,0,-1,1,2,-1,2,-7,3,2,5,0,0,1,-1,-1,1,-1,5,1
KR_6464857027,420,0,6,1,1,-2,0,2,-1,1,2,0,3,3,3,3,0,1,1,0,0,1,121,7,1,8,-9,0,-1,1,1,-1,1,4,1
KR_6626540301,420,0,-21,36,0,-4,0,4,3,3,0,0,4,4,2,4,2,-1,0,1,0,-1,-34,0,3,3,-4,0,-1,-1,1,-1,1,5,1
KR_6703482764,420,0,34,-8,9,2,3,1,4,6,2,1,4,3,3,5,2,-1,1,2,0,16,7,2,1,3,-2,0,0,-1,0,1,1,2,1
KR_6749937625,420,1,-19,-24,5,0,0,0,3,7,4,-2,0,2,3,4,1,1,2,1,0,7,-29,0,2,2,-4,0,1,1,1,1,1,3,1
KR_6750533124,420,0,7,0,-2,1,4,3,0,2,2,-1,1,2,-1,1,2,-1,0,1,0,-1,5,-5,6,1,3,0,0,-1,-1,1,1,6,1
KR_6695612557,420,-1,-20,-64,3,-2,0,2,1,2,1,-1,4,5,3,3,0,2,2,0,0,10,20,3,3,6,3,0,-1,-1,-1,-1,-1,5,1
KR_6624176312,420,0,32,9,2,-1,2,3,8,8,0,-1,3,4,-3,2,5,-1,0,1,-1,3,-3,-1,4,3,3,0,1,1,-1,1,-1,5,1
KR_6678094960,420,0,2,2,-4,1,2,1,-4,3,7,-2,0,2,-1,4,5,2,3,1,0,-2,-12,-2,5,3,-4,0,-1,1,-1,-1,1,6,1
KR_6754339084,420,7,78,31,14,4,6,2,3,3,0,4,4,0,0,4,4,3,3,0,2,12,8,-1,3,2,4,1,6,1,1,1,1,3,1
KR_6742177073,440,-2,-29,4,4,-2,1,3,-5,2,7,1,3,2,9,10,1,1,2,1,0,9,-6,-7,8,1,2,0,-1,1,-1,-1,1,5,1
KR_6736764226,420,2,2,-3,2,4,4,0,1,3,2,-2,2,4,-1,0,1,0,0,0,0,-3,-35,-1,3,2,11,0,-1,-1,-1,-1,1,4,1
KR_6761863389,420,2,-7,-8,0,-4,1,5,-1,4,5,6,6,0,-1,2,3,0,1,1,0,1,-7,-1,8,7,4,0,0,1,0,-1,-1,1,1
KR_6723099107,420,5,61,36,11,-2,0,2,0,4,4,7,7,0,5,5,0,1,1,0,0,22,21,3,3,6,-2,0,2,1,1,1,1,4,1
KR_6755500450,440,3,96,26,4,4,5,1,2,3,1,-1,0,1,0,2,2,-1,2,3,-1,0,2,-1,6,5,2,0,0,-1,1,1,-1,4,1
KR_6732145690,420,0,-17,4,2,0,3,3,-2,1,3,4,4,0,0,4,4,0,0,0,0,6,1,2,4,6,4,0,0,1,-1,-1,1,5,1
KR_6735871406,420,7,139,36,21,4,4,0,4,5,1,3,4,1,10,12,2,0,1,1,1,16,3,2,2,4,0,0,1,1,0,1,1,4,1
KR_6765768763,440,0,65,-24,1,-5,2,7,-4,2,6,1,1,0,8,10,2,1,2,1,0,9,9,6,4,10,0,0,1,1,-1,1,-1,5,1
KR_6768247479,420,-3,1,-21,-17,-1,1,2,-5,4,9,-5,2,7,-6,2,8,0,1,1,-1,-24,-6,-3,4,1,0,0,1,-1,0,1,-1,3,1
KR_6755183908,420,-1,39,-4,-4,-1,0,1,-2,3,5,0,1,1,1,2,1,-2,0,2,0,-6,-9,0,4,4,0,0,-1,0,1,-1,1,0,1
KR_6705238649,420,-3,-33,5,-10,-1,4,5,1,1,0,-5,0,5,-5,1,6,0,0,0,1,-9,-8,-3,4,1,0,0,-1,-1,-1,-1,1,5,1
KR_6637909617,420,-5,-52,-5,-1,3,3,0,1,7,6,0,2,2,-6,0,6,1,1,0,0,-11,-7,0,5,5,1,0,0,1,-1,-1,-1,4,1
KR_6592984585,420,1,59,-14,0,7,8,1,-1,2,3,-5,2,7,-2,1,3,1,2,1,1,2,-19,-3,8,5,-1,0,0,1,1,1,1,3,1
KR_6752005742,440,1,31,-12,1,-3,1,4,4,4,0,4,6,2,-1,5,6,-3,0,3,0,2,9,1,3,4,0,0,2,0,-1,1,1,0,1
KR_6724281537,440,2,5,-12,7,2,5,3,2,3,1,4,4,0,0,3,3,-1,1,2,0,3,6,5,0,5,1,0,1,-1,1,1,1,6,1
KR_6695620417,420,2,59,13,9,0,2,2,0,3,3,3,4,1,0,3,3,6,6,0,0,1,14,-2,4,2,-2,0,1,1,1,1,1,4,1
KR_6713028244,420,0,-29,-7,5,0,1,1,4,5,1,0,3,3,1,1,0,0,0,0,0,4,63,6,3,9,-2,0,0,1,1,0,1,5,1
KR_6741723702,420,2,-19,-15,8,-1,3,4,3,4,1,3,3,0,3,4,1,0,0,0,0,10,25,-7,7,0,0,0,0,-1,1,0,1,2,1
KR_6763260949,420,1,-35,-4,3,4,5,1,-1,2,3,0,2,2,0,1,1,0,0,0,0,0,-2,-1,2,1,-2,0,1,-1,1,1,1,2,1
KR_6684972029,420,7,82,29,18,3,3,0,6,6,0,1,4,3,3,10,7,5,5,0,1,14,13,2,2,4,-4,0,2,1,1,1,1,5,1
KR_6726101993,420,3,88,-4,1,3,3,0,1,3,2,-1,1,2,-3,2,5,1,3,2,0,-1,-2,-3,7,4,-2,0,0,1,0,0,-1,1,1
KR_6733925540,420,5,-8,3,6,2,3,1,-1,2,3,3,4,1,-3,5,8,5,5,0,0,2,18,-1,4,3,1,0,1,1,1,1,-1,3,1
KR_6654621222,420,3,34,17,2,-2,0,2,1,2,1,0,1,1,0,3,3,3,3,0,0,10,23,-4,6,2,7,0,1,1,-1,1,1,1,1
KR_6696886487,420,2,60,-23,4,3,3,0,-3,0,3,1,2,1,1,2,1,2,2,0,0,-2,-21,0,3,3,14,0,0,1,-1,-1,1,5,1
KR_6755447064,420,-2,42,-4,5,-3,0,3,2,4,2,5,5,0,0,1,1,1,1,0,0,4,122,-1,4,3,-2,0,1,1,1,1,1,2,1
KR_6733606243,420,2,49,16,-2,1,1,0,0,3,3,2,3,1,-4,0,4,-1,0,1,0,-7,7,-3,7,4,-2,0,0,1,1,0,-1,1,1
KR_6767336088,420,3,47,-12,7,3,4,1,0,1,1,2,3,1,3,4,1,-1,0,1,0,4,-39,0,4,4,3,0,1,1,1,1,1,4,1
KR_6689481612,420,0,0,-18,-3,-6,1,7,2,3,1,-1,1,2,3,4,1,-1,0,1,0,-2,-5,1,7,8,-1,0,0,-1,1,0,-1,3,1
KR_6742241512,440,2,44,16,-2,-4,3,7,2,2,0,3,5,2,-3,3,6,0,1,1,0,-3,-10,2,2,4,7,0,3,1,1,1,-1,2,1
KR_6677806916,420,-3,-76,16,-3,1,1,0,-2,2,4,1,2,1,-2,3,5,-1,1,2,1,-1,4,3,5,8,0,0,0,-1,-1,-1,1,3,1
KR_6750406979,440,5,59,-8,14,3,6,3,3,3,0,2,2,0,3,5,2,3,3,0,0,12,13,3,4,7,9,0,1,1,-1,1,1,1,1
KR_6756789461,420,-2,-24,-12,-10,-1,1,2,-2,0,2,-5,1,6,0,2,2,-2,2,4,-3,-13,-6,-7,8,1,4,0,-1,-1,-1,-1,-1,4,1
KR_6764573681,420,0,125,-9,7,0,1,1,0,2,2,1,3,2,1,1,0,5,5,0,0,6,-1,-3,5,2,1,0,1,0,0,1,1,0,1
KR_6759309132,420,-2,-38,28,2,-2,2,4,7,8,1,-1,2,3,-1,2,3,-1,0,1,2,5,4,4,1,5,4,0,0,1,1,1,1,2,1
KR_6757403608,420,0,-8,48,3,3,3,0,0,3,3,0,5,5,-2,2,4,2,2,0,0,-1,-169,1,3,4,0,0,-1,-1,1,-1,1,2,1
KR_6699332238,420,0,-22,16,5,2,2,0,-4,3,7,4,5,1,2,3,1,1,2,1,0,11,9,4,2,6,-2,0,0,1,1,0,1,4,1
KR_6758745917,440,1,-31,-8,9,4,4,0,-2,1,3,-2,1,3,8,11,3,1,2,1,0,5,50,-1,4,3,-23,0,1,1,1,1,1,6,1
KR_6762442579,420,0,6,-7,0,-1,3,4,-1,2,3,-3,2,5,4,7,3,1,1,0,-1,6,3,1,4,5,3,0,0,1,-1,-1,-1,6,1
KR_6761977491,420,1,-21,13,3,5,5,0,-3,1,4,5,7,2,-3,3,6,-1,1,2,0,-6,-114,-4,6,2,2,0,2,-1,1,1,1,1,1
KR_6683007119,420,-1,-31,-4,-4,1,1,0,0,2,2,0,2,2,-5,0,5,0,2,2,0,0,6,-1,3,2,3,0,-2,-1,-1,-1,-1,1,1
KR_6684004748,420,0,-91,28,3,-3,1,4,6,7,1,3,5,2,-2,2,4,-1,0,1,0,4,-10,-7,10,3,1,0,-1,0,1,-1,-1,0,1
KR_6559630121,420,2,22,12,1,-1,0,1,-2,1,3,6,6,0,-2,1,3,0,1,1,0,-6,-2,-2,5,3,-1,0,0,1,-1,0,1,1,1
KR_6764622318,440,0,-30,20,-1,-3,2,5,1,2,1,-1,0,1,-4,2,6,6,8,2,0,-1,-11,-2,8,6,8,0,-1,-1,1,-1,1,1,1
KR_6757603491,420,1,71,26,-3,2,4,2,-2,1,3,0,2,2,-1,2,3,-2,0,2,0,-5,54,3,4,7,-35,0,2,1,-1,1,-1,6,1
KR_6744865297,420,1,-10,29,-1,2,3,1,0,1,1,0,1,1,-2,3,5,-1,1,2,-1,-3,199,-2,8,6,1,0,0,1,-1,1,-1,6,1
KR_6712882377,420,3,38,12,0,1,3,2,-1,0,1,0,4,4,1,2,1,-1,0,1,0,-4,178,0,3,3,-3,0,1,-1,1,1,1,1,1
KR_6733494656,420,2,61,36,4,-2,0,2,1,4,3,4,5,1,0,1,1,1,1,0,0,-4,31,8,0,8,-1,0,3,1,1,1,1,1,1
KR_6717730678,420,-1,5,14,-3,1,2,1,2,7,5,1,3,2,-6,0,6,-1,0,1,0,1,6,2,6,8,-10,0,0,-1,-1,0,-1,5,1
KR_6728586000,420,2,51,-16,5,0,2,2,-1,1,2,3,4,1,-1,0,1,4,4,0,1,7,-30,-2,5,3,2,0,1,1,1,1,1,5,1
KR_6745758258,420,1,-1,16,11,0,2,2,2,4,2,-1,2,3,5,5,0,5,6,1,0,19,8,-4,8,4,4,0,2,1,-1,1,1,6,1
KR_6767146771,440,0,-76,1,1,-5,0,5,3,4,1,4,6,2,-4,1,5,3,5,2,-1,-4,-12,0,4,4,1,0,-1,1,-1,-1,-1,3,1
KR_6670239075,420,-2,44,0,-9,-3,1,4,0,3,3,-4,1,5,1,4,3,-3,0,3,0,-10,-7,-3,7,4,0,0,-1,-1,-1,-1,-1,6,1
KR_6761128836,420,1,92,16,2,1,3,2,0,1,1,-1,1,2,-2,3,5,4,4,0,0,4,5,1,0,1,1,0,3,1,-1,1,-1,4,1
KR_6717327086,420,2,57,-30,2,-1,4,5,-1,2,3,2,3,1,2,2,0,0,1,1,0,9,-7,1,4,5,5,0,1,-1,1,1,-1,2,1
KR_6607571416,420,-1,9,-20,1,5,5,0,-4,0,4,1,5,4,0,5,5,-1,0,1,0,1,-6,2,7,9,5,0,0,-1,-1,-1,1,3,1
KR_6761268011,420,0,-37,-14,-2,-3,1,4,3,4,1,6,8,2,-4,3,7,-4,1,5,-1,-3,-17,4,1,5,-1,0,-1,0,-1,-1,-1,0,1
KR_6670967447,420,3,52,-4,13,1,4,3,4,7,3,2,3,1,6,6,0,0,0,0,0,14,27,4,2,6,2,0,1,0,1,1,1,0,1
KR_6727395937,420,0,14,-8,-3,1,2,1,2,3,1,1,2,1,-4,1,5,-3,3,6,-1,-9,-29,4,1,5,19,0,-1,1,-1,1,-1,6,1
KR_6626454637,420,-3,-25,16,-5,0,1,1,1,3,2,-1,1,2,-4,4,8,-1,0,1,0,-2,-3,0,3,3,2,0,-2,-1,-1,1,-1,3,1
KR_6754018175,420,4,104,-8,13,2,2,0,4,4,0,5,5,0,2,3,1,0,0,0,0,9,-16,-3,5,2,-1,0,1,0,1,1,1,0,1
KR_6625586199,420,4,64,16,8,-3,0,3,6,6,0,6,6,0,-5,2,7,4,4,0,2,4,-7,-4,7,3,1,0,1,1,1,1,1,2,1
KR_6759785094,420,1,-13,9,-2,-1,1,2,2,4,2,-1,1,2,-7,0,7,5,5,0,0,0,3,-5,9,4,-2,0,0,0,1,0,1,0,1
KR_6745123438,420,1,-25,3,0,-3,0,3,3,4,1,1,2,1,-1,1,2,0,1,1,-1,9,-2,8,1,9,-5,0,0,1,0,0,-1,4,1
KR_6655396771,420,-3,-4,11,-11,4,4,0,1,4,3,-6,1,7,-7,0,7,-3,0,3,-1,-16,196,-1,5,4,4,0,0,-1,1,1,-1,5,1
KR_6756496505,440,0,-59,-13,5,-5,2,7,4,5,1,-2,2,4,8,10,2,0,2,2,-2,7,15,3,2,5,-4,0,0,1,-1,-1,-1,2,1
KR_6733439353,420,2,44,5,8,3,4,1,0,3,3,2,3,1,0,1,1,3,4,1,0,7,10,4,1,5,0,0,2,-1,1,1,1,2,1
KR_6756045567,420,-2,0,21,-5,1,2,1,0,2,2,-5,1,6,1,2,1,-2,0,2,0,-8,19,2,4,6,0,0,0,1,0,-1,1,4,1
KR_6739302615,420,3,10,12,11,6,7,1,1,4,3,5,6,1,-1,2,3,0,1,1,-1,5,-7,-2,5,3,7,0,1,1,1,1,-1,6,1
KR_6753055192,420,2,48,34,4,2,4,2,-2,1,3,1,1,0,3,3,0,0,0,0,0,5,11,0,3,3,0,0,1,1,1,1,1,6,1
KR_6762236749,420,0,56,-35,1,0,3,3,-3,0,3,-1,0,1,6,9,3,-1,0,1,0,0,-7,1,3,4,2,0,0,1,0,1,-1,3,1
KR_6679799240,420,4,47,3,7,1,1,0,-1,1,2,2,3,1,5,5,0,0,1,1,0,5,-31,-3,6,3,-1,0,0,0,-1,0,1,0,1
KR_6765631221,420,2,46,-16,4,0,1,1,3,4,1,0,2,2,2,3,1,-1,2,3,0,2,-5,-1,3,2,0,0,-1,1,-1,-1,-1,5,1
KR_6762986674,420,1,-40,29,3,-3,0,3,-1,3,4,1,2,1,2,5,3,4,5,1,-1,6,0,3,4,7,5,0,1,-1,1,1,-1,6,1
KR_6764636073,420,1,7,28,3,5,7,2,-6,0,6,0,2,2,0,3,3,4,5,1,0,5,-4,0,4,4,6,0,0,-1,1,1,1,3,1
KR_6767324689,420,4,66,11,-1,2,2,0,1,2,1,-7,0,7,1,2,1,2,3,1,0,6,-4,-3,6,3,0,0,-1,1,-1,-1,-1,4,1
KR_6767731297,420,1,-63,0,8,1,1,0,2,3,1,2,4,2,4,5,1,-1,0,1,0,13,-3,-2,6,4,2,0,-1,-1,1,-1,-1,3,1
KR_6761680899,440,0,-18,-40,4,0,2,2,0,1,1,4,5,1,0,3,3,0,2,2,0,6,-3,3,4,7,3,0,-1,1,-1,-1,1,2,1
KR_6766387916,420,0,-28,12,-2,-5,0,5,0,2,2,3,4,1,0,3,3,0,1,1,0,5,9,-1,6,5,-1,0,0,-1,1,-1,1,4,1
KR_6751179774,420,7,79,55,6,1,2,1,5,6,1,1,2,1,-1,1,2,0,1,1,0,3,460,0,3,3,-23,0,0,1,1,1,-1,6,1
KR_6767895649,420,2,76,19,8,5,6,1,3,4,1,0,2,2,-1,0,1,1,1,0,-2,10,0,1,3,4,-2,0,1,1,1,1,-1,2,1
KR_6682888618,420,2,19,8,-1,2,2,0,-3,2,5,-4,3,7,4,6,2,0,2,2,0,2,-4,4,2,6,-6,0,0,-1,1,1,-1,2,1
KR_6698317061,420,3,82,5,10,5,6,1,-2,5,7,3,6,3,4,5,1,0,0,0,0,5,-11,2,3,5,13,0,2,-1,1,1,1,3,1
KR_6572972680,420,3,69,1,10,2,5,3,3,4,1,-1,3,4,6,6,0,0,1,1,0,7,-2,3,2,5,1,0,-2,1,-1,-1,1,6,1
KR_6703375992,420,4,-14,-20,8,1,2,1,4,5,1,0,2,2,4,7,3,-1,1,2,0,5,1,0,4,4,-1,0,1,-1,1,1,-1,3,1
KR_6759332877,420,1,-47,-24,6,-1,1,2,3,5,2,7,10,3,-3,2,5,0,3,3,0,10,-3,-3,6,3,-1,0,0,0,1,-1,-1,0,1
KR_6710885867,420,1,0,-9,7,2,3,1,7,8,1,-1,1,2,-3,2,5,2,5,3,0,6,1,2,2,4,-3,0,1,-1,1,1,1,4,1
KR_6738625419,420,0,-6,2,-5,-1,0,1,2,3,1,0,2,2,-4,0,4,-2,0,2,0,-7,-153,3,2,5,1,0,-1,1,-1,-1,-1,5,1
KR_6733568320,420,8,79,21,27,7,10,3,3,3,0,5,6,1,13,13,0,-1,0,1,1,25,2,3,2,5,1,0,1,1,1,1,1,1,1
KR_6736706085,420,-3,7,-31,-2,4,5,1,-4,1,5,0,1,1,-2,2,4,0,0,0,0,-8,-74,-3,7,4,23,0,-1,1,1,-1,1,1,1
KR_6720610249,420,-3,-45,5,0,0,1,1,1,2,1,-1,1,2,0,5,5,0,0,0,0,-2,-2,2,1,3,1,0,0,0,0,0,-1,0,1
KR_6717830254,420,2,3,1,4,4,4,0,-6,2,8,3,5,2,4,7,3,-1,1,2,0,-4,9,7,3,10,0,0,1,1,1,1,-1,4,1
KR_6767322287,420,5,35,28,10,2,3,1,3,3,0,-3,0,3,6,6,0,2,2,0,1,14,-12,1,5,6,3,0,1,-1,1,1,1,2,1
KR_6468657736,420,4,108,5,17,1,1,0,1,4,3,6,7,1,7,7,0,2,2,0,1,15,-6,2,2,4,4,0,3,1,1,1,1,1,1
KR_6621039069,420,4,63,-13,2,4,4,0,1,1,0,-7,0,7,2,3,1,2,2,0,0,2,120,0,2,2,4,0,0,1,-1,1,-1,4,1
KR_6768343821,420,2,6,11,2,-1,1,2,1,6,5,1,3,2,1,1,0,0,1,1,1,5,74,1,2,3,23,0,0,-1,-1,-1,1,3,1
KR_6733338779,420,1,-15,-4,1,2,4,2,-1,2,3,-2,2,4,2,2,0,0,0,0,0,5,-36,3,4,7,24,0,0,-1,1,0,-1,6,1
KR_6765405255,420,1,61,0,1,2,2,0,-2,1,3,7,9,2,-2,0,2,-4,0,4,0,2,-17,-1,5,4,0,0,0,-1,1,-1,1,2,1
KR_6767263080,420,-1,67,0,-6,-1,2,3,-2,1,3,0,0,0,-3,1,4,0,0,0,0,-7,0,-2,4,2,2,0,0,1,1,0,1,6,1
KR_6684898830,420,0,61,11,0,1,2,1,-1,2,3,-4,1,5,5,10,5,-1,2,3,1,-8,16,0,7,7,-6,0,1,1,1,1,-1,5,1
KR_6725063357,420,5,29,-16,16,4,5,1,-6,2,8,9,10,1,8,8,0,1,2,1,0,20,-8,-6,8,2,4,0,1,0,-1,1,1,0,1
KR_6700347590,420,-3,-65,-1,-4,-5,0,5,1,3,2,-1,5,6,-1,4,5,2,2,0,0,1,-2,2,9,11,-2,0,-2,1,-1,-1,1,3,1
KR_6758075526,420,2,41,-29,-1,0,0,0,0,1,1,0,1,1,-2,2,4,1,1,0,1,0,-7,-1,6,5,-1,0,0,0,-1,0,1,0,1
KR_6748642216,420,1,-13,-28,8,0,1,1,5,5,0,0,3,3,2,3,1,1,3,2,0,8,0,-4,4,0,0,0,1,1,-1,1,1,4,1
KR_6636217009,420,3,34,40,6,0,0,0,-2,4,6,0,1,1,6,6,0,2,3,1,0,7,17,2,2,4,0,0,1,1,1,1,-1,2,1
KR_6642438503,420,2,17,8,4,5,6,1,-5,4,9,1,3,2,1,1,0,2,2,0,0,2,-36,2,6,8,13,0,1,-1,1,1,-1,3,1
KR_6625441084,420,0,103,-16,-4,0,2,2,-4,0,4,-3,4,7,6,6,0,-3,2,5,0,-8,-3,0,2,2,1,0,0,-1,-1,1,-1,4,1
KR_6710588733,420,4,-4,32,10,2,3,1,3,4,1,1,2,1,5,7,2,-1,0,1,0,16,54,5,2,7,-28,0,2,1,-1,1,1,4,1
KR_6720867947,440,-1,-53,-26,-5,3,5,2,-2,2,4,-3,4,7,-1,1,2,-2,1,3,0,-5,-3,2,4,6,1,0,-1,-1,1,-1,-1,4,1
KR_6674336336,440,2,36,-4,6,7,11,4,-6,0,6,3,3,0,0,2,2,2,5,3,1,10,-3,0,2,2,-1,0,2,-1,0,1,1,2,1
KR_6199619083,420,-1,-27,-8,3,-4,2,6,3,3,0,0,1,1,5,5,0,-1,0,1,0,6,2,-1,5,4,1,0,-2,1,-1,-1,-1,5,1
KR_6764499483,420,-1,20,-15,1,2,4,2,1,2,1,-1,2,3,1,8,7,-2,0,2,1,3,20,-2,5,3,-22,0,0,1,-1,0,1,2,1
KR_6706240586,420,3,30,3,2,1,4,3,2,5,3,-5,2,7,4,4,0,0,1,1,0,10,-6,3,4,7,-1,0,1,1,-1,1,1,6,1
KR_6736522404,420,2,24,16,-4,2,4,2,-2,2,4,2,4,2,-4,3,7,-2,0,2,-1,-16,14,-2,5,3,-2,0,0,1,1,1,-1,4,1
KR_6740040497,420,0,29,4,-2,2,2,0,-5,0,5,-3,1,4,8,9,1,-4,0,4,0,-2,-5,-4,6,2,3,0,1,0,-1,1,-1,0,1
KR_6723354561,420,5,67,43,-1,3,3,0,-1,1,2,0,1,1,-4,2,6,1,1,0,0,-1,-106,4,2,6,-1,0,0,1,1,1,-1,6,1
KR_6767815371,420,4,41,27,13,1,3,2,6,7,1,5,5,0,2,4,2,-1,1,2,0,13,15,2,3,5,0,0,3,-1,1,1,-1,4,1
KR_6729230187,440,1,66,0,-2,1,2,1,-2,2,4,-3,1,4,1,3,2,1,1,0,1,2,11,-2,5,3,0,0,0,-1,-1,0,1,3,1
KR_6631407942,420,3,-21,32,2,0,1,1,2,3,1,-1,2,3,1,5,4,0,1,1,0,-1,8,1,4,5,-4,0,0,1,1,0,1,6,1
KR_6674298578,420,0,-11,-4,-7,-7,1,8,-4,1,5,5,5,0,-3,1,4,2,2,0,0,-6,11,3,4,7,2,0,0,-1,-1,0,-1,1,1
KR_6684665543,420,-1,-22,-43,1,-3,0,3,8,11,3,-1,1,2,-3,1,4,0,1,1,0,8,-140,-1,6,5,2,0,0,1,1,0,-1,3,1
KR_6621097882,420,3,45,0,7,2,4,2,-2,4,6,5,5,0,3,6,3,-1,1,2,-1,2,-106,1,7,8,-1,0,-2,-1,-1,-1,-1,5,1
KR_6742104617,420,0,5,-8,-2,4,6,2,-4,1,5,1,3,2,-4,1,5,1,4,3,-2,-13,19,3,2,5,2,0,0,0,-1,0,-1,0,1
KR_6738688482,440,2,19,0,8,-2,2,4,2,2,0,2,2,0,5,7,2,1,2,1,0,13,-4,-2,6,4,8,0,0,1,1,1,1,1,1
KR_6759931952,440,2,-14,-4,4,6,7,1,0,0,0,-1,1,2,-1,1,2,0,1,1,0,3,-7,3,3,6,-2,0,0,0,0,0,-1,0,1
KR_6763245639,440,6,64,-2,22,10,10,0,0,1,1,-1,0,1,12,12,0,1,1,0,0,16,15,1,3,4,3,0,2,1,1,1,1,5,1
KR_6713928550,420,1,-10,17,-1,-2,0,2,-1,1,2,0,3,3,4,7,3,-2,0,2,0,6,7,1,4,5,4,0,0,1,-1,0,-1,5,1
KR_6758073075,420,3,33,11,4,1,2,1,0,2,2,-3,1,4,5,5,0,1,2,1,-1,2,2,-2,4,2,2,0,1,1,0,1,-1,4,1
KR_6764677736,440,-2,-39,-16,2,-1,0,1,-4,2,6,1,5,4,4,5,1,2,2,0,0,9,-360,-1,4,3,6,0,-1,-1,-1,-1,1,5,1
KR_6622641497,420,2,-15,7,1,3,3,0,-1,3,4,-4,2,6,3,5,2,0,0,0,0,-1,-25,-5,6,1,2,0,1,-1,1,1,-1,2,1
KR_6672686680,440,-1,-41,16,-4,5,5,0,6,8,2,-5,0,5,-3,1,4,-7,2,9,-1,-12,-14,-6,7,1,6,0,0,-1,1,0,-1,2,1
KR_6749063792,420,1,-50,30,5,5,5,0,4,7,3,4,7,3,-4,0,4,-4,1,5,1,7,7,1,3,4,-5,0,0,0,1,0,1,0,1
KR_6645798625,420,2,48,0,3,-5,0,5,-4,2,6,5,6,1,3,5,2,4,4,0,0,2,42,-4,7,3,-22,0,1,1,-1,1,-1,1,1
KR_6746273620,420,1,84,24,-4,5,6,1,-6,1,7,0,1,1,0,2,2,-3,0,3,0,-3,-320,2,4,6,2,0,1,-1,1,1,-1,2,1
KR_6725619883,420,3,-21,8,11,0,0,0,9,10,1,-2,1,3,2,7,5,2,2,0,0,13,-2,1,4,5,0,0,1,-1,0,1,1,6,1
KR_6719788543,420,3,35,16,1,3,3,0,-1,1,2,-2,2,4,1,1,0,0,1,1,0,1,1,-3,7,4,3,0,2,0,1,1,-1,0,1
KR_6725985616,440,0,-8,6,3,3,3,0,-1,3,4,-3,1,4,5,6,1,-1,1,2,0,3,0,-1,6,5,0,0,1,1,0,1,1,3,1
KR_6682860581,420,2,87,-31,9,4,4,0,-1,0,1,-2,0,2,8,9,1,0,1,1,1,7,-14,-1,6,5,8,0,0,1,-1,1,1,3,1
KR_6644361367,420,0,5,0,-2,0,3,3,1,4,3,-1,3,4,-2,7,9,0,0,0,1,-4,37,-3,7,4,-11,0,0,-1,0,-1,1,1,1
KR_6744129727,420,1,30,21,3,-3,0,3,6,10,4,2,2,0,-3,4,7,1,1,0,0,4,-123,0,4,4,0,0,0,1,1,0,-1,1,1
KR_6693045223,420,-1,-32,-12,0,-1,3,4,1,5,4,-3,3,6,2,5,3,1,1,0,0,8,-1,2,4,6,-3,0,-1,1,-1,-1,-1,6,1
KR_6767357676,420,1,36,-15,3,2,3,1,0,1,1,2,4,2,-3,1,4,2,2,0,0,0,0,-1,4,3,-4,0,0,-1,1,1,1,4,1
KR_6480290674,420,7,17,24,15,3,4,1,2,3,1,6,8,2,4,7,3,0,1,1,0,15,-7,2,1,3,1,0,1,1,-1,1,-1,1,1
KR_6716266751,420,6,112,50,12,3,4,1,4,4,0,4,5,1,-3,1,4,4,5,1,0,5,6,3,3,6,-5,0,1,1,-1,1,-1,1,1
KR_6756390210,420,1,-19,8,-2,-8,0,8,6,9,3,-4,1,5,4,5,1,0,1,1,0,-6,0,-5,8,3,2,0,-1,1,-1,-1,-1,4,1
KR_6767965956,420,0,-22,-5,-3,0,1,1,0,1,1,-3,2,5,0,2,2,0,1,1,0,-2,-315,1,3,4,1,0,-1,0,-1,-1,1,0,1
KR_6729593976,440,-5,-38,-31,-11,-5,0,5,0,3,3,-9,0,9,1,1,0,2,2,0,0,4,-2,1,2,3,-5,0,-1,0,0,-1,-1,0,1
KR_6603110189,420,-5,-139,-23,-9,-5,1,6,-3,5,8,0,3,3,-3,2,5,2,4,2,-1,7,240,2,5,7,-2,0,-1,1,-1,-1,-1,2,1
KR_6731462965,420,2,14,28,3,0,2,2,-1,1,2,4,4,0,1,3,2,-1,0,1,0,2,7,-2,5,3,5,0,-1,-1,1,1,1,2,1
KR_6754737802,420,0,-15,30,0,2,3,1,-3,2,5,-1,2,3,2,5,3,0,0,0,0,-1,-46,-3,8,5,30,0,-2,-1,-1,-1,-1,5,1
KR_6767482616,420,6,89,-3,17,8,8,0,8,10,2,2,4,2,5,5,0,-6,1,7,0,2,0,1,2,3,1,0,2,-1,-1,1,-1,2,1
KR_6728940115,420,-1,18,8,-7,1,3,2,-4,2,6,-6,1,7,0,2,2,2,2,0,-1,-11,15,5,4,9,-3,0,2,0,1,1,-1,0,1
KR_6698696533,420,2,44,0,5,-3,1,4,2,3,1,5,5,0,-3,2,5,4,5,1,2,15,2,-3,5,2,1,0,0,1,-1,-1,1,2,1
KR_6705298839,420,4,21,33,9,3,4,1,1,2,1,-1,2,3,0,1,1,6,6,0,0,11,-14,4,2,6,15,0,1,1,1,1,1,5,1
KR_6757993065,420,-1,-7,-38,-3,-3,1,4,-3,0,3,2,2,0,-1,0,1,2,2,0,0,0,-1,0,5,5,-2,0,0,0,-1,0,-1,0,1
KR_6739039250,420,4,67,7,14,2,3,1,0,1,1,7,8,1,5,7,2,0,1,1,0,15,6,3,1,4,0,0,1,1,1,1,1,6,1
KR_6482561192,420,2,-6,-9,5,-1,1,2,-2,3,5,4,6,2,1,3,2,3,3,0,0,13,-54,-6,9,3,0,0,2,1,-1,1,-1,2,1
KR_6751456031,420,1,3,-1,3,1,2,1,2,4,2,5,6,1,-1,2,3,-4,0,4,0,5,-25,4,5,9,1,0,-1,1,-1,-1,1,1,1
KR_6650632297,420,2,30,24,3,4,5,1,0,5,5,0,3,3,-1,1,2,0,1,1,-1,-1,220,0,4,4,-1,0,0,-1,1,1,-1,4,1
KR_6731468826,420,-3,53,-27,2,4,4,0,-1,0,1,3,3,0,-2,1,3,-2,0,2,1,1,-19,2,2,4,-2,0,0,1,1,0,1,6,1
KR_6730287890,420,7,138,11,18,3,3,0,1,5,4,6,8,2,9,10,1,-1,2,3,2,17,30,6,0,6,6,0,3,1,-1,1,1,1,1
KR_6736677406,440,1,21,-11,-6,-4,0,4,1,2,1,-2,2,4,-3,0,3,2,3,1,0,-12,-8,-3,8,5,2,0,1,-1,1,1,-1,1,1
KR_6673747368,420,3,103,-16,4,8,10,2,-7,0,7,-1,3,4,4,6,2,0,2,2,-2,-2,5,1,3,4,2,0,2,1,-1,1,-1,6,1
KR_6662446255,420,-2,-60,-20,-4,0,4,4,-2,0,2,-5,0,5,3,8,5,0,0,0,0,9,-2,5,2,7,-4,0,0,1,-1,-1,1,2,1
KR_6727584364,420,5,37,1,9,1,2,1,2,6,4,-1,1,2,2,2,0,5,5,0,-1,3,14,0,4,4,-1,0,3,1,1,1,-1,1,1
KR_6647474136,420,5,-2,-4,8,1,4,3,0,2,2,3,4,1,4,5,1,0,1,1,0,13,17,1,3,4,1,0,1,1,1,1,1,5,1
KR_6731827788,420,-3,-68,-20,0,0,2,2,-5,0,5,7,8,1,-1,5,6,-1,1,2,0,-5,-5,0,4,4,-2,0,-3,1,-1,-1,1,1,1
KR_6703099380,440,9,38,12,21,5,5,0,4,4,0,5,6,1,5,6,1,2,2,0,0,15,2,-2,4,2,4,0,1,1,1,1,1,2,1
KR_6616390111,440,4,92,8,1,3,3,0,-1,0,1,0,1,1,5,9,4,-6,3,9,0,-1,5,4,5,9,-5,0,1,-1,1,1,-1,4,1
KR_6520441860,420,3,50,14,12,3,3,0,7,10,3,0,0,0,1,1,0,1,1,0,0,13,-13,0,3,3,0,0,2,0,1,1,1,0,1
KR_6642345842,420,4,38,16,13,0,2,2,1,2,1,6,6,0,5,7,2,1,1,0,0,14,-14,0,5,5,3,0,2,1,1,1,1,5,1
KR_6767053326,420,-1,-23,-11,2,-1,0,1,-2,0,2,3,4,1,3,3,0,-1,0,1,0,4,57,1,2,3,3,0,0,1,-1,0,1,5,1
KR_6675783248,420,2,110,4,1,-1,2,3,5,6,1,-4,4,8,2,2,0,-1,0,1,0,2,350,2,8,10,-9,0,4,1,1,1,-1,3,1
KR_6767257402,420,-5,-26,16,-15,-3,3,6,-2,1,3,0,6,6,-8,0,8,-2,1,3,0,-18,-14,2,3,5,-2,0,0,-1,1,-1,-1,6,1
KR_6465234301,420,2,7,24,8,-2,0,2,4,6,2,3,4,1,3,5,2,0,1,1,-1,10,0,3,2,5,2,0,2,1,1,1,-1,3,1
KR_6763908623,420,5,12,4,9,-3,0,3,3,3,0,1,1,0,4,5,1,4,5,1,0,12,4,3,1,4,-1,0,-1,-1,-1,-1,1,6,1
KR_6652901938,420,1,14,-9,6,-2,2,4,3,4,1,3,6,3,0,2,2,2,2,0,-3,13,15,1,3,4,-7,0,0,1,0,0,-1,1,1
KR_6750282507,420,6,50,52,13,1,1,0,2,3,1,0,1,1,6,6,0,4,4,0,2,13,6,4,3,7,3,0,1,1,1,1,1,3,1
KR_6698861497,420,6,77,-21,16,1,2,1,6,8,2,7,8,1,1,2,1,1,1,0,1,20,-1,3,3,6,5,0,2,-1,-1,1,1,1,1
KR_6729647494,420,3,48,21,5,3,3,0,-3,1,4,7,7,0,-1,2,3,-1,0,1,0,0,11,4,2,6,-8,0,0,-1,-1,-1,-1,4,1
KR_6766235536,420,1,-47,-12,3,0,1,1,5,7,2,0,0,0,-1,6,7,-1,0,1,0,-6,19,-2,7,5,-2,0,1,-1,1,1,1,1,1
KR_6709115631,420,-1,-23,-4,-3,0,0,0,4,8,4,-4,2,6,0,2,2,-3,0,3,-1,-5,-3,3,5,8,-1,0,-1,1,-1,-1,-1,3,1
KR_6730880669,420,3,12,12,9,4,4,0,5,6,1,0,2,2,0,0,0,0,1,1,0,8,87,6,3,9,9,0,-1,1,-1,-1,1,5,1
KR_6764552614,420,6,103,31,15,0,0,0,0,0,0,7,7,0,5,5,0,3,3,0,0,8,7,2,2,4,-3,0,2,1,1,1,1,4,1
KR_6758489928,420,2,70,-4,6,2,3,1,-1,0,1,4,5,1,0,2,2,1,1,0,0,1,32,-4,6,2,-26,0,1,0,1,1,1,0,1
KR_6466355176,420,1,-12,7,10,2,2,0,1,6,5,-1,3,4,7,8,1,1,2,1,1,14,-10,2,2,4,-3,0,0,0,0,0,1,0,1
KR_6621354662,420,7,36,6,19,2,2,0,7,8,1,4,6,2,5,5,0,1,3,2,0,16,-1,3,4,7,3,0,1,1,-1,1,1,5,1
KR_6762222976,420,-1,19,-13,-2,1,1,0,-2,0,2,3,7,4,-6,1,7,2,2,0,0,-13,-3,1,0,1,2,0,3,-1,1,1,1,2,1
KR_6742968255,420,-3,-35,-21,-3,-3,3,6,-5,2,7,4,4,0,1,4,3,0,1,1,0,-1,2,-4,9,5,3,0,0,0,-1,0,1,0,1
KR_6748583138,420,2,80,-28,7,1,2,1,6,6,0,4,7,3,-4,1,5,0,3,3,1,7,16,4,2,6,3,0,0,-1,1,1,1,5,1
KR_6663505188,420,1,42,8,-1,5,8,3,2,3,1,-4,0,4,-3,1,4,-1,0,1,0,-10,1,4,2,6,-3,0,0,-1,1,-1,1,6,1
KR_6633158915,440,8,94,11,23,3,4,1,11,13,2,3,5,2,0,2,2,6,8,2,2,24,24,4,4,8,-1,0,3,-1,1,1,1,1,1
KR_6648547574,420,2,48,-16,4,5,5,0,2,3,1,0,2,2,-1,4,5,-2,0,2,0,0,4,3,1,4,-1,0,0,1,0,-1,1,3,1
KR_6582633874,420,0,-31,31,-6,0,3,3,0,2,2,1,3,2,-6,1,7,-1,2,3,-1,-14,-6,0,4,4,2,0,0,0,-1,0,-1,0,1
KR_6723183892,420,1,13,-20,-6,-3,1,4,0,1,1,-1,0,1,-3,1,4,1,1,0,0,-4,5,1,5,6,-2,0,0,-1,-1,0,-1,3,1
KR_6632816120,420,-2,56,-20,-2,-1,0,1,2,2,0,0,2,2,-1,1,2,-2,1,3,0,-1,-1,5,2,7,-4,0,0,-1,1,1,1,2,1
KR_6723245944,420,2,6,4,1,0,0,0,0,5,5,-4,0,4,1,3,2,4,4,0,0,8,37,-2,5,3,25,0,0,1,1,0,-1,6,1
KR_6730310305,420,4,92,-17,3,1,1,0,1,5,4,-4,0,4,6,6,0,-1,1,2,0,7,5,1,3,4,3,0,0,-1,-1,1,-1,4,1
KR_6659900566,420,8,62,99,13,2,3,1,4,4,0,2,3,1,5,5,0,0,1,1,1,11,7,-1,6,5,0,0,2,1,1,1,1,4,1
KR_6752594348,420,-1,23,-20,1,1,2,1,-1,2,3,0,1,1,2,2,0,-1,0,1,0,3,-2,-2,6,4,2,0,-1,1,-1,-1,-1,6,1
KR_6752994919,420,2,-28,-25,-3,2,2,0,2,4,2,1,4,3,-7,0,7,-1,0,1,0,1,13,5,3,8,-9,0,1,1,-1,-1,-1,5,1
KR_6737839409,420,2,59,-27,2,3,4,1,1,5,4,0,3,3,-2,1,3,0,0,0,0,-1,1,2,4,6,0,0,1,-1,1,1,-1,6,1
KR_6733485708,420,1,12,15,-2,1,2,1,2,4,2,-2,0,2,-3,2,5,0,2,2,0,1,40,-1,5,4,-10,0,1,-1,1,1,-1,5,1
KR_6758245753,440,-3,-46,-12,-2,-1,3,4,-3,0,3,-4,2,6,5,5,0,1,3,2,0,3,57,0,4,4,-19,0,-2,1,-1,-1,1,3,1
KR_6660130810,420,0,96,-12,4,3,3,0,4,7,3,1,3,2,-3,1,4,-1,2,3,0,3,-4,-4,8,4,0,0,-1,-1,1,-1,-1,1,1
KR_6767963491,420,-1,-9,4,3,-2,1,3,3,5,2,2,2,0,0,2,2,0,0,0,0,5,81,-3,6,3,8,0,1,1,-1,1,-1,6,1
KR_6747905132,440,-1,-69,8,-1,0,0,0,1,2,1,0,4,4,-1,2,3,-1,1,2,2,3,1,3,3,6,-2,0,0,1,-1,0,1,2,1
KR_6687706818,420,0,-20,3,7,0,3,3,1,2,1,3,5,2,2,2,0,1,1,0,0,9,7,4,3,7,0,0,1,-1,1,1,1,5,1
KR_6735693358,420,-1,35,-32,1,-3,1,4,1,4,3,0,5,5,3,4,1,0,3,3,1,14,-310,-4,6,2,-3,0,0,-1,-1,0,1,5,1
KR_6759764978,420,0,61,-11,3,-1,2,3,-2,2,4,0,5,5,6,6,0,0,1,1,0,1,0,-1,4,3,0,0,0,1,-1,0,1,2,1
KR_6725336053,420,2,-16,4,14,1,2,1,6,6,0,-2,3,5,3,3,0,6,6,0,0,14,2,2,3,5,2,0,1,1,-1,1,1,3,1
KR_6762476997,420,1,60,-36,9,2,5,3,-1,3,4,3,3,0,5,6,1,0,0,0,0,17,7,-2,6,4,2,0,2,-1,1,1,1,1,1
KR_6731295394,420,1,-36,6,3,3,6,3,0,5,5,2,4,2,-2,1,3,0,0,0,0,8,-29,-6,7,1,0,0,2,-1,-1,1,1,5,1
KR_6728176403,420,-1,17,7,-4,-1,1,2,8,9,1,-6,0,6,-4,1,5,-1,0,1,-1,-5,6,-1,3,2,1,0,-1,1,-1,-1,-1,4,1
KR_6761367476,420,2,27,20,-4,0,2,2,0,1,1,3,5,2,-6,1,7,-1,0,1,0,-6,-11,-5,7,2,5,0,0,1,1,0,-1,4,1
KR_6719146853,440,1,20,17,0,4,4,0,0,4,4,-2,2,4,-2,1,3,0,2,2,0,2,-10,-2,5,3,-1,0,1,-1,-1,1,-1,4,1
KR_6760348805,420,3,20,-20,6,3,3,0,1,4,3,-1,2,3,4,4,0,-1,1,2,0,6,39,-2,5,3,-14,0,2,0,-1,1,-1,0,1
KR_6741715634,420,0,0,4,-1,6,6,0,-3,3,6,-4,1,5,0,2,2,0,1,1,-1,-4,-31,2,5,7,12,0,0,-1,-1,1,-1,6,1
KR_6758205860,420,1,61,9,9,0,0,0,1,2,1,3,4,1,3,6,3,2,3,1,1,5,5,2,6,8,2,0,0,0,-1,0,1,0,1
KR_6742403535,420,3,23,-24,1,2,3,1,-1,2,3,-5,2,7,5,5,0,0,1,1,1,4,-3,0,3,3,2,0,2,-1,-1,1,1,4,1
KR_6659453215,420,4,39,-4,10,5,7,2,1,5,4,3,5,2,0,2,2,1,1,0,0,14,13,2,2,4,0,0,0,1,1,1,-1,1,1
KR_6758675478,420,7,49,28,10,3,3,0,-3,5,8,-1,2,3,7,7,0,4,5,1,0,8,10,1,1,2,0,0,3,1,1,1,1,5,1
KR_6698740914,440,0,0,3,8,-1,4,5,1,2,1,1,5,4,6,8,2,1,4,3,0,10,-29,2,3,5,15,0,1,0,1,1,-1,0,1
KR_6722844276,420,4,48,32,6,-2,3,5,4,5,1,1,1,0,2,5,3,1,1,0,1,9,3,0,5,5,2,0,-1,1,-1,-1,1,6,1
KR_6676954776,420,-1,29,-26,-8,1,2,1,2,2,0,-7,0,7,-3,2,5,-1,0,1,-1,-9,-1,-3,5,2,-4,0,-1,1,0,-1,-1,3,1
KR_6724627061,420,8,54,36,18,5,7,2,3,5,2,11,11,0,1,2,1,-2,2,4,0,8,-32,2,1,3,11,0,3,1,1,1,1,2,1
KR_6698661556,420,0,25,-33,9,-2,2,4,2,4,2,8,9,1,-1,0,1,2,2,0,2,15,-3,-2,4,2,1,0,1,1,1,1,1,1,1
KR_6669839037,420,3,78,-28,7,0,1,1,1,3,2,5,7,2,1,2,1,0,0,0,-2,-1,-7,-3,6,3,0,0,0,-1,-1,1,-1,2,1
KR_6766532264,440,5,87,16,3,-4,0,4,1,1,0,2,3,1,0,2,2,4,4,0,0,5,0,-3,5,2,3,0,1,1,0,1,-1,1,1
KR_6573244492,420,2,21,19,8,-5,1,6,3,3,0,1,3,2,5,6,1,4,4,0,-1,11,18,3,6,9,-3,0,0,1,-1,1,-1,1,1
KR_6733666900,420,3,95,16,8,-1,3,4,1,1,0,4,4,0,5,7,2,-1,0,1,-1,4,-1,3,2,5,0,0,0,1,-1,-1,1,1,1
KR_6762450329,440,5,78,39,8,1,3,2,5,7,2,3,6,3,-1,0,1,0,2,2,0,16,-1,2,3,5,0,0,1,0,1,1,1,0,1
KR_6687329918,420,3,11,17,4,4,4,0,2,4,2,-2,1,3,1,7,6,-1,1,2,-1,-2,2,3,2,5,-1,0,2,1,1,1,1,6,1
KR_6764963339,420,1,31,-4,1,-2,0,2,3,5,2,0,0,0,-1,1,2,1,2,1,0,1,49,1,7,8,-33,0,0,0,0,0,-1,0,1
KR_6759461969,420,1,60,-5,-2,7,8,1,-3,0,3,-5,2,7,0,3,3,-1,2,3,0,-14,38,-1,5,4,-18,0,2,-1,1,1,1,6,1
KR_6745081392,420,7,38,-7,8,3,4,1,3,5,2,0,6,6,5,7,2,-3,1,4,1,5,19,1,0,1,3,1,1,1,1,1,1,2,1
KR_6700219413,420,2,39,8,5,1,1,0,0,2,2,0,2,2,3,5,2,1,1,0,0,4,-67,2,6,8,-14,0,-1,1,-1,-1,1,5,1
KR_6661485809,420,4,72,-8,6,3,4,1,0,4,4,-1,1,2,2,3,1,2,2,0,0,4,-1,2,4,6,3,0,1,1,0,1,-1,4,1
KR_6607654148,440,1,-11,28,-1,2,2,0,0,3,3,-3,1,4,-1,4,5,1,1,0,0,1,-3,0,5,5,4,0,-2,0,-1,-1,1,0,1
KR_6623987788,420,-2,70,-22,-1,-1,2,3,-2,0,2,-1,1,2,4,4,0,-1,1,2,0,-9,-114,-1,6,5,2,0,1,1,0,1,1,5,1
KR_6746536615,420,5,36,13,3,0,3,3,-3,2,5,2,5,3,3,3,0,1,1,0,-1,0,-3,1,2,3,0,0,1,1,1,1,-1,1,1
KR_6495689892,420,1,31,-4,7,-1,1,2,0,0,0,0,1,1,2,2,0,6,6,0,0,6,-43,-5,6,1,24,0,1,1,1,1,-1,6,1
KR_6648206022,420,-1,-96,27,-1,-2,2,4,0,2,2,1,4,3,-1,2,3,1,2,1,0,0,4,4,3,7,-1,0,1,1,-1,1,-1,3,1
KR_6629570898,420,0,-8,-1,-4,-8,1,9,4,5,1,-2,1,3,2,3,1,0,0,0,0,3,-2,-6,8,2,4,0,0,1,1,-1,1,5,1
KR_6666162267,420,4,54,28,3,3,3,0,2,4,2,2,2,0,-3,0,3,-1,0,1,1,0,-25,3,3,6,0,0,0,-1,1,1,1,2,1
KR_6759968096,420,2,14,12,2,-2,2,4,2,4,2,4,4,0,-7,2,9,5,6,1,0,3,7,3,4,7,0,0,0,1,1,1,1,3,1
KR_6724901834,420,4,58,27,11,5,5,0,1,5,4,-5,4,9,10,10,0,0,0,0,0,13,-12,-2,8,6,6,0,1,-1,1,1,-1,1,1
KR_6766132247,420,1,26,32,-1,0,1,1,2,4,2,2,3,1,-6,1,7,1,2,1,-1,1,-4,-1,7,6,-1,0,-1,1,1,-1,-1,4,1
KR_6741668166,420,1,44,-3,4,1,2,1,1,6,5,-2,0,2,3,3,0,1,1,0,0,8,6,4,3,7,-3,0,1,1,1,1,1,2,1
KR_6708462246,420,2,-1,12,6,2,3,1,8,9,1,-1,4,5,-4,1,5,1,2,1,0,10,13,6,5,11,-7,0,0,1,1,0,1,1,1
KR_6702560965,420,0,34,0,2,1,2,1,5,8,3,-3,1,4,-1,0,1,0,1,1,0,4,36,2,3,5,-30,0,0,-1,0,0,-1,3,1
KR_6733668539,420,-3,-112,-24,-5,0,1,1,-3,0,3,1,4,3,-3,2,5,0,1,1,0,1,-11,0,3,3,0,0,0,0,-1,-1,-1,0,1
KR_6750181676,420,4,112,-6,8,2,2,0,0,2,2,-1,1,2,8,10,2,-1,2,3,0,3,-6,-1,7,6,3,0,1,0,1,1,1,0,1
KR_6703665080,420,3,20,48,-2,0,1,1,1,2,1,-3,0,3,0,3,3,0,0,0,-1,-2,-10,-2,8,6,-1,0,-1,-1,-1,-1,-1,1,1
KR_6767299464,420,2,66,-24,13,0,3,3,2,3,1,4,4,0,4,5,1,3,3,0,2,11,-341,2,3,5,-3,0,3,1,-1,1,1,4,1
