matchId,queueId,Diff_LV,Diff_CS,Diff_jglCS,Diff-K,Diff-K-top,K-WIN-top,K-LOSE-top,Diff-K-jug,K-WIN-jug,K-LOSE-jug,Diff-K-mid,K-WIN-mid,K-LOSE-mid,Diff-K-ad,K-WIN-ad,K-LOSE-ad,Diff-K-sup,K-WIN-sup,K-LOSE-sup,invadeKill,Diff-A,Diff_WARDplaced,Diff-ControlWARDplaced,LOSE_controlWARDPlaced,WIN_controlWARDPlaced,Diff_WARDkill,Diff_Inhibitor,Diff_TOWERkill,Diff_FirstDRAGON,Diff_FirstHERALD,Diff_Firsttower,Diff_FirstBLOOD,dragonType,result
KR_6763223052,440,0,27,-40,0,-2,4,2,1,3,4,1,1,2,3,3,6,-3,4,-1,0,3,-1,1,-4,3,-2,0,0,1,-1,1,1,3,-1
KR_6763758113,420,-3,-8,-32,-6,-2,3,1,-3,3,0,-2,3,1,2,2,4,-1,3,-2,0,1,0,5,-5,0,-1,0,0,1,1,0,-1,5,-1
KR_6726632713,420,-3,-88,27,-10,-4,4,0,-6,8,2,3,1,4,-2,4,2,-1,2,-1,0,8,-3,-2,-2,4,3,0,-2,1,-1,-1,-1,6,-1
KR_6726817558,440,-3,-36,-23,0,-2,3,1,6,1,7,-1,2,1,0,6,6,-3,4,-1,-1,-5,0,2,-5,3,-2,0,-1,1,0,-1,-1,5,-1
KR_6750452809,420,-2,-66,2,-2,0,0,0,-1,2,1,3,1,4,-2,4,2,-2,2,0,0,5,-49,-2,-3,5,-26,0,0,-1,0,-1,-1,5,-1
KR_6758544420,420,-4,-2,-24,-13,-1,1,0,2,2,4,-9,9,0,-2,6,4,-3,3,0,1,14,0,-3,-2,5,0,0,0,0,-1,0,1,0,-1
KR_6755306063,420,0,-24,0,0,-1,2,1,4,0,4,-1,5,4,-2,4,2,0,1,-1,0,-1,41,2,-5,3,22,0,0,0,0,0,-1,0,-1
KR_6632772822,420,0,-46,28,-3,-1,5,4,3,0,3,-1,3,2,-3,5,2,-1,3,-2,0,-1,-15,-2,-4,6,-2,0,0,1,1,-1,-1,1,-1
KR_6620519272,420,3,-9,-28,0,0,6,6,3,2,5,0,2,2,-1,3,2,-2,2,0,-2,-7,3,-1,-3,4,-2,0,-1,1,-1,-1,-1,4,-1
KR_6565363136,420,-1,-34,-8,3,0,2,2,-1,4,3,-2,3,1,7,0,7,-1,1,0,1,-9,-2,-2,-1,3,-3,0,1,1,1,1,1,5,-1
KR_6748688099,420,-2,-20,3,-6,-2,2,0,-1,3,2,0,1,1,-1,3,2,-2,2,0,1,3,-26,0,-6,6,2,0,0,-1,1,0,1,6,-1
KR_6732335317,420,0,34,-3,-1,1,0,1,0,5,5,1,0,1,-2,2,0,-1,1,0,0,6,13,-1,-1,2,0,0,0,-1,-1,0,1,4,-1
KR_6739063897,420,-1,10,-4,-2,2,1,3,-2,4,2,-3,5,2,2,1,3,-1,1,0,0,11,-53,4,-5,1,-1,0,0,-1,1,1,-1,4,-1
KR_6754197195,420,-4,-3,4,-7,1,1,2,-5,6,1,2,2,4,-1,3,2,-4,4,0,0,7,-12,0,-5,5,3,0,0,-1,0,0,1,1,-1
KR_6579916424,420,-1,-27,24,6,8,0,8,1,4,5,-3,5,2,0,3,3,0,1,-1,1,-2,15,3,-6,3,-2,0,1,1,1,1,1,4,-1
KR_6738453333,420,-2,20,3,-3,5,2,7,0,0,0,-5,6,1,-1,3,2,-2,2,0,0,0,0,0,-2,2,2,0,-1,-1,-1,-1,1,4,-1
KR_6761395132,420,-4,-49,-32,-3,1,0,1,-2,4,2,-1,1,0,-1,2,1,0,1,-1,0,1,13,3,-6,3,6,0,-1,-1,0,-1,-1,1,-1
KR_6743616393,420,-4,-65,-12,-10,1,0,1,-1,1,0,-3,6,3,-3,3,0,-4,4,0,0,14,-8,-6,-3,9,2,0,-2,-1,-1,-1,-1,5,-1
KR_6613103318,420,-4,-66,-24,-3,-2,5,3,4,2,6,-5,6,1,1,2,3,-1,1,0,0,-1,-5,1,-7,6,3,0,0,-1,1,0,-1,5,-1
KR_6733619900,420,-3,-26,3,-13,-2,3,1,-5,5,0,-3,3,0,-3,3,0,0,0,0,0,13,-17,-5,-1,6,2,0,-1,-1,-1,-1,-1,2,-1
KR_6759397181,420,0,-34,16,3,-2,2,0,-1,3,2,0,3,3,4,3,7,2,0,-2,0,-14,12,-1,-4,5,0,0,1,-1,1,1,-1,4,-1
KR_6758283360,420,-3,46,-14,-12,-2,2,0,-1,2,1,-5,5,0,-3,3,0,-1,1,0,-2,13,-15,3,-5,2,0,0,1,-1,1,1,-1,3,-1
KR_6668765635,420,-7,-154,4,-6,-3,3,0,-1,2,1,-2,2,0,0,1,1,0,0,0,0,2,-8,0,-3,3,-2,0,-2,-1,1,-1,-1,4,-1
KR_6733288879,440,-5,-116,-15,-17,0,1,1,-4,4,0,-3,5,2,-11,13,2,1,0,-1,0,23,-25,-5,-2,7,3,0,-1,1,-1,-1,-1,3,-1
KR_6756892755,420,-1,-20,-8,-2,0,2,2,-2,4,2,0,2,2,1,5,6,-1,1,0,0,-2,-3,-2,-3,5,1,0,1,0,1,1,-1,0,-1
KR_6700571106,420,-3,-45,-36,-8,0,1,1,1,1,2,-9,10,1,0,4,4,0,1,-1,2,1,-10,-3,-3,6,1,0,-1,-1,1,-1,1,6,-1
KR_6701436763,420,0,-37,-25,1,2,0,2,-7,8,1,2,0,2,3,2,5,1,0,-1,0,-6,1,1,-3,2,5,0,-1,-1,1,-1,-1,3,-1
KR_6689370502,420,-3,-30,-32,-6,-3,3,0,-3,4,1,3,1,4,-2,8,6,-1,2,-1,-2,8,-18,-2,-4,6,-3,0,0,-1,1,1,-1,2,-1
KR_6717194005,420,0,-55,20,-1,1,0,1,3,0,3,1,2,3,-3,4,1,-3,4,-1,0,7,-1,-2,-3,5,1,0,-2,1,0,-1,1,5,-1
KR_6458180474,420,1,0,-5,-3,1,2,3,-5,6,1,1,4,5,-1,1,0,1,0,-1,0,4,186,1,-4,3,-2,0,0,1,1,0,-1,1,-1
KR_6672249784,420,1,10,0,4,0,0,0,2,4,6,0,2,2,1,1,2,1,0,-1,0,-7,-37,-4,-1,5,-31,0,0,1,1,0,1,5,-1
KR_6607673998,420,-1,56,-22,4,3,0,3,1,3,4,-2,3,1,2,1,3,0,2,-2,0,2,-13,-1,-5,6,2,0,0,-1,-1,1,1,2,-1
KR_6762532882,420,-1,-22,5,-4,2,3,5,0,4,4,1,2,3,-5,8,3,-2,3,-1,-3,11,4,2,-6,4,3,0,-1,1,1,-1,-1,6,-1
KR_6756745203,420,-10,-40,-43,-22,-9,9,0,-2,5,3,-3,4,1,-7,7,0,-1,1,0,0,14,1,0,-6,6,4,0,-3,-1,-1,-1,-1,5,-1
KR_6692540933,420,-2,-63,8,2,-2,3,1,-3,6,3,-1,2,1,4,1,5,4,2,-6,1,-1,-6,-2,-5,7,-2,0,-1,-1,-1,-1,1,4,-1
KR_6729026502,420,3,66,-12,3,4,0,4,-2,4,2,-5,7,2,3,2,5,3,0,-3,1,1,0,0,-3,3,-2,0,0,0,-1,0,1,0,-1
KR_6726697985,420,-1,-45,-8,3,-1,1,0,1,1,2,-2,3,1,2,2,4,3,0,-3,0,-3,5,4,-11,7,5,0,-1,-1,1,-1,1,2,-1
KR_6707571122,420,0,5,-24,-2,-3,3,0,4,1,5,-2,3,1,-2,3,1,1,1,-2,0,-6,-312,4,-8,4,7,0,-1,-1,-1,-1,-1,5,-1
KR_6712781787,420,2,33,47,1,-1,1,0,1,1,2,2,0,2,-1,2,1,0,0,0,0,0,-16,-2,-2,4,2,0,0,1,-1,0,1,2,-1
KR_6662717113,420,-3,-59,-5,-9,-2,3,1,-5,6,1,-1,2,1,-1,2,1,0,1,-1,-2,5,-34,1,-5,4,0,0,-1,-1,-1,-1,-1,4,-1
KR_6763798798,420,1,-11,-8,1,-2,2,0,-2,2,0,4,0,4,0,3,3,1,2,-3,0,-1,23,1,-5,4,0,0,-1,1,-1,-1,1,3,-1
KR_6760458464,420,4,-5,-40,7,1,3,4,3,1,4,2,1,3,1,1,2,0,0,0,0,-6,-8,5,-5,0,-1,0,1,0,-1,1,1,0,-1
KR_6760376259,420,-2,-68,2,-2,-1,3,2,4,1,5,-6,7,1,4,1,5,-3,3,0,3,-8,10,4,-5,1,-2,0,0,-1,-1,0,1,6,-1
KR_6697615315,420,2,-29,-12,-2,4,0,4,-4,4,0,0,1,1,-1,4,3,-1,2,-1,0,8,-262,1,-5,4,0,0,0,-1,0,0,1,1,-1
KR_6733782366,420,-2,9,-24,-4,-1,2,1,-6,6,0,-4,4,0,4,1,5,3,1,-4,0,3,0,-3,-2,5,-5,0,0,-1,-1,0,1,5,-1
KR_6757903161,440,2,12,1,2,-2,2,0,-1,4,3,-2,5,3,1,4,5,6,1,-7,0,-9,1,2,-5,3,2,0,1,-1,-1,1,1,3,-1
KR_6673431240,420,-4,-5,-16,-7,-1,2,1,-1,4,3,1,2,3,-3,3,0,-3,3,0,0,6,-2,-2,-1,3,-2,0,0,-1,0,0,1,6,-1
KR_6632063946,420,-4,-84,10,-3,-1,4,3,-3,4,1,1,2,3,1,0,1,-1,2,-1,0,0,-15,2,-5,3,-1,0,0,0,-1,-1,1,0,-1
KR_6757423390,420,0,-25,-29,-1,-2,2,0,1,1,2,1,1,2,-2,5,3,1,0,-1,-2,7,7,-4,-3,7,-1,0,0,-1,1,0,1,2,-1
KR_6660902924,440,1,-52,-6,3,-1,1,0,1,1,2,0,1,1,3,1,4,0,1,-1,0,-1,8,4,-7,3,0,0,1,-1,0,1,-1,4,-1
KR_6760795300,440,-1,-68,-12,0,3,1,4,-1,1,0,1,1,2,-2,2,0,-1,3,-2,0,-4,-4,-2,-3,5,1,0,-1,1,-1,-1,1,1,-1
KR_6749127299,440,-1,-37,1,-1,-3,4,1,-2,2,0,12,0,12,-5,5,0,-3,4,-1,0,-3,-3,3,-5,2,-3,0,0,-1,1,-1,1,4,-1
KR_6741356821,420,-4,-31,-37,-12,-3,5,2,-3,6,3,-5,6,1,-1,2,1,0,1,-1,0,8,3,1,-3,2,3,0,-3,-1,-1,-1,1,3,-1
KR_6763708742,420,-1,-78,-27,1,-7,10,3,2,3,5,0,4,4,8,1,9,-2,2,0,-1,-2,1,-1,-8,9,2,0,0,-1,-1,-1,-1,3,-1
KR_6728162490,420,-3,-1,-32,-8,-4,5,1,-2,6,4,-1,2,1,0,1,1,-1,2,-1,0,6,13,1,-5,4,0,0,-1,0,-1,-1,-1,0,-1
KR_6689945635,420,0,-48,49,-1,0,2,2,-1,5,4,2,1,3,2,1,3,-4,4,0,0,5,-33,0,-3,3,-3,0,0,1,-1,-1,1,6,-1
KR_6625931133,420,-2,-25,-44,-5,0,1,1,0,1,1,2,1,3,-6,6,0,-1,2,-1,0,10,3,2,-4,2,3,0,0,1,-1,-1,-1,5,-1
KR_6674364925,420,-4,-48,-36,-9,-5,5,0,-2,2,0,-2,3,1,1,4,5,-1,1,0,0,-2,48,-1,-2,3,21,0,-1,-1,-1,1,1,4,-1
KR_6720258814,420,-3,-34,5,0,-5,7,2,-4,6,2,1,0,1,6,0,6,2,1,-3,0,-8,0,6,-9,3,0,0,0,1,-1,0,-1,6,-1
KR_6761142960,420,0,6,33,-2,2,2,4,-1,1,0,1,0,1,-3,4,1,-1,2,-1,0,6,0,-3,-1,4,1,0,1,-1,1,1,1,1,-1
KR_6747119445,420,1,-3,36,-3,1,0,1,-1,1,0,-1,2,1,-1,1,0,-1,1,0,0,2,4,3,-5,2,1,0,0,-1,1,0,-1,1,-1
KR_6703743156,420,-6,-15,0,-11,-2,2,0,-1,4,3,-2,6,4,-6,6,0,0,1,-1,1,13,-1,0,-4,4,2,0,0,-1,1,0,1,2,-1
KR_6729010142,440,-4,19,6,-7,-2,2,0,-7,7,0,4,0,4,0,1,1,-2,2,0,0,3,5,2,-7,5,1,0,0,1,1,-1,-1,1,-1
KR_6657243705,420,-2,-28,23,-5,1,2,3,-1,4,3,-3,4,1,2,4,6,-4,4,0,-1,7,-9,-2,-4,6,2,0,1,-1,0,1,-1,1,-1
KR_6752383145,420,-5,2,-32,-11,-1,1,0,-6,6,0,-1,2,1,-2,2,0,-1,2,-1,0,14,-33,-1,-4,5,2,0,-1,-1,-1,-1,1,1,-1
KR_6712299127,420,1,-23,-21,-5,1,1,2,-7,9,2,-3,5,2,5,2,7,-1,2,-1,0,4,-2,-6,-3,9,0,0,0,-1,-1,0,1,3,-1
KR_6709083543,420,-7,-35,-8,-17,-2,3,1,-6,6,0,1,1,2,-9,10,1,-1,2,-1,-1,20,15,3,-10,7,8,0,-2,-1,-1,-1,-1,1,-1
KR_6750185770,440,-1,-61,-11,-2,-1,3,2,0,3,3,1,3,4,-2,4,2,0,0,0,-1,0,57,2,-6,4,0,0,0,0,0,0,-1,0,-1
KR_6755837130,420,-2,13,4,-5,-2,2,0,-1,2,1,0,3,3,-1,1,0,-1,2,-1,0,4,-8,-7,0,7,-1,0,-3,-1,-1,-1,1,4,-1
KR_6752240731,420,-3,-1,14,-12,-2,2,0,-4,4,0,-2,5,3,-4,5,1,0,1,-1,0,10,-20,-4,-2,6,1,0,-1,-1,1,-1,-1,2,-1
KR_6714256973,420,-7,-40,-76,-5,-1,3,2,-2,2,0,-6,6,0,4,0,4,0,2,-2,-1,2,15,2,-6,4,1,0,-2,-1,-1,-1,-1,5,-1
KR_6654629687,420,1,-2,-4,-4,6,0,6,-6,6,0,-1,3,2,-3,3,0,0,0,0,0,8,-24,-2,-2,4,6,0,0,-1,1,0,-1,5,-1
KR_6647104987,420,0,-5,0,0,-2,4,2,1,2,3,0,1,1,1,3,4,0,1,-1,0,4,5,2,-4,2,0,0,-1,1,-1,-1,1,4,-1
KR_6739324012,440,3,11,28,7,1,1,2,3,0,3,2,0,2,-3,5,2,4,1,-5,0,-2,-28,-4,-3,7,-5,0,0,-1,1,0,-1,5,-1
KR_6742373975,420,-2,-68,-5,-8,-3,3,0,-1,4,3,-3,3,0,-1,3,2,0,1,-1,0,8,0,-2,-4,6,2,0,0,-1,1,0,-1,1,-1
KR_6725916804,420,-4,-48,-28,-1,-1,3,2,0,3,3,0,4,4,1,2,3,-1,2,-1,0,-7,-13,-2,-3,5,-2,0,0,-1,1,-1,1,3,-1
KR_6737230432,420,-6,4,-24,-8,1,2,3,0,3,3,-2,4,2,-4,4,0,-3,3,0,0,10,42,-4,-2,6,17,0,-1,1,-1,-1,-1,5,-1
KR_6728519635,420,0,-31,0,-1,-1,2,1,0,1,1,0,4,4,-1,1,0,1,0,-1,0,7,-18,-1,-5,6,-1,0,0,1,-1,0,1,6,-1
KR_6714940544,420,1,5,22,-6,-1,4,3,1,2,3,1,6,7,-3,5,2,-4,6,-2,-1,7,-15,2,-8,6,3,0,-1,1,-1,-1,-1,6,-1
KR_6758147745,420,-1,-81,-8,-2,-2,4,2,0,0,0,1,2,3,-2,5,3,1,0,-1,0,-5,12,3,-7,4,6,0,0,-1,-1,0,-1,6,-1
KR_6530946837,420,2,52,-4,4,0,2,2,0,1,1,0,1,1,2,1,3,2,1,-3,0,-7,3,-1,-5,6,4,0,0,-1,1,0,-1,1,-1
KR_6706580305,440,3,48,12,4,5,0,5,3,2,5,-6,8,2,2,0,2,0,0,0,0,-1,-2,-3,-1,4,1,0,0,-1,-1,-1,1,4,-1
KR_6712035549,420,-4,-65,24,-15,-2,2,0,1,2,3,-5,6,1,-5,5,0,-4,6,-2,0,16,0,0,-3,3,-2,0,0,-1,1,0,-1,4,-1
KR_6752798419,420,0,1,-20,1,2,1,3,-8,8,0,6,1,7,3,1,4,-2,2,0,-1,-4,8,1,-5,4,3,0,1,-1,1,1,-1,6,-1
KR_6681569840,420,3,19,-17,1,0,1,1,1,5,6,0,1,1,1,1,2,-1,1,0,0,-2,4,3,-5,2,0,0,1,-1,1,1,1,4,-1
KR_6736671224,440,1,31,1,2,2,1,3,-5,8,3,-2,3,1,7,0,7,0,1,-1,0,-6,-12,-3,-5,8,0,0,2,1,1,1,1,6,-1
KR_6716071155,420,-5,-66,0,-15,-6,7,1,-1,2,1,-3,3,0,-5,6,1,0,0,0,0,12,2,-3,-3,6,1,0,-1,-1,-1,-1,-1,5,-1
KR_6754259347,420,-5,-41,-39,-10,-2,5,3,1,2,3,-2,4,2,-5,5,0,-2,3,-1,0,13,4,3,-7,4,8,0,0,-1,1,1,-1,1,-1
KR_6620474670,420,-5,-98,-20,-8,-6,6,0,-4,6,2,-3,3,0,3,2,5,2,0,-2,0,8,-30,-4,-1,5,2,0,-1,-1,-1,-1,1,3,-1
KR_6758521015,420,-1,-4,16,-7,0,2,2,1,1,2,4,1,5,-8,9,1,-4,4,0,-1,11,-9,-7,-1,8,-2,0,0,-1,-1,0,-1,3,-1
KR_6757143276,440,0,19,-16,-4,1,0,1,5,0,5,1,3,4,-2,2,0,-9,10,-1,0,9,9,-3,-6,9,-1,0,0,-1,1,0,1,1,-1
KR_6764790483,420,-1,-49,0,-7,0,3,3,-5,5,0,3,0,3,-2,4,2,-3,3,0,0,9,12,4,-8,4,3,0,-1,0,1,-1,1,0,-1
KR_6744425055,420,1,-47,4,-2,-1,2,1,-2,3,1,-4,5,1,0,2,2,5,3,-8,0,-2,-8,-2,-1,3,0,0,0,-1,1,-1,1,4,-1
KR_6763600334,420,-3,-116,16,-4,-4,5,1,1,0,1,1,1,2,-3,4,1,1,0,-1,0,3,6,1,-3,2,2,0,0,-1,0,-1,-1,4,-1
KR_6761657701,440,2,78,-2,1,-3,3,0,-3,4,1,-4,6,2,6,0,6,5,1,-6,0,6,8,-4,-2,6,-2,0,0,-1,1,1,-1,1,-1
KR_6739980828,420,0,46,41,-2,0,3,3,3,3,6,-4,6,2,-5,8,3,4,4,-8,2,-6,-7,-1,-4,5,3,0,0,-1,-1,-1,1,5,-1
KR_6756465303,420,-6,-49,-48,-12,-4,4,0,-1,3,2,-2,3,1,-3,7,4,-2,3,-1,0,8,-5,7,-8,1,0,0,1,1,0,1,-1,2,-1
KR_6663235204,440,-1,-110,-12,3,4,1,5,1,3,4,-3,5,2,1,4,5,0,1,-1,0,-5,1,0,-3,3,3,0,0,0,1,1,-1,0,-1
KR_6616650061,420,-1,-88,-4,-5,-2,4,2,-3,5,2,-3,6,3,1,4,5,2,0,-2,0,1,-4,-4,-2,6,-4,0,0,1,0,0,-1,1,-1
KR_6728313082,420,2,6,-32,5,-1,2,1,1,1,2,6,0,6,1,4,5,-2,3,-1,1,-7,-5,-1,-7,8,-3,0,0,1,1,1,1,4,-1
KR_6759100902,420,0,-55,-11,5,0,3,3,0,1,1,0,1,1,5,2,7,0,1,-1,0,-17,2,2,-5,3,4,0,-1,1,-1,-1,1,2,-1
KR_6672538413,420,-4,-50,-51,-11,-3,3,0,-3,5,2,-8,8,0,5,0,5,-2,3,-1,-1,-3,106,-6,-3,9,0,0,-1,-1,-1,-1,-1,4,-1
KR_6739474936,420,-2,1,-8,0,2,2,4,3,2,5,0,4,4,-4,4,0,-1,1,0,0,2,-5,0,-6,6,-3,0,-1,-1,0,-1,1,2,-1
KR_6763393686,420,-2,-3,-20,-7,-2,2,0,-3,4,1,-1,2,1,2,0,2,-3,3,0,0,9,-12,4,-8,4,2,0,0,-1,-1,-1,-1,1,-1
KR_6733690232,420,2,-3,16,-6,-2,3,1,1,1,2,4,0,4,-2,4,2,-7,7,0,0,6,4,-5,0,5,4,0,-2,-1,-1,-1,-1,5,-1
KR_6740328173,420,-3,-38,-12,0,-1,1,0,2,5,7,-2,4,2,0,1,1,1,1,-2,0,-3,-5,2,-4,2,5,0,-1,1,-1,-1,-1,1,-1
KR_6742944088,420,-2,20,-8,-12,-1,2,1,-5,6,1,-5,7,2,1,2,3,-2,2,0,-3,12,-6,-6,-1,7,-4,0,0,0,-1,0,-1,0,-1
KR_6669282062,420,0,-74,-4,-7,-2,4,2,0,5,5,-2,5,3,-3,3,0,0,0,0,0,5,-3,3,-7,4,-2,0,0,-1,0,0,-1,6,-1
KR_6763234692,420,-2,41,2,-7,-1,2,1,-4,6,2,-1,3,2,-1,3,2,0,1,-1,0,13,-1,-2,-1,3,2,0,1,-1,1,1,1,4,-1
KR_6758426110,440,-4,-29,9,-4,4,0,4,-4,5,1,-9,9,0,7,3,10,-2,2,0,0,-2,4,-1,-4,5,2,0,-3,-1,1,-1,-1,6,-1
KR_6638099479,420,-4,-15,-24,-11,-1,1,0,-5,8,3,0,1,1,-2,4,2,-3,6,-3,0,11,-202,-3,-4,7,-2,0,0,-1,-1,0,-1,5,-1
KR_6758082786,440,2,-56,14,8,11,2,13,1,1,2,-4,4,0,-1,3,2,1,0,-1,1,-4,-44,-5,-1,6,1,0,-2,-1,-1,-1,1,6,-1
KR_6701996819,420,-2,-10,-1,-3,-1,2,1,0,3,3,-5,5,0,2,2,4,1,2,-3,0,1,3,2,-6,4,1,0,-2,-1,1,-1,1,1,-1
KR_6728052381,440,0,-49,-32,0,-1,2,1,-3,4,1,-2,4,2,0,5,5,6,0,-6,0,-3,7,2,-6,4,-3,0,-1,1,-1,-1,1,3,-1
KR_6763027250,420,1,-13,-17,3,-3,5,2,3,4,7,5,2,7,2,2,4,-4,4,0,0,-10,-4,-1,-3,4,3,0,0,-1,-1,-1,1,2,-1
KR_6651783032,420,-2,-39,4,-4,0,2,2,-2,5,3,-2,5,3,0,4,4,0,1,-1,1,2,26,3,-3,0,4,0,0,1,1,0,1,1,-1
KR_6763583262,420,-3,-57,-8,-6,-2,3,1,-3,4,1,-3,4,1,-4,8,4,6,1,-7,1,0,-7,-4,-1,5,1,0,3,-1,0,1,1,1,-1
KR_6743559695,420,1,-31,-4,-3,1,1,2,-1,4,3,3,0,3,-5,5,0,-1,2,-1,0,7,9,-1,-3,4,1,0,0,-1,1,1,-1,4,-1
KR_6699011105,420,-4,-39,-39,-4,-1,1,0,3,1,4,-2,3,1,-2,2,0,-2,2,0,0,4,0,-2,0,2,1,0,0,-1,1,-1,1,4,-1
KR_6643252911,420,-3,-20,20,-13,-1,3,2,-1,2,1,4,0,4,-12,12,0,-3,4,-1,0,14,6,2,-7,5,0,0,-1,1,1,-1,-1,2,-1
KR_6708997439,420,-3,15,-19,-4,5,2,7,-3,7,4,0,0,0,-6,8,2,0,0,0,0,5,-70,1,-7,6,-1,0,0,-1,1,1,1,5,-1
KR_6574277847,420,-5,-41,8,-10,0,1,1,-5,6,1,-4,5,1,-1,2,1,0,0,0,0,13,46,0,-7,7,18,0,-1,-1,-1,-1,-1,4,-1
KR_6742706993,420,0,51,0,1,2,0,2,-4,6,2,-2,3,1,3,1,4,2,0,-2,0,-2,47,-2,-2,4,11,0,0,0,-1,-1,1,0,-1
KR_6707334760,420,3,18,-12,5,4,0,4,-2,3,1,1,4,5,4,4,8,-2,3,-1,0,-3,-5,-4,0,4,-2,0,0,-1,-1,-1,-1,4,-1
KR_6738315105,420,-4,-72,18,-10,-4,4,0,2,2,4,-4,4,0,-1,3,2,-3,5,-2,0,1,44,-2,-4,6,33,0,1,1,1,1,-1,3,-1
KR_6762957788,420,4,22,36,9,0,1,1,3,2,5,5,0,5,0,2,2,1,0,-1,0,-3,-10,2,-3,1,2,0,1,1,1,1,1,6,-1
KR_6678642255,420,0,8,-24,-5,1,2,3,-2,3,1,-4,5,1,0,2,2,0,0,0,0,4,-28,-3,-3,6,-5,0,-1,-1,1,-1,1,6,-1
KR_6612229611,420,-3,-81,-3,-7,-5,5,0,0,3,3,-1,4,3,-2,3,1,1,0,-1,-1,1,-12,-3,-2,5,1,0,-2,-1,-1,-1,-1,6,-1
KR_6763227363,440,-4,-26,-20,-2,-2,2,0,1,1,2,0,2,2,0,0,0,-1,3,-2,0,-1,-2,0,-7,7,-1,0,0,1,-1,-1,-1,4,-1
KR_6697583617,420,0,-60,-11,5,-1,2,1,1,1,2,1,0,1,6,5,11,-2,2,0,0,-9,-24,0,-8,8,2,0,0,-1,0,1,-1,2,-1
KR_6648452920,420,-4,-98,-16,-13,-3,3,0,-6,9,3,-3,3,0,-1,2,1,0,0,0,0,7,-2,-3,-4,7,-1,0,-3,-1,-1,-1,-1,6,-1
KR_6756040868,420,-6,-79,-24,-16,-6,8,2,-2,4,2,-4,6,2,-3,3,0,-1,2,-1,-2,15,-9,-9,-4,13,1,0,-2,-1,0,-1,-1,1,-1
KR_6758132496,420,0,-19,-16,-3,-1,2,1,-2,3,1,-2,2,0,2,2,4,0,1,-1,0,6,9,1,-5,4,0,0,0,-1,-1,-1,-1,5,-1
KR_6657530283,420,-2,-6,-32,4,0,2,2,-1,6,5,1,1,2,1,2,3,3,1,-4,1,-8,-5,8,-9,1,4,0,-1,-1,1,1,1,5,-1
KR_6722816065,440,-6,-45,-20,-8,-1,1,0,-7,7,0,0,1,1,-1,9,8,1,3,-4,2,4,-6,0,-6,6,0,0,-1,-1,1,-1,-1,3,-1
KR_6753468515,420,-1,14,-4,1,-1,3,2,-3,4,1,6,0,6,1,1,2,-2,3,-1,1,-5,2,-2,-4,6,-4,0,1,-1,1,1,1,3,-1
KR_6611762686,420,-1,-104,23,-5,-1,4,3,-3,5,2,2,2,4,0,1,1,-3,3,0,0,7,177,0,-4,4,-3,0,-1,-1,1,-1,1,1,-1
KR_6738851980,420,-1,49,-9,0,0,3,3,-1,1,0,4,0,4,0,4,4,-3,3,0,0,-1,11,-5,-4,9,-8,0,1,0,1,1,1,0,-1
KR_6745222844,420,-4,-42,-20,-7,-1,1,0,-2,3,1,-3,4,1,-2,4,2,1,0,-1,0,10,-71,-2,-4,6,1,0,0,0,-1,0,-1,0,-1
KR_6753735950,440,1,-71,8,2,1,2,3,1,1,2,4,2,6,-1,4,3,-3,4,-1,0,0,4,0,-3,3,4,0,-1,-1,0,-1,-1,1,-1
KR_6731528442,420,-1,-23,-16,-7,-2,3,1,-1,2,1,4,0,4,-5,6,1,-3,3,0,0,6,33,1,-2,1,20,0,0,-1,0,0,-1,3,-1
KR_6633892714,420,0,-34,8,0,1,0,1,-3,5,2,-3,3,0,5,1,6,0,1,-1,0,0,9,-2,-5,7,2,0,0,1,-1,0,1,3,-1
KR_6581995653,420,-2,30,-64,-6,-1,2,1,-2,2,0,-2,2,0,-1,2,1,0,0,0,0,5,152,-1,0,1,4,0,0,0,-1,0,1,0,-1
KR_6564067201,420,1,59,2,-1,0,3,3,4,0,4,-5,5,0,0,3,3,0,0,0,1,11,10,4,-9,5,5,0,1,-1,-1,1,1,1,-1
KR_6673324990,420,1,2,-15,5,0,2,2,-3,3,0,-1,3,2,9,0,9,0,1,-1,1,-8,6,2,-6,4,5,0,1,1,-1,1,1,1,-1
KR_6752774287,440,-6,-22,-31,-18,-5,6,1,-1,4,3,0,3,3,-7,7,0,-5,5,0,-1,17,5,-6,-3,9,2,0,-1,0,1,-1,-1,0,-1
KR_6736598144,420,-6,-51,-66,-8,2,0,2,-6,7,1,-4,6,2,-1,1,0,1,0,-1,0,10,2,-2,-1,3,2,0,-2,-1,-1,-1,-1,6,-1
KR_6763238937,420,-2,-14,0,0,3,0,3,-2,4,2,-2,5,3,-3,3,0,4,0,-4,0,4,-6,2,-7,5,-1,0,0,-1,1,1,1,4,-1
KR_6760801968,420,-6,5,-111,-9,-1,3,2,-5,5,0,1,1,2,-2,3,1,-2,4,-2,-2,15,-1,-2,-2,4,3,0,-2,-1,-1,-1,-1,4,-1
KR_6760457722,420,-4,-62,-8,-5,-5,7,2,0,1,1,1,5,6,-1,5,4,0,0,0,-1,8,-1,8,-9,1,4,0,0,-1,-1,0,-1,2,-1
KR_6755127718,420,3,14,23,4,1,1,2,4,0,4,1,5,6,-3,6,3,1,1,-2,0,-8,9,2,-6,4,1,0,-1,1,-1,-1,-1,5,-1
KR_6702716716,420,2,23,-8,2,0,2,2,-3,5,2,5,2,7,0,2,2,0,0,0,0,-3,0,-4,-4,8,-3,0,0,-1,1,0,-1,2,-1
KR_6729244078,420,0,72,7,0,2,0,2,0,5,5,1,3,4,-3,3,0,0,1,-1,0,10,-8,-3,0,3,-1,0,1,1,0,1,-1,2,-1
KR_6670498796,420,1,-12,16,-5,-5,6,1,1,2,3,1,1,2,0,4,4,-2,3,-1,0,2,4,-1,-3,4,-1,0,-1,0,1,-1,-1,0,-1
KR_6739824575,420,-3,-33,-28,-7,2,1,3,-4,4,0,3,2,5,-7,8,1,-1,3,-2,0,9,-3,-2,-4,6,1,0,-1,-1,-1,-1,1,4,-1
KR_6711900768,420,1,-12,40,4,-3,3,0,-2,3,1,5,4,9,4,3,7,0,1,-1,0,-2,-240,5,-5,0,3,0,1,1,1,1,1,2,-1
KR_6700082974,420,-1,12,1,-2,-1,1,0,-1,4,3,0,2,2,0,3,3,0,1,-1,0,0,-3,-3,-7,10,-5,0,-1,-1,-1,-1,1,6,-1
KR_6752536329,440,1,-51,23,-6,-2,3,1,-1,1,0,-3,3,0,0,0,0,0,1,-1,0,7,-15,-3,-3,6,1,0,0,1,-1,0,-1,2,-1
KR_6744033052,420,-2,-95,-18,-9,-3,3,0,-1,2,1,0,0,0,-1,2,1,-4,4,0,0,8,-3,0,-5,5,-3,0,0,-1,-1,0,-1,1,-1
KR_6648382153,420,-3,-81,-11,-8,-1,1,0,-6,7,1,2,3,5,-2,4,2,-1,1,0,0,8,4,0,-5,5,-1,0,-1,-1,-1,-1,-1,3,-1
KR_6720529482,440,1,-95,-5,-2,-1,2,1,-3,7,4,-1,2,1,1,1,2,2,0,-2,0,0,-24,1,-3,2,5,0,0,0,0,-1,-1,0,-1
KR_6744592210,420,-2,-42,-16,3,3,0,3,2,4,6,1,0,1,-2,4,2,-1,2,-1,0,1,7,3,-9,6,-4,0,-1,-1,1,-1,1,1,-1
KR_6725559778,420,-1,-30,9,-2,-2,3,1,3,2,5,2,0,2,-4,4,0,-1,2,-1,-1,1,5,-2,-2,4,1,0,-1,-1,0,-1,-1,4,-1
KR_6762722134,420,-3,-75,8,-12,-3,3,0,2,2,4,-6,6,0,-4,4,0,-1,2,-1,0,12,-10,-2,-3,5,-3,0,-2,-1,0,-1,1,1,-1
KR_6700247694,420,1,49,6,2,0,1,1,-1,3,2,4,0,4,-1,4,3,0,0,0,0,0,17,0,-4,4,5,0,0,1,1,0,1,4,-1
KR_6680317078,440,-3,66,-16,-6,-1,3,2,-4,5,1,0,2,2,0,1,1,-1,2,-1,-1,9,-8,-2,-3,5,0,0,-1,1,-1,-1,-1,1,-1
KR_6741743127,440,-1,-52,-25,-7,-2,3,1,-1,3,2,1,2,3,-2,4,2,-3,3,0,-1,6,-33,4,-8,4,4,0,-1,-1,1,-1,-1,2,-1
KR_6752496371,420,-3,19,-20,-3,-2,2,0,-2,4,2,-1,3,2,2,0,2,0,0,0,0,0,307,1,-3,2,3,0,0,-1,-1,-1,1,1,-1
KR_6741553966,440,-2,-12,-12,-6,-2,3,1,-2,2,0,0,4,4,2,1,3,-4,5,-1,0,12,-1,1,-5,4,1,0,-1,-1,1,-1,1,1,-1
KR_6764106722,420,-5,-45,-41,-10,2,1,3,-1,3,2,-2,7,5,-7,8,1,-2,3,-1,1,14,4,1,-3,2,-1,0,-1,-1,-1,-1,1,6,-1
KR_6643183852,420,-2,58,-7,0,3,0,3,-2,4,2,-2,5,3,2,0,2,-1,2,-1,0,0,0,0,-3,3,0,0,0,-1,1,0,1,3,-1
KR_6616783614,420,-2,-68,19,-3,0,1,1,2,0,2,-3,4,1,-1,2,1,-1,1,0,0,-1,-10,-1,-2,3,-1,0,-1,-1,-1,-1,-1,4,-1
KR_6720867123,420,-5,14,-73,-16,-1,1,0,-9,9,0,-2,2,0,-3,5,2,-1,1,0,-1,17,39,3,-5,2,19,0,-1,-1,-1,-1,1,6,-1
KR_6729028408,440,-7,-114,-57,-17,-4,5,1,-4,4,0,-2,3,1,-7,11,4,0,1,-1,0,17,-5,-6,-2,8,-1,0,-3,-1,-1,-1,-1,3,-1
KR_6635023756,420,-5,-48,-59,-13,-4,4,0,-2,5,3,-4,6,2,-2,4,2,-1,2,-1,0,0,7,6,-8,2,4,0,1,-1,-1,-1,-1,5,-1
KR_6760459902,420,1,6,0,-2,2,1,3,-1,4,3,0,3,3,-5,5,0,2,0,-2,0,7,5,-2,-3,5,1,0,-2,1,-1,-1,-1,1,-1
KR_6761043603,420,-2,19,-6,-3,0,1,1,-3,3,0,-2,3,1,1,2,3,1,0,-1,0,-2,-3,-1,-3,4,-1,0,-1,-1,1,-1,1,5,-1
KR_6764493261,420,1,-28,15,5,1,0,1,2,4,6,-1,3,2,4,2,6,-1,1,0,-2,-8,-142,2,-9,7,0,0,-1,1,1,-1,-1,6,-1
KR_6752127287,420,0,26,-4,-4,-1,2,1,0,3,3,-1,6,5,-2,3,1,0,0,0,0,2,-4,-4,-4,8,-3,0,0,-1,1,0,1,3,-1
KR_6670418441,420,-2,-28,23,-4,2,1,3,-3,3,0,2,1,3,-4,7,3,-1,2,-1,0,6,-7,1,-5,4,0,0,-1,-1,1,-1,1,4,-1
KR_6763610210,420,-4,-29,-16,-6,-2,2,0,-6,6,0,-5,5,0,7,3,10,0,1,-1,0,8,6,2,-3,1,4,0,-1,1,-1,-1,-1,2,-1
KR_6764226853,420,-4,-51,-16,-9,1,0,1,1,1,2,-4,4,0,-6,7,1,-1,1,0,0,8,2,0,-4,4,0,0,0,-1,1,0,-1,5,-1
KR_6731579569,420,-4,-24,-8,-6,3,1,4,-1,1,0,1,2,3,-9,10,1,0,0,0,0,13,-12,-2,-3,5,-1,0,-4,-1,-1,-1,1,6,-1
KR_6742284406,420,-6,-78,-52,-20,-1,4,3,-2,3,1,-8,8,0,-8,9,1,-1,1,0,-1,14,-1,2,-4,2,2,0,-1,-1,-1,-1,-1,5,-1
KR_6676996157,420,-3,-77,-13,-9,0,1,1,-3,4,1,0,2,2,-4,4,0,-2,3,-1,0,13,-6,-4,-2,6,2,0,0,-1,1,0,-1,4,-1
KR_6760821476,440,2,79,-8,6,1,0,1,0,0,0,-1,2,1,5,1,6,1,0,-1,0,-4,-2,2,-6,4,-2,0,0,0,-1,0,1,0,-1
KR_6466727611,420,-2,-47,-8,-12,-3,3,0,0,2,2,-2,2,0,-3,4,1,-4,6,-2,-1,12,0,1,-6,5,3,0,-1,-1,-1,-1,-1,1,-1
KR_6760341092,420,-4,-27,-10,-12,-2,3,1,-4,5,1,-1,1,0,-6,9,3,1,3,-4,0,7,-7,-4,-1,5,1,0,0,-1,-1,-1,-1,2,-1
KR_6594185416,420,0,-40,-1,-4,0,2,2,0,0,0,-4,7,3,1,2,3,-1,1,0,0,8,-1,-7,-2,9,0,0,1,-1,0,-1,1,5,-1
KR_6010175656,420,-1,-6,13,-3,-3,3,0,0,2,2,-1,3,2,2,2,4,-1,2,-1,-1,1,-33,-3,-10,13,-10,0,-1,-1,-1,-1,-1,1,-1
KR_6749154332,420,-3,-30,-11,0,-1,1,0,0,2,2,2,1,3,1,3,4,-2,2,0,0,-8,-10,0,-4,4,-1,0,0,-1,1,1,1,2,-1
KR_6641189581,420,0,15,0,-7,4,0,4,0,0,0,-3,4,1,-7,8,1,-1,2,-1,0,10,24,0,-7,7,0,0,1,-1,1,1,-1,5,-1
KR_6763008612,420,0,26,-3,-4,1,1,2,-3,6,3,-2,3,1,0,1,1,0,0,0,0,8,2,0,-5,5,6,0,0,1,-1,0,1,4,-1
KR_6681932411,420,-2,2,-8,-6,0,1,1,-6,6,0,-2,4,2,5,3,8,-3,6,-3,1,11,-37,-1,-4,5,-27,0,-1,1,-1,-1,1,1,-1
KR_6625109869,420,-7,-80,-8,-17,-5,5,0,-1,3,2,-3,5,2,-6,6,0,-2,3,-1,0,15,25,1,-5,4,1,0,-1,-1,-1,-1,-1,1,-1
KR_6763567942,420,-1,-4,-1,0,1,2,3,-2,2,0,2,3,5,0,4,4,-1,3,-2,0,12,-4,-4,-3,7,2,0,0,1,-1,0,-1,3,-1
KR_6692170898,420,-3,15,-13,-1,-3,4,1,-4,4,0,0,3,3,3,2,5,3,0,-3,0,0,2,3,-6,3,0,0,0,0,-1,-1,-1,0,-1
KR_6679386600,420,4,40,-3,2,0,1,1,4,1,5,-3,4,1,-1,3,2,2,0,-2,0,-2,-3,-2,-3,5,-5,0,1,0,0,1,-1,0,-1
KR_6750030098,420,-1,-2,0,2,6,1,7,1,0,1,0,4,4,-4,6,2,-1,1,0,0,6,-19,2,-5,3,0,0,1,1,1,1,1,2,-1
KR_6741032926,420,-4,-38,-35,-8,-4,4,0,0,2,2,-9,9,0,3,2,5,2,1,-3,0,0,15,1,-4,3,3,0,-2,-1,1,-1,-1,2,-1
KR_6756971415,420,1,28,8,10,2,1,3,3,1,4,2,1,3,4,0,4,-1,1,0,0,-12,-152,0,-4,4,-2,0,0,1,1,1,1,1,-1
KR_6764495663,440,-5,-40,-23,-7,0,5,5,-1,2,1,-2,4,2,-2,2,0,-2,2,0,0,6,-9,2,-8,6,3,0,0,1,-1,-1,1,6,-1
KR_6741750248,420,-2,-60,-3,-4,-2,3,1,-1,2,1,-4,4,0,2,1,3,1,0,-1,0,2,-11,-2,-4,6,0,0,2,1,-1,-1,-1,1,-1
KR_6458235494,420,2,22,28,4,4,0,4,4,2,6,-1,2,1,1,0,1,-4,4,0,0,2,4,-5,-3,8,3,0,0,-1,-1,0,-1,6,-1
KR_6762573794,420,1,-68,-13,-1,-1,4,3,1,1,2,1,2,3,-5,10,5,3,0,-3,-2,2,-2,-1,-4,5,0,0,0,-1,-1,-1,1,3,-1
KR_6754044030,420,0,-43,-6,-1,-2,3,1,1,1,2,-2,5,3,-2,3,1,4,0,-4,0,5,12,3,-4,1,3,0,-1,1,1,-1,-1,5,-1
KR_6624773638,420,-4,-98,-24,-5,-1,1,0,0,2,2,-4,4,0,1,0,1,-1,1,0,0,2,10,0,-3,3,2,0,-1,1,-1,-1,-1,4,-1
KR_6759493898,420,0,13,4,-1,-1,2,1,-3,4,1,2,1,3,-1,1,0,2,0,-2,0,-1,102,-2,-5,7,0,0,1,-1,1,1,1,6,-1
KR_6653913630,420,-2,-16,3,-5,-5,7,2,3,5,8,0,2,2,-4,7,3,1,2,-3,0,4,-265,8,-9,1,7,0,-1,-1,-1,-1,-1,3,-1
KR_6697124609,420,-2,-56,8,-7,0,1,1,1,1,2,-3,5,2,-2,4,2,-3,3,0,0,8,-4,-3,-3,6,-5,0,-2,-1,0,-1,-1,2,-1
KR_6761685283,420,-2,23,-18,-1,-3,4,1,4,2,6,-2,2,0,0,3,3,0,1,-1,2,5,34,2,-6,4,28,0,-1,-1,1,-1,1,6,-1
KR_6750097705,420,2,10,23,0,-3,5,2,1,4,5,3,1,4,0,4,4,-1,2,-1,0,8,2,2,-4,2,4,0,0,-1,1,0,1,5,-1
KR_6601561367,420,-3,50,-11,-3,1,1,2,4,2,6,-9,9,0,3,3,6,-2,2,0,0,6,-1,2,-4,2,-3,0,0,-1,1,1,-1,2,-1
KR_6763597855,440,-1,-31,16,1,2,0,2,0,2,2,-1,2,1,-4,4,0,4,0,-4,0,-3,-63,0,-3,3,6,0,-1,-1,-1,-1,1,3,-1
KR_6759598682,440,3,-15,-3,5,3,1,4,0,3,3,-1,4,3,3,1,4,0,0,0,0,-8,-1,-4,-1,5,-2,0,2,-1,1,1,-1,6,-1
KR_6728301696,420,0,-29,-9,4,2,1,3,3,1,4,1,3,4,1,4,5,-3,3,0,0,-2,-2,-1,-6,7,-3,0,1,-1,1,1,1,3,-1
KR_6742925706,420,-3,-7,-4,-7,-1,2,1,-4,7,3,-3,4,1,0,2,2,1,0,-1,0,3,-6,-2,-5,7,1,0,0,0,0,0,1,0,-1
KR_6764067024,420,-3,-18,-16,-4,0,3,3,1,1,2,2,2,4,-4,7,3,-3,3,0,0,-1,4,4,-9,5,0,0,0,-1,1,-1,-1,4,-1
KR_6742952362,420,0,-18,22,-9,2,3,5,-4,4,0,-4,5,1,-4,4,0,1,0,-1,0,9,-2,0,-4,4,5,0,1,-1,1,1,-1,5,-1
KR_6753208830,420,-5,-28,0,-8,-2,3,1,-1,2,1,4,0,4,-8,8,0,-1,3,-2,0,15,-17,-1,-5,6,5,0,-1,1,1,-1,-1,4,-1
KR_6738044521,420,-2,-53,-14,-11,-9,9,0,-1,4,3,-3,5,2,0,3,3,2,0,-2,1,5,-35,-3,-5,8,2,0,0,0,-1,-1,1,0,-1
KR_6593929184,420,-1,-87,13,-4,4,0,4,-3,3,0,-1,1,0,-4,7,3,0,2,-2,-1,6,7,-1,-4,5,4,0,1,-1,1,-1,-1,6,-1
KR_6751118254,440,-5,-76,19,-7,-3,4,1,0,4,4,-2,3,1,-5,7,2,3,5,-8,0,-1,1,2,-4,2,2,0,-3,0,0,-1,-1,0,-1
KR_6748108130,420,-4,-63,-3,-4,-1,5,4,0,2,2,-3,3,0,-2,3,1,2,1,-3,-2,7,-5,-2,-6,8,1,0,-2,1,-1,-1,-1,6,-1
KR_6763588635,420,0,14,-8,1,0,1,1,-2,2,0,1,2,3,1,1,2,1,0,-1,0,1,-7,2,-3,1,0,0,0,1,-1,0,1,1,-1
KR_6741660610,420,3,97,0,1,1,2,3,-2,4,2,3,2,5,-1,1,0,0,0,0,0,6,-15,1,-6,5,-1,0,1,1,-1,1,-1,4,-1
KR_6731730876,420,-3,-60,-24,-1,3,1,4,-3,4,1,-3,4,1,2,2,4,0,1,-1,1,-4,23,1,-3,2,1,0,-1,-1,-1,-1,1,1,-1
KR_6549284451,420,0,-19,-4,3,-3,4,1,-1,3,2,-2,3,1,7,2,9,2,2,-4,-2,-4,16,-4,-3,7,-5,0,3,-1,-1,1,-1,3,-1
KR_6763598181,420,-2,-34,-29,-10,1,1,2,-4,5,1,-2,2,0,-5,5,0,0,1,-1,-1,14,1,-5,-2,7,1,0,-1,-1,-1,-1,-1,1,-1
KR_6714992319,420,-3,29,-44,-7,1,2,3,-2,4,2,-6,7,1,1,3,4,-1,1,0,-1,3,-8,-3,-4,7,-4,0,-1,-1,-1,-1,-1,3,-1
KR_6703816151,420,-1,12,13,-7,1,0,1,-1,3,2,1,0,1,-6,9,3,-2,5,-3,-1,15,0,0,-6,6,0,0,0,-1,1,1,-1,5,-1
KR_6586778783,420,2,-65,15,-6,0,2,2,1,1,2,-1,2,1,-1,2,1,-5,7,-2,0,6,30,-3,-1,4,4,0,-2,-1,-1,-1,-1,4,-1
KR_6749985500,420,-3,-31,-21,-9,-3,5,2,-4,5,1,-3,6,3,1,1,2,0,1,-1,0,9,-18,-2,-1,3,-4,0,-1,-1,0,-1,-1,4,-1
KR_6756131136,420,-1,16,9,-1,-2,2,0,-3,3,0,1,3,4,0,0,0,3,0,-3,0,1,-12,-1,-4,5,-3,0,0,1,1,0,-1,5,-1
KR_6740929587,420,3,18,-10,0,1,1,2,1,2,3,-5,6,1,2,3,5,1,0,-1,0,3,4,-2,-3,5,-2,0,-1,-1,-1,-1,-1,2,-1
KR_6763513425,420,-5,-45,-21,1,0,1,1,-1,3,2,1,2,3,4,2,6,-3,4,-1,1,-9,1,2,-7,5,4,0,-1,0,0,-1,1,0,-1
KR_6710774303,420,-1,-115,7,-4,0,2,2,1,1,2,-3,4,1,0,0,0,-2,2,0,0,7,8,-3,-3,6,1,0,-1,1,1,-1,-1,4,-1
KR_6744383455,420,-8,-101,-28,-15,0,0,0,-2,3,1,-10,10,0,-2,3,1,-1,2,-1,0,14,-354,4,-6,2,-23,0,-2,-1,-1,-1,-1,4,-1
KR_6762368992,420,1,-55,-22,7,6,2,8,-1,1,0,-3,3,0,3,4,7,2,0,-2,0,-4,-1,1,-6,5,-1,0,0,1,1,1,-1,6,-1
KR_6688085877,420,-5,-19,-16,-8,2,1,3,-3,5,2,0,1,1,0,1,1,-7,7,0,0,14,-4,-1,-6,7,7,0,0,-1,1,0,1,6,-1
KR_6647466360,420,-1,101,-22,-3,-1,2,1,-3,6,3,0,2,2,4,4,8,-3,4,-1,1,1,-4,2,-7,5,-4,0,1,-1,-1,1,1,3,-1
KR_6762791673,420,-2,-37,-21,-5,5,1,6,-4,4,0,0,2,2,-6,6,0,0,0,0,0,13,-29,-2,-2,4,0,0,-2,-1,-1,-1,-1,2,-1
KR_6626247838,420,-5,-112,-8,-8,-2,3,1,-2,3,1,-6,6,0,1,1,2,1,1,-2,0,4,-10,-1,-2,3,1,0,-1,-1,1,-1,1,2,-1
KR_6759579859,420,3,-14,28,5,2,0,2,-1,3,2,3,0,3,2,4,6,-1,2,-1,0,-9,10,3,-6,3,3,0,0,1,-1,0,-1,2,-1
KR_6698918508,420,-2,19,21,-8,-2,2,0,-2,2,0,2,2,4,-5,6,1,-1,1,0,0,15,-121,-2,-3,5,-2,0,-2,0,-1,-1,-1,0,-1
KR_6660067573,420,-4,-40,-17,-5,-3,5,2,-2,2,0,1,3,4,0,0,0,-1,1,0,0,3,8,2,-5,3,3,0,-1,-1,-1,-1,1,4,-1
KR_6735146709,440,-3,-25,4,-14,3,0,3,-5,6,1,-1,5,4,-10,12,2,-1,4,-3,0,15,-152,2,-3,1,2,0,-1,0,-1,-1,1,0,-1
KR_6751475909,440,0,22,1,-2,0,3,3,-1,2,1,1,1,2,-3,3,0,1,0,-1,0,7,-38,3,-7,4,-18,0,0,1,0,0,-1,4,-1
KR_6740694769,420,2,-58,1,5,-2,2,0,2,2,4,0,3,3,5,1,6,0,0,0,0,-4,-390,0,-3,3,2,0,0,-1,1,0,1,4,-1
KR_6705861037,420,-2,-54,20,-1,-5,7,2,2,5,7,1,1,2,2,1,3,-1,1,0,0,-2,-323,0,-3,3,1,0,-2,1,-1,-1,-1,6,-1
KR_6760347953,420,0,-15,20,-6,-2,2,0,2,1,3,2,1,3,-8,10,2,0,1,-1,-1,11,14,-1,-5,6,1,0,1,-1,1,1,-1,6,-1
KR_6754028132,440,-5,17,-18,-8,-2,2,0,-5,6,1,2,0,2,-4,4,0,1,0,-1,0,9,44,4,-8,4,20,0,0,-1,-1,0,-1,2,-1
KR_6707451948,440,3,16,20,1,-2,2,0,0,1,1,2,2,4,0,1,1,1,0,-1,0,2,12,0,-4,4,4,0,0,1,1,0,-1,4,-1
KR_6736542882,440,3,-9,20,6,3,2,5,4,2,6,0,1,1,1,2,3,-2,2,0,0,-4,-6,2,-4,2,3,0,0,-1,1,0,1,2,-1
KR_6740255661,440,-1,-15,-12,-5,-2,4,2,-3,4,1,0,3,3,0,2,2,0,1,-1,0,4,34,-1,-5,6,31,0,-1,-1,1,-1,-1,1,-1
KR_6708422245,420,0,-82,4,-1,3,0,3,-3,5,2,0,1,1,-1,3,2,0,0,0,0,6,0,1,-5,4,-2,0,0,1,1,0,-1,1,-1
KR_6764707970,420,1,-18,-4,1,1,2,3,1,2,3,3,0,3,-7,8,1,3,0,-3,0,2,-7,-3,-6,9,-4,0,0,-1,-1,-1,-1,6,-1
KR_6726947349,440,-1,57,-4,-2,2,0,2,0,0,0,2,2,4,-1,3,2,-5,6,-1,0,10,17,5,-9,4,2,0,1,-1,1,1,1,4,-1
KR_6698551985,420,-1,-78,-15,-5,-1,4,3,1,2,3,-1,1,0,-3,4,1,-1,1,0,-1,6,-4,-2,-3,5,-2,0,0,0,-1,0,-1,0,-1
KR_6716196046,420,-3,53,-37,-5,-2,2,0,-3,3,0,1,1,2,0,2,2,-1,2,-1,0,7,7,4,-7,3,0,0,1,-1,1,1,1,2,-1
KR_6763752607,420,-3,-162,-1,-9,-2,2,0,0,2,2,-4,4,0,2,2,4,-5,6,-1,0,3,3,-7,-2,9,0,0,-2,-1,1,-1,-1,4,-1
KR_6750487710,420,0,13,12,-2,2,0,2,-2,3,1,-1,3,2,-2,5,3,1,2,-3,0,5,-7,4,-7,3,1,0,1,-1,1,1,1,5,-1
KR_6643126462,420,2,47,-8,4,4,0,4,-2,3,1,1,0,1,1,3,4,0,0,0,1,-4,13,0,-4,4,2,0,1,1,1,1,1,5,-1
KR_6658779630,420,-2,6,1,-7,0,1,1,-1,3,2,-2,5,3,-9,12,3,5,0,-5,0,4,-48,-2,-5,7,-3,0,-2,-1,1,-1,-1,6,-1
KR_6731383694,420,4,-12,5,7,-2,3,1,3,3,6,0,3,3,3,1,4,3,0,-3,0,-10,1,-3,-2,5,-1,0,1,0,1,1,1,0,-1
KR_6756445268,420,2,57,24,3,1,2,3,1,1,2,-3,3,0,4,4,8,0,4,-4,0,-4,4,4,-7,3,0,0,1,1,-1,1,1,5,-1
KR_6688488334,420,-3,-48,24,-8,-3,3,0,2,1,3,-2,2,0,-5,5,0,0,1,-1,0,6,6,0,-7,7,8,0,-1,1,-1,-1,-1,6,-1
KR_6761559799,440,-1,-24,-28,-4,1,2,3,-4,4,0,1,1,2,-2,5,3,0,1,-1,-1,11,-2,0,-4,4,-1,0,0,-1,0,1,-1,5,-1
KR_6761007358,420,-3,-49,-20,-6,-1,4,3,-4,5,1,2,1,3,-3,3,0,0,1,-1,0,11,109,0,-4,4,2,0,-1,0,0,-1,1,0,-1
KR_6730031971,420,-1,-49,23,-1,0,0,0,-4,6,2,1,3,4,1,2,3,1,0,-1,0,2,4,-2,-6,8,2,0,1,-1,1,1,1,2,-1
KR_6708899399,420,-1,-17,-10,-4,2,1,3,-1,6,5,-1,2,1,-3,4,1,-1,1,0,1,2,2,-5,-4,9,0,0,-1,1,-1,-1,1,1,-1
KR_6628479467,420,1,48,-16,-5,1,0,1,1,0,1,-2,4,2,-1,1,0,-4,4,0,0,7,6,1,-5,4,-4,0,0,-1,-1,0,-1,3,-1
KR_6752963833,420,-2,28,-21,-3,-3,4,1,1,2,3,-1,3,2,3,1,4,-3,3,0,1,-5,-7,5,-9,4,0,0,0,-1,0,0,1,5,-1
KR_6732404504,440,-4,28,-24,-1,-4,4,0,-1,2,1,0,1,1,3,0,3,1,1,-2,0,2,-13,2,-5,3,1,0,-1,0,-1,-1,1,0,-1
KR_6729157637,420,-1,-8,-1,0,0,3,3,3,0,3,1,0,1,0,1,1,-4,4,0,1,-3,-4,-1,-2,3,-3,0,0,1,-1,0,1,6,-1
KR_6644212322,420,-1,10,-44,-1,4,1,5,-7,10,3,-2,2,0,4,0,4,0,0,0,0,-4,1,-1,-6,7,0,0,-2,1,-1,1,1,3,-1
KR_6762998465,420,-3,2,-28,-4,3,2,5,-4,4,0,3,1,4,-5,6,1,-1,2,-1,1,0,10,1,-3,2,-3,0,0,-1,0,0,1,4,-1
KR_6714590217,420,-2,-19,-12,-6,0,3,3,-3,3,0,-1,2,1,-2,3,1,0,0,0,0,9,4,-1,-5,6,-2,0,-1,1,-1,-1,-1,1,-1
KR_6716183843,440,-1,-4,-4,-1,-4,4,0,3,2,5,-1,1,0,-4,8,4,5,1,-6,0,5,-11,4,-6,2,2,0,0,1,0,0,1,2,-1
KR_6736043381,420,0,14,-33,-2,1,2,3,-3,5,2,2,2,4,0,1,1,-2,2,0,0,4,-1,-3,-2,5,-1,0,-2,-1,-1,-1,-1,2,-1
KR_6001085816,420,-2,-5,-24,-2,-2,3,1,2,0,2,-3,3,0,3,1,4,-2,3,-1,0,-4,3,5,-8,3,0,0,0,-1,1,0,-1,4,-1
KR_6660232578,420,-1,13,14,1,-2,3,1,1,3,4,2,1,3,0,0,0,0,0,0,0,-4,7,3,-6,3,-4,0,1,1,1,1,1,1,-1
KR_6759783003,420,-5,2,7,-9,-1,1,0,-4,6,2,-3,5,2,-3,4,1,2,0,-2,0,13,358,0,-3,3,0,0,0,-1,1,0,-1,2,-1
KR_6722428400,420,3,22,-7,7,5,0,5,1,1,2,-3,4,1,2,0,2,2,0,-2,0,-5,-4,1,-6,5,0,0,0,-1,1,-1,1,2,-1
KR_6733871163,440,-1,-16,20,-2,0,1,1,-2,4,2,-1,2,1,3,1,4,-2,3,-1,-1,4,-363,-4,0,4,-1,0,0,1,0,-1,-1,3,-1
KR_6624763175,420,-3,48,0,-4,4,1,5,-2,5,3,0,2,2,-7,8,1,1,0,-1,1,7,7,-2,-6,8,-2,0,2,-1,1,1,1,4,-1
KR_6762572445,440,-2,7,-13,-6,-6,7,1,4,1,5,-2,3,1,-3,4,1,1,0,-1,0,2,-6,-5,-4,9,-4,0,-1,-1,-1,-1,-1,6,-1
KR_6740499412,420,1,21,-20,3,1,3,4,2,0,2,-2,4,2,2,1,3,0,3,-3,0,-6,-37,-2,-3,5,2,0,-1,1,-1,-1,1,5,-1
KR_6633121364,420,1,41,44,4,0,1,1,-3,5,2,0,2,2,6,1,7,1,0,-1,0,-4,28,1,-4,3,-1,0,0,1,-1,0,1,2,-1
KR_6757667951,420,5,-31,96,11,5,0,5,6,1,7,1,3,4,-3,4,1,2,0,-2,1,-10,-218,7,-9,2,0,0,1,1,1,1,1,1,-1
KR_6619089119,420,1,-6,-4,-1,5,1,6,0,1,1,-7,10,3,-1,3,2,2,0,-2,1,12,-13,3,-6,3,4,0,1,1,1,1,1,5,-1
KR_6714323034,420,-1,16,21,0,-1,3,2,0,2,2,2,0,2,-1,2,1,0,0,0,0,3,-19,0,-5,5,0,0,-1,1,-1,-1,1,2,-1
KR_6665785464,420,-5,-94,-25,-7,-1,5,4,0,2,2,-6,6,0,-1,2,1,1,0,-1,-1,10,-17,2,-3,1,0,0,-2,-1,1,1,-1,3,-1
KR_6759739139,440,-5,-21,-65,-10,-3,4,1,-4,8,4,-6,6,0,-1,4,3,4,1,-5,-2,10,-3,-1,-1,2,2,0,-2,-1,-1,-1,-1,2,-1
KR_6691867448,420,-4,-53,-44,-9,3,2,5,-5,5,0,-2,6,4,-5,5,0,0,3,-3,-1,11,-4,-1,-3,4,4,0,-2,-1,-1,-1,-1,2,-1
KR_6718928632,420,-12,-93,-95,-15,-2,5,3,-5,5,0,-3,3,0,0,4,4,-5,7,-2,-1,10,-10,-2,-3,5,3,0,-4,-1,-1,-1,-1,3,-1
KR_6668944287,420,-1,-71,8,2,1,0,1,1,2,3,0,1,1,-1,3,2,1,0,-1,0,-4,5,0,-4,4,2,0,0,1,0,0,1,3,-1
KR_6729573307,420,1,109,20,1,0,1,1,5,1,6,-4,6,2,-1,1,0,1,0,-1,0,-2,6,4,-5,1,5,0,1,1,0,1,1,2,-1
KR_6598075312,420,-1,-7,-10,-1,-1,2,1,-2,8,6,3,1,4,-3,5,2,2,0,-2,0,1,-281,-2,-5,7,2,0,0,-1,1,0,1,5,-1
KR_6658732125,420,-7,-90,-19,-13,-3,3,0,-7,7,0,0,1,1,-3,4,1,0,0,0,0,9,-27,-1,-5,6,5,0,-2,-1,-1,-1,-1,1,-1
KR_6735245250,420,1,-42,12,-4,-2,4,2,2,2,4,-2,5,3,-1,4,3,-1,2,-1,0,-9,11,3,-8,5,6,0,-2,0,1,-1,1,0,-1
KR_6763234782,420,-1,-63,8,-3,-3,4,1,1,1,2,-5,6,1,4,1,5,0,0,0,0,-6,-25,-1,-4,5,-11,0,0,1,0,0,1,4,-1
KR_6760213798,420,-2,-40,7,0,2,0,2,-6,6,0,2,1,3,0,4,4,2,1,-3,0,3,10,1,-4,3,7,0,0,-1,1,0,1,4,-1
KR_6728245908,420,-10,-76,-92,-21,-3,3,0,-1,1,0,-4,4,0,-15,15,0,2,0,-2,0,18,-1,-1,-2,3,1,0,-1,-1,-1,-1,-1,4,-1
KR_6755810252,420,-2,-10,4,1,-1,3,2,-5,8,3,1,2,3,1,3,4,5,1,-6,1,4,5,5,-6,1,5,0,1,0,-1,1,1,0,-1
KR_6731351601,420,-4,51,-13,-14,-1,2,1,-10,11,1,0,3,3,-3,6,3,0,1,-1,0,23,0,-2,-5,7,2,0,-2,-1,-1,-1,1,2,-1
KR_6646353352,420,0,57,13,-3,-1,2,1,5,1,6,0,2,2,-6,7,1,-1,1,0,0,0,5,2,-4,2,3,0,1,0,1,1,1,0,-1
KR_6762067960,420,3,7,16,1,1,1,2,3,3,6,3,0,3,-3,7,4,-3,4,-1,0,-4,4,2,-6,4,2,0,0,1,-1,0,-1,3,-1
KR_6662878012,420,3,7,23,0,-1,4,3,-1,4,3,-1,3,2,1,2,3,2,2,-4,0,-2,9,-8,-2,10,4,0,1,-1,-1,1,1,4,-1
KR_6714608742,420,1,-14,0,-3,4,3,7,3,1,4,-3,4,1,-4,5,1,-3,4,-1,0,-5,6,6,-8,2,9,0,-1,0,1,-1,-1,0,-1
KR_6749090898,420,0,-28,16,-3,1,1,2,4,3,7,-4,5,1,-4,8,4,0,0,0,0,-3,114,-5,-3,8,1,0,1,-1,1,1,1,5,-1
KR_6736544434,420,-4,-100,-8,-11,-1,3,2,-5,6,1,1,3,4,-3,3,0,-3,4,-1,0,5,-5,-1,-3,4,2,0,-1,-1,-1,-1,-1,4,-1
KR_6739255164,420,-2,-50,2,-4,-2,3,1,-4,7,3,-2,4,2,5,0,5,-1,3,-2,-1,-7,27,-1,-4,5,-3,0,-3,1,1,-1,-1,5,-1
KR_6685004176,440,-2,-55,-12,1,2,1,3,4,2,6,3,3,6,-5,5,0,-3,3,0,0,-5,23,2,-3,1,1,0,0,1,-1,-1,-1,1,-1
KR_6764561075,420,0,43,12,-7,-1,1,0,-3,3,0,-4,6,2,0,2,2,1,1,-2,0,16,3,-1,-4,5,4,0,1,-1,1,1,-1,3,-1
KR_6718637004,420,1,-14,4,-6,-1,2,1,0,7,7,-1,3,2,-3,6,3,-1,2,-1,0,13,1,2,-6,4,3,0,-1,-1,-1,-1,-1,6,-1
KR_6643359310,420,-2,33,20,-7,-4,4,0,-4,5,1,0,2,2,1,0,1,0,1,-1,0,5,-4,2,-8,6,-2,0,0,1,1,0,1,1,-1
KR_6693300625,440,-2,-114,5,-12,-3,3,0,0,2,2,-3,4,1,-6,6,0,0,1,-1,1,3,-10,-3,-2,5,-1,0,-1,1,1,-1,1,4,-1
KR_6763193161,420,0,-62,-8,-2,-4,5,1,2,0,2,-1,2,1,1,1,2,0,2,-2,0,-4,108,-2,-3,5,0,0,-1,0,1,-1,-1,0,-1
KR_6667210216,420,0,14,-15,-3,1,1,2,-2,2,0,0,1,1,2,1,3,-4,4,0,0,8,-38,-4,-4,8,-2,0,0,-1,-1,-1,1,1,-1
KR_6637056151,420,-3,-22,-16,-3,-4,4,0,1,5,6,-6,7,1,6,1,7,0,0,0,1,-7,-13,-5,-5,10,-1,0,0,1,1,0,1,2,-1
KR_6764481979,440,-2,17,-24,-1,3,0,3,-3,7,4,2,2,4,-3,4,1,0,3,-3,0,-7,1,-1,-3,4,-1,0,0,0,-1,1,1,0,-1
KR_6763427185,420,-3,-10,8,-12,1,0,1,-6,6,0,-5,7,2,-1,1,0,-1,2,-1,0,14,7,-2,-3,5,-4,0,0,-1,-1,0,-1,5,-1
KR_6640110419,420,0,-66,-20,-2,-2,3,1,-4,7,3,2,1,3,2,2,4,0,3,-3,-1,1,-1,7,-8,1,-2,0,-1,1,-1,-1,-1,2,-1
KR_6763909785,420,-5,-119,-20,2,1,0,1,0,4,4,5,1,6,-4,4,0,0,0,0,0,1,-14,-5,-1,6,2,0,-1,1,1,-1,-1,2,-1
KR_6763446623,440,-1,11,-14,-5,2,0,2,4,0,4,-4,4,0,-5,5,0,-2,3,-1,0,5,-29,-1,-3,4,2,0,-1,1,0,-1,-1,2,-1
KR_6698760694,420,-2,-63,-8,-3,-4,5,1,-1,3,2,-2,2,0,2,3,5,2,1,-3,0,3,-29,0,-5,5,-18,0,0,1,1,-1,1,4,-1
KR_6762427556,420,-2,-6,-9,-13,-5,5,0,-3,5,2,2,0,2,-8,11,3,1,0,-1,0,11,4,0,-2,2,-2,0,1,1,-1,-1,1,3,-1
KR_6651995371,420,-4,-79,-8,-5,0,1,1,0,2,2,0,2,2,-5,5,0,0,0,0,0,-1,6,5,-6,1,1,0,0,-1,1,0,1,1,-1
KR_6738844996,420,1,35,-8,2,2,0,2,-4,4,0,2,1,3,1,0,1,1,2,-3,0,-3,11,-5,-5,10,-2,0,0,1,-1,0,-1,1,-1
KR_6747851766,420,-5,-71,-28,-8,-5,6,1,1,2,3,-2,4,2,-1,3,2,-1,2,-1,0,3,4,-2,-4,6,4,0,0,-1,-1,-1,-1,4,-1
KR_6649358412,420,-3,-38,-10,-3,1,1,2,5,3,8,-4,4,0,-5,5,0,0,1,-1,0,-4,0,3,-6,3,0,0,0,1,1,1,1,6,-1
KR_6646470205,420,-3,-48,19,-11,-1,1,0,1,3,4,-1,1,0,-7,7,0,-3,3,0,0,10,6,2,-6,4,5,0,-1,-1,1,-1,1,2,-1
KR_6759625529,420,1,0,47,0,6,0,6,-1,1,0,0,1,1,-1,5,4,-4,4,0,-3,14,-14,3,-7,4,-1,0,-1,-1,0,-1,-1,5,-1
KR_6719027232,420,-4,-55,-8,0,-3,5,2,-2,4,2,-2,4,2,4,2,6,3,0,-3,0,-9,-22,-4,-3,7,-2,0,1,1,-1,1,1,6,-1
KR_6764573539,420,0,5,-43,-4,2,0,2,-4,4,0,-2,7,5,-1,2,1,1,0,-1,0,-1,-10,1,-5,4,0,0,0,-1,1,1,1,3,-1
KR_6751913058,440,-6,-20,-60,-9,1,1,2,-9,9,0,1,2,3,3,7,10,-5,5,0,0,5,34,3,-4,1,27,0,-2,-1,-1,-1,1,3,-1
KR_6576881525,420,0,-64,-2,-2,1,1,2,3,1,4,-4,4,0,-4,6,2,2,0,-2,0,-3,10,-1,-5,6,1,0,1,1,1,1,1,2,-1
KR_6746697096,440,-1,-58,-20,-7,-3,3,0,0,3,3,-3,4,1,-2,6,4,1,4,-5,-1,13,-4,-2,-3,5,-1,0,-1,0,-1,-1,1,0,-1
KR_6672603490,420,-2,-113,12,3,-3,3,0,1,3,4,1,0,1,2,4,6,2,1,-3,1,-7,15,-1,-2,3,7,0,-1,-1,1,-1,1,2,-1
KR_6649327716,420,-8,-25,-46,-16,-3,4,1,-4,4,0,-9,9,0,1,1,2,-1,4,-3,-1,14,-30,-2,-4,6,3,0,-2,-1,-1,-1,-1,2,-1
KR_6738767460,420,1,32,-8,3,1,1,2,1,2,3,-3,6,3,2,2,4,2,2,-4,-1,-6,20,3,-6,3,-5,0,-1,-1,-1,-1,-1,6,-1
KR_6729836804,420,-5,-79,-16,-12,0,2,2,-4,5,1,-5,6,1,-4,4,0,1,0,-1,0,7,-21,4,-7,3,5,0,-2,-1,-1,-1,1,6,-1
KR_6698527752,420,-1,7,-16,-5,-1,3,2,-5,7,2,-1,1,0,4,1,5,-2,2,0,0,8,-25,8,-11,3,2,0,0,-1,1,0,-1,1,-1
KR_6699097879,440,-1,11,-19,5,0,2,2,0,2,2,9,0,9,-1,2,1,-3,3,0,0,-7,-17,0,-4,4,-2,0,0,-1,-1,0,1,5,-1
KR_6752448199,420,0,43,-32,-11,0,2,2,1,2,3,-3,4,1,-6,6,0,-3,4,-1,-1,19,-6,-2,-3,5,2,0,-1,-1,-1,-1,-1,5,-1
KR_6705789760,420,-4,-89,-6,-2,-3,4,1,-3,4,1,4,0,4,-1,1,0,1,1,-2,0,4,-10,5,-9,4,2,0,-1,-1,1,-1,1,4,-1
KR_6763756960,420,-3,-104,-31,1,-2,3,1,-2,4,2,0,1,1,2,0,2,3,0,-3,0,-4,38,0,-4,4,21,0,0,-1,0,0,1,6,-1
KR_6755765635,420,-1,3,-4,1,-2,6,4,-2,5,3,-3,5,2,0,1,1,8,0,-8,1,-6,-10,0,-5,5,6,0,0,-1,1,-1,1,1,-1
KR_6757887322,420,-4,-4,-12,-8,1,4,5,0,1,1,0,3,3,-6,6,0,-3,3,0,0,23,12,-1,-4,5,1,0,-1,-1,-1,-1,1,4,-1
KR_6714390737,420,1,56,4,0,0,2,2,-5,7,2,6,0,6,1,2,3,-2,2,0,-1,-4,-55,2,-5,3,9,0,3,-1,1,1,-1,4,-1
KR_6751361530,440,0,-70,-14,1,3,1,4,-2,6,4,-2,4,2,1,2,3,1,2,-3,0,-6,-9,-5,-2,7,3,0,0,-1,1,1,-1,2,-1
KR_6753831946,420,3,56,8,3,7,0,7,1,0,1,-1,2,1,-2,3,1,-2,2,0,0,2,-192,-1,-3,4,-4,0,1,-1,1,1,1,6,-1
KR_6757090356,440,-5,-4,-48,-15,-2,2,0,-5,5,0,0,1,1,-6,7,1,-2,2,0,0,16,-9,-6,-2,8,0,0,0,0,-1,-1,-1,0,-1
KR_6743212385,440,-1,-29,-20,-6,-2,3,1,-2,3,1,-2,4,2,0,0,0,0,4,-4,1,7,4,-1,-2,3,3,0,0,-1,1,0,1,1,-1
KR_6741056454,420,1,26,-21,-2,3,0,3,-3,3,0,3,0,3,-5,7,2,0,1,-1,1,3,-2,-1,-2,3,2,0,1,-1,1,1,1,3,-1
KR_6763377233,420,-7,-60,3,-15,1,4,5,-1,2,1,-1,3,2,-13,14,1,-1,1,0,0,20,-2,-3,-2,5,2,0,-2,-1,-1,-1,-1,5,-1
KR_6735741572,420,-2,4,-15,0,1,1,2,-2,3,1,-5,5,0,6,0,6,0,0,0,0,-1,-15,2,-8,6,2,0,0,1,-1,0,1,6,-1
KR_6735520432,420,-2,-20,-40,-7,-2,2,0,-1,3,2,-2,4,2,-2,4,2,0,4,-4,0,5,1,5,-6,1,0,0,-1,-1,-1,-1,-1,3,-1
KR_6751655012,420,-2,-81,-6,-5,2,0,2,1,1,2,-6,9,3,-1,2,1,-1,1,0,-1,1,-3,0,-2,2,3,0,-3,-1,1,-1,-1,5,-1
KR_6679629691,420,3,-17,28,0,-1,1,0,3,0,3,4,2,6,-2,3,1,-4,5,-1,-1,-1,43,-3,-4,7,20,0,1,1,1,1,-1,1,-1
KR_6753654773,420,-3,-77,-12,-14,-4,5,1,-2,2,0,-7,8,1,-2,4,2,1,0,-1,0,6,25,-6,-2,8,4,0,-2,-1,-1,-1,-1,1,-1
KR_6758946518,420,0,2,-4,11,1,2,3,-1,4,3,4,2,6,4,1,5,3,0,-3,0,-10,-8,-5,-1,6,-3,0,0,1,-1,0,1,5,-1
KR_6671151458,420,-3,24,-18,-12,-3,5,2,-4,7,3,-2,5,3,-1,2,1,-2,2,0,0,10,-7,0,-3,3,0,0,1,-1,0,-1,-1,6,-1
KR_6756659959,440,2,11,-27,8,5,0,5,6,1,7,0,2,2,0,3,3,-3,3,0,0,-7,11,0,-9,9,16,0,1,-1,1,1,1,5,-1
KR_6701798512,420,-2,-12,-20,-9,-1,2,1,2,2,4,0,4,4,-8,8,0,-2,2,0,-1,2,13,0,-5,5,-2,0,0,-1,0,-1,-1,6,-1
KR_6703106865,420,-2,-13,-39,-4,7,0,7,1,1,2,-1,2,1,-6,6,0,-5,6,-1,1,10,-12,1,-4,3,1,0,-1,-1,-1,1,1,4,-1
KR_6654613270,420,-2,18,-6,0,-1,1,0,0,2,2,1,1,2,0,2,2,0,1,-1,0,-3,-51,3,-8,5,4,0,-1,1,1,-1,-1,1,-1
KR_6197058818,420,2,-52,10,3,3,2,5,0,1,1,2,0,2,-2,4,2,0,1,-1,0,-8,20,3,-9,6,6,0,0,1,-1,0,1,3,-1
KR_6672731868,420,-7,-52,-31,-11,0,3,3,-5,5,0,-3,4,1,-4,5,1,1,0,-1,0,12,-4,-2,-3,5,2,0,-1,-1,-1,-1,-1,6,-1
KR_6744602946,420,-2,-7,3,-5,-1,2,1,-5,7,2,3,4,7,-3,6,3,1,1,-2,0,9,-23,-2,-5,7,8,0,2,-1,1,1,1,6,-1
KR_6650905924,420,-6,-162,-35,-12,-7,7,0,-1,4,3,0,2,2,-3,3,0,-1,1,0,-1,12,-6,-3,-3,6,2,0,-1,-1,-1,-1,-1,2,-1
KR_6763051170,420,-1,-1,-7,4,-3,4,1,-1,3,2,5,0,5,5,1,6,-2,3,-1,2,-11,37,4,-8,4,2,0,1,-1,-1,1,1,4,-1
KR_6757101602,420,-3,-93,16,-3,-3,3,0,-4,4,0,0,3,3,5,2,7,-1,3,-2,0,-3,0,1,-5,4,1,0,0,0,0,0,-1,0,-1
KR_6704761722,420,-5,-96,-32,-10,-3,8,5,-2,3,1,-8,8,0,3,1,4,0,0,0,-1,9,3,3,-5,2,1,0,-1,-1,-1,-1,-1,5,-1
KR_6756155569,420,0,-49,26,4,1,1,2,1,3,4,1,1,2,-3,3,0,4,0,-4,-1,-5,-13,-1,-3,4,1,0,0,1,-1,-1,-1,3,-1
KR_6698497041,420,-4,-74,29,-20,-6,7,1,-4,5,1,3,1,4,-11,12,1,-2,2,0,-1,27,5,-2,-4,6,0,0,-2,-1,-1,-1,-1,6,-1
KR_6762251926,420,-2,42,14,-9,0,5,5,-3,3,0,-3,4,1,-3,3,0,0,0,0,0,12,4,0,-4,4,2,0,-2,-1,-1,-1,1,1,-1
KR_6763957990,420,0,17,-8,-1,-4,5,1,-2,2,0,2,1,3,1,0,1,2,0,-2,0,5,4,0,-4,4,4,0,1,1,-1,1,-1,1,-1
KR_6622696636,420,0,6,-24,-3,-2,2,0,-1,4,3,-2,2,0,0,3,3,2,3,-5,-1,10,303,2,-7,5,2,0,1,-1,1,1,-1,3,-1
KR_6763633061,420,0,-13,7,0,1,2,3,2,1,3,1,2,3,-2,3,1,-2,2,0,-1,1,-12,-4,-2,6,-8,0,-2,-1,-1,-1,-1,2,-1
KR_6704600391,420,-2,68,-27,-8,-1,1,0,-5,7,2,-1,4,3,0,1,1,-1,1,0,0,5,6,5,-7,2,3,0,0,-1,-1,-1,-1,2,-1
KR_6761152301,420,-1,-23,-3,-6,-1,5,4,-1,1,0,-1,4,3,-4,5,1,1,1,-2,-1,5,0,-2,-4,6,-1,0,0,1,-1,1,-1,3,-1
KR_6690827286,420,2,-3,-4,-2,-1,2,1,-2,3,1,-1,2,1,0,1,1,2,0,-2,0,-4,-133,-1,-5,6,-1,0,-2,-1,-1,-1,-1,3,-1
KR_6724462358,420,-4,-201,19,-8,-5,6,1,-5,7,2,0,2,2,-1,3,2,3,0,-3,0,0,19,-2,-3,5,2,0,-2,-1,1,-1,-1,5,-1
KR_6692068953,420,-1,-45,-8,-2,-2,3,1,-4,6,2,-1,1,0,7,1,8,-2,3,-1,-1,2,-35,-4,-3,7,-17,0,0,1,-1,-1,-1,2,-1
KR_6684257037,420,-4,-27,-2,-5,2,5,7,-4,5,1,0,1,1,-2,6,4,-1,1,0,0,12,-6,1,-4,3,1,0,-1,1,1,1,-1,5,-1
KR_6674298885,420,-8,-97,-23,-14,-3,5,2,-4,6,2,0,2,2,-7,7,0,0,1,-1,-1,7,2,-1,-3,4,6,0,-2,-1,-1,-1,-1,3,-1
KR_6761772736,420,-1,-41,22,-10,-1,3,2,0,3,3,-3,4,1,-5,7,2,-1,1,0,-2,15,6,-3,-4,7,9,0,1,-1,-1,-1,-1,6,-1
KR_6745708690,420,4,90,29,1,2,1,3,-4,6,2,4,1,5,0,2,2,-1,1,0,1,7,-158,2,-6,4,1,0,0,1,-1,0,1,1,-1
KR_6743371447,420,-2,-69,0,-2,1,0,1,-2,4,2,0,3,3,-1,2,1,0,0,0,1,-3,-36,2,-6,4,-14,0,-2,1,-1,-1,1,6,-1
KR_6752401495,420,-5,-13,-23,-14,-3,3,0,-2,2,0,-3,6,3,-4,4,0,-2,2,0,0,19,2,-6,0,6,2,0,-3,-1,-1,-1,-1,6,-1
KR_6722589715,440,-1,-73,-14,-6,1,0,1,3,1,4,-1,3,2,-7,9,2,-2,2,0,-1,5,-9,-4,-1,5,1,0,0,-1,-1,-1,-1,4,-1
KR_6746178241,420,1,-11,-29,6,-1,2,1,-3,5,2,0,3,3,4,2,6,6,1,-7,-1,-8,-11,-6,-2,8,-3,0,1,-1,1,1,-1,1,-1
KR_6763835057,420,1,-16,-34,-5,1,1,2,-3,5,2,1,1,2,-3,3,0,-1,1,0,-2,4,140,4,-7,3,3,0,0,-1,1,0,-1,3,-1
KR_6757124498,440,0,-15,35,-2,9,3,12,-3,3,0,-1,1,0,-3,4,1,-4,5,-1,0,-6,-3,3,-9,6,5,0,-1,1,-1,-1,1,1,-1
KR_6740986505,420,-1,28,4,-3,-1,4,3,4,2,6,-2,2,0,-4,4,0,0,1,-1,0,8,-3,-1,-1,2,1,0,0,-1,0,-1,-1,5,-1
KR_6717446643,420,0,54,12,-6,-2,4,2,1,3,4,-3,3,0,-1,4,3,-1,2,-1,0,2,-281,-4,-4,8,-3,0,-1,-1,-1,1,-1,1,-1
KR_6759540575,420,-4,-26,-24,-1,-1,2,1,7,0,7,-8,8,0,1,1,2,0,0,0,0,-4,-14,-2,-1,3,1,0,0,-1,1,0,1,5,-1
KR_6749714461,440,-3,-58,2,-21,-6,6,0,-2,4,2,-2,4,2,-10,13,3,-1,2,-1,0,11,-7,1,-4,3,0,0,-3,-1,1,-1,-1,1,-1
KR_6751543914,440,-2,-45,-29,-8,-1,2,1,0,1,1,-1,1,0,0,3,3,-6,7,-1,0,16,142,3,-9,6,3,0,0,-1,-1,-1,1,5,-1
KR_6756932798,420,-2,27,-20,-4,-4,7,3,-2,3,1,0,1,1,2,1,3,0,2,-2,0,4,-104,-5,-3,8,-2,0,-1,1,-1,-1,-1,4,-1
KR_6763307561,420,1,16,28,3,-3,4,1,0,2,2,0,0,0,5,1,6,1,0,-1,0,-2,-389,3,-7,4,0,0,-2,1,-1,-1,-1,1,-1
KR_6655697110,420,0,-1,-4,-6,0,1,1,2,2,4,0,0,0,-9,10,1,1,2,-3,1,2,0,1,-6,5,-6,0,-1,1,-1,-1,1,1,-1
KR_6620546995,420,-1,-56,3,-5,-1,3,2,1,3,4,0,3,3,0,2,2,-5,5,0,-1,8,-42,1,-6,5,-10,0,0,-1,1,0,-1,2,-1
KR_6764475876,420,-5,-105,-48,-14,-1,3,2,-4,4,0,-2,2,0,-8,8,0,1,0,-1,0,5,-2,-1,-6,7,5,0,0,-1,-1,0,-1,4,-1
KR_6746380947,420,-3,-43,-10,-11,-1,5,4,-3,6,3,1,2,3,-7,8,1,-1,1,0,0,10,-6,2,-4,2,-2,0,-3,-1,1,-1,-1,5,-1
KR_6681831304,420,4,60,-36,6,6,1,7,3,0,3,1,0,1,-3,4,1,-1,2,-1,0,-6,-37,4,-8,4,0,0,1,-1,1,1,-1,4,-1
KR_6724417415,420,-2,-37,-4,-3,-6,6,0,3,2,5,2,0,2,0,0,0,-2,5,-3,0,3,-7,2,-6,4,0,0,0,-1,1,0,-1,4,-1
KR_6764674683,440,-2,-42,-13,-1,1,0,1,0,1,1,0,0,0,-2,5,3,0,1,-1,0,2,22,2,-5,3,5,0,0,1,-1,-1,1,2,-1
KR_6759987540,420,-3,-55,-8,-2,-3,4,1,1,1,2,0,0,0,1,2,3,-1,2,-1,0,-4,10,-1,-4,5,-1,0,-1,-1,1,-1,1,3,-1
KR_6764508296,420,-2,-60,-4,-7,-3,3,0,2,1,3,-1,2,1,-5,6,1,0,2,-2,1,2,-1,0,-7,7,-1,0,0,1,-1,0,1,6,-1
KR_6675679825,420,-1,-29,13,-6,0,1,1,2,3,5,-2,2,0,-6,7,1,0,0,0,-1,6,4,-2,-2,4,-3,0,-1,-1,0,-1,-1,4,-1
KR_6761588814,420,-2,-21,-4,-2,1,1,2,-3,3,0,-3,3,0,1,1,2,2,0,-2,0,2,0,-2,-2,4,-3,0,0,1,-1,0,1,4,-1
KR_6665628809,420,-5,-53,7,-13,-1,3,2,-2,6,4,-6,6,0,1,2,3,-5,6,-1,0,9,-118,-4,-3,7,1,0,-2,1,-1,-1,1,3,-1
KR_6683375633,420,2,5,36,2,3,0,3,-1,3,2,-1,2,1,1,1,2,0,0,0,0,2,12,-1,-5,6,-1,0,-1,1,0,-1,1,4,-1
KR_6759477252,420,0,-26,-4,-5,0,2,2,0,1,1,-6,7,1,3,3,6,-2,2,0,-2,4,-48,-3,-1,4,-4,0,-1,-1,-1,-1,-1,3,-1
KR_6733191881,420,-1,0,0,-4,0,2,2,0,3,3,1,0,1,1,6,7,-6,8,-2,0,11,28,2,-6,4,0,0,-1,-1,1,-1,-1,6,-1
KR_6722136970,420,-1,-23,0,-5,-2,5,3,-3,3,0,1,1,2,-2,4,2,1,1,-2,-2,9,4,-1,-3,4,1,0,0,-1,1,0,-1,2,-1
KR_6745568776,420,-2,-8,2,-4,-7,7,0,-3,4,1,7,1,8,-1,2,1,0,0,0,1,0,20,-1,-3,4,0,0,0,1,-1,0,1,5,-1
KR_6718911577,420,-5,-16,8,-12,-2,3,1,-1,3,2,-1,2,1,-8,9,1,0,2,-2,0,10,-35,-3,-2,5,2,0,0,-1,-1,-1,-1,1,-1
KR_6649031978,420,1,1,-30,5,2,1,3,2,1,3,-2,3,1,6,2,8,-3,3,0,0,-4,-7,-2,-4,6,-2,0,0,-1,-1,-1,-1,6,-1
KR_6757444458,420,-2,-53,21,-2,-3,5,2,5,1,6,0,0,0,-4,6,2,0,0,0,0,0,-1,-5,-3,8,-2,0,-2,-1,1,-1,1,4,-1
KR_6644398793,420,1,8,19,5,-3,3,0,2,1,3,1,2,3,6,1,7,-1,1,0,0,-4,1,1,-5,4,-7,0,0,0,1,0,1,0,-1
KR_6760171595,420,-4,-38,12,-5,-4,5,1,2,0,2,1,0,1,-3,5,2,-1,1,0,0,1,-7,-5,-1,6,2,0,0,1,1,0,1,6,-1
KR_6741456901,420,1,-29,4,3,4,0,4,-4,6,2,-1,1,0,4,1,5,0,1,-1,0,-3,-12,-4,-2,6,-4,0,1,-1,-1,-1,1,2,-1
KR_6700154555,420,-3,-14,-12,-7,1,0,1,0,2,2,-3,3,0,-2,6,4,-3,4,-1,0,10,-5,1,-6,5,2,0,0,1,1,0,-1,5,-1
KR_6738001295,420,-2,-117,-5,3,2,1,3,0,5,5,2,4,6,0,1,1,-1,1,0,0,3,38,-4,-1,5,-2,0,-1,-1,1,-1,-1,1,-1
KR_6760573565,420,-2,16,4,-2,-3,3,0,1,2,3,1,3,4,-1,4,3,0,0,0,0,-1,-2,1,-5,4,-1,0,1,-1,1,1,-1,5,-1
KR_6759351062,420,-1,-37,-34,-6,-5,6,1,0,6,6,-6,6,0,3,4,7,2,1,-3,-2,-2,-2,-1,-3,4,2,0,-2,-1,-1,-1,-1,1,-1
KR_6762902946,420,2,22,9,6,2,0,2,1,1,2,3,2,5,-2,3,1,2,0,-2,0,0,-18,-8,-4,12,-6,0,-1,-1,-1,-1,-1,1,-1
KR_6717468711,420,-1,-28,-3,0,-1,4,3,-6,7,1,2,1,3,6,0,6,-1,2,-1,0,-4,-5,-3,-3,6,-1,0,0,-1,1,0,1,1,-1
KR_6747817140,420,-2,10,-31,-12,1,2,3,-5,9,4,-2,4,2,-6,6,0,0,1,-1,0,4,5,0,-4,4,0,0,0,0,1,0,-1,0,-1
KR_6756615693,420,-4,-38,-16,-12,1,1,2,-6,6,0,-6,9,3,-2,5,3,1,0,-1,1,4,2,0,-3,3,0,0,-1,1,-1,-1,1,5,-1
KR_6734133033,420,-4,-69,-6,-6,-3,5,2,2,3,5,-1,4,3,-2,5,3,-2,3,-1,0,6,2,4,-8,4,0,0,0,1,1,1,1,2,-1
KR_6648772699,420,-4,-57,-28,-7,2,0,2,-1,3,2,0,3,3,-5,5,0,-3,3,0,0,9,-413,-4,-1,5,0,0,-2,-1,1,-1,-1,4,-1
KR_6758542858,420,-1,-45,7,-6,-2,3,1,1,1,2,-4,6,2,0,1,1,-1,3,-2,0,2,10,-1,-3,4,-1,0,-2,-1,-1,-1,-1,1,-1
KR_6762246999,420,0,-19,5,0,0,1,1,3,2,5,-2,5,3,-2,2,0,1,0,-1,0,-6,129,-4,-4,8,0,0,0,1,1,0,1,6,-1
KR_6753858204,420,-2,-63,69,-7,-2,2,0,3,2,5,-7,10,3,1,1,2,-2,3,-1,0,4,8,-2,-2,4,-1,0,-2,-1,-1,-1,-1,3,-1
KR_6732641255,440,5,62,11,10,3,1,4,6,1,7,-3,4,1,3,0,3,1,0,-1,0,-6,184,3,-6,3,5,0,2,1,-1,1,1,5,-1
KR_6714331448,420,-1,-90,-1,-4,0,1,1,-5,6,1,0,1,1,1,1,2,0,0,0,0,12,-2,-4,-5,9,-1,0,0,-1,1,0,1,5,-1
KR_6745598333,420,5,115,-16,11,1,1,2,1,1,2,4,1,5,6,1,7,-1,2,-1,0,-5,-5,0,-3,3,0,0,0,1,0,0,1,2,-1
KR_6727855630,420,-4,-100,-19,-14,-1,2,1,-2,4,2,-1,1,0,-9,11,2,-1,1,0,0,8,-3,1,-1,0,2,0,0,-1,-1,0,-1,5,-1
KR_6763565230,440,-5,-32,-32,-9,-2,3,1,-4,4,0,-3,5,2,0,2,2,0,3,-3,0,4,-7,-4,-4,8,-6,0,0,1,0,0,-1,2,-1
KR_6732529397,420,-4,-91,-16,-4,0,1,1,-2,5,3,-1,2,1,-3,5,2,2,1,-3,0,3,33,-3,-5,8,2,0,0,-1,-1,-1,1,1,-1
KR_6647986348,420,-2,-22,-4,0,-2,2,0,-2,3,1,5,0,5,0,2,2,-1,1,0,0,3,78,0,-6,6,-2,0,0,0,-1,0,-1,0,-1
KR_6739538170,420,3,-57,-12,-1,3,1,4,0,3,3,3,1,4,-5,5,0,-2,2,0,0,11,3,4,-9,5,8,0,0,-1,1,1,-1,4,-1
KR_6759840071,420,0,-19,21,-3,-5,6,1,-5,9,4,3,2,5,4,4,8,0,1,-1,0,2,-3,-1,-5,6,1,0,2,-1,1,1,1,6,-1
KR_6695354403,420,0,30,-12,-4,2,0,2,-1,3,2,-3,4,1,-1,2,1,-1,1,0,1,6,-47,0,-4,4,-22,0,-1,-1,1,-1,1,1,-1
KR_6737260766,420,-1,-44,-33,5,0,1,1,9,1,10,0,1,1,-3,3,0,-1,1,0,0,-7,3,-2,-2,4,1,0,-1,-1,-1,-1,-1,5,-1
KR_6753285349,420,-2,-12,4,-5,-3,6,3,0,4,4,1,4,5,-2,3,1,-1,1,0,0,4,-15,-3,-3,6,2,0,0,-1,-1,-1,1,4,-1
KR_6689458068,420,-2,86,-13,-12,-1,3,2,-5,6,1,1,1,2,-6,8,2,-1,1,0,-1,17,-25,-5,-5,10,0,0,-1,-1,1,1,-1,3,-1
KR_6745801802,420,-1,-72,-29,-3,-5,5,0,1,5,6,-1,2,1,0,2,2,2,2,-4,-2,-5,-4,-4,-1,5,3,0,-2,0,-1,-1,-1,0,-1
KR_6601634709,420,-1,-8,-12,-5,0,1,1,0,2,2,-2,4,2,-3,3,0,0,0,0,0,4,2,-2,-3,5,0,0,0,-1,1,0,1,2,-1
KR_6745544385,420,-1,41,-12,0,-3,4,1,0,1,1,0,3,3,1,0,1,2,0,-2,0,-2,-55,2,-3,1,-24,0,3,-1,1,1,1,4,-1
KR_6746532410,420,1,-6,-4,-2,0,1,1,5,1,6,2,1,3,-8,9,1,-1,1,0,0,0,7,0,-2,2,1,0,-2,1,-1,-1,-1,5,-1
KR_6660998134,420,1,-33,10,5,1,0,1,3,4,7,0,4,4,1,2,3,0,0,0,0,-1,8,5,-7,2,3,0,-1,1,1,-1,-1,2,-1
KR_6763290751,420,0,58,27,-7,-1,1,0,-4,6,2,3,2,5,-4,4,0,-1,2,-1,0,10,-21,-1,-7,8,-5,0,0,-1,1,0,-1,4,-1
KR_6755512278,420,-1,18,-8,-1,5,0,5,-7,8,1,-2,3,1,3,3,6,0,0,0,1,4,-6,1,-5,4,-3,0,0,-1,-1,0,1,3,-1
KR_6727179305,420,0,72,16,0,2,1,3,-3,4,1,0,4,4,3,2,5,-2,2,0,0,-1,3,3,-6,3,0,0,1,-1,1,1,-1,4,-1
KR_6712850078,420,-5,-70,9,-13,-1,2,1,-4,6,2,-5,6,1,-3,4,1,0,1,-1,0,9,-111,-7,-2,9,0,0,-1,0,-1,-1,-1,0,-1
KR_6695066405,420,-6,-45,-1,-11,-3,4,1,-4,4,0,-1,2,1,-3,3,0,0,1,-1,0,9,-4,-3,-2,5,1,0,-2,-1,-1,-1,1,2,-1
KR_6720092614,420,-4,-22,-7,-12,-3,3,0,-4,7,3,-2,4,2,-3,3,0,0,3,-3,0,13,8,-6,-3,9,3,0,-1,1,1,-1,1,5,-1
KR_6729125213,420,-5,-110,32,-7,-3,4,1,-4,8,4,-3,6,3,0,3,3,3,1,-4,2,8,-50,2,-6,4,-27,0,-1,-1,1,-1,-1,1,-1
KR_6762591257,420,-2,29,-15,-5,4,1,5,0,2,2,-4,4,0,-4,4,0,-1,1,0,0,8,7,1,-4,3,5,0,0,-1,-1,1,-1,2,-1
KR_6671171873,420,-4,-119,-11,-7,0,1,1,0,3,3,0,1,1,-5,5,0,-2,2,0,0,9,-50,-4,-3,7,-22,0,-1,-1,-1,-1,-1,3,-1
KR_6762140611,420,-1,16,-24,-1,4,1,5,2,3,5,-3,4,1,-4,8,4,0,0,0,0,5,33,0,-4,4,-2,0,0,-1,-1,-1,1,5,-1
KR_6485984986,420,-3,-123,16,-8,-2,2,0,-2,2,0,-1,2,1,-3,5,2,0,0,0,0,7,-4,2,-5,3,2,0,-1,-1,1,-1,-1,3,-1
KR_6736048875,420,2,5,-1,2,2,0,2,-1,3,2,-2,4,2,4,0,4,-1,1,0,0,2,17,-1,-2,3,1,0,1,1,-1,1,1,4,-1
KR_6760544240,420,2,-20,23,3,-5,5,0,0,2,2,1,1,2,3,2,5,4,0,-4,0,-5,0,-4,-2,6,-3,0,0,1,0,0,1,1,-1
KR_6754201638,420,-1,-17,17,0,-2,2,0,1,2,3,-1,2,1,2,3,5,0,1,-1,0,-3,-118,2,-5,3,6,0,0,-1,1,-1,-1,1,-1
KR_6763964521,440,-11,-146,-87,-16,-4,7,3,0,1,1,-9,9,0,0,0,0,-3,3,0,-1,14,-5,-5,0,5,-1,0,-4,-1,-1,-1,-1,3,-1
KR_6652324683,420,-5,-103,0,-10,-1,2,1,-6,8,2,-1,3,2,-2,4,2,0,0,0,0,15,179,1,-3,2,-1,0,-2,1,-1,-1,1,4,-1
KR_6758871179,420,-1,85,-29,-10,-3,3,0,-4,6,2,1,0,1,-2,3,1,-2,4,-2,0,8,6,-2,-3,5,-2,0,0,1,-1,0,1,2,-1
KR_6530022815,420,-5,-23,-43,-6,-2,2,0,3,0,3,-6,7,1,0,1,1,-1,2,-1,-1,3,-37,2,-4,2,1,0,-1,0,-1,-1,-1,0,-1
KR_6760584613,420,-4,20,6,-14,-2,2,0,0,3,3,-3,6,3,-9,10,1,0,3,-3,-1,13,10,-7,-1,8,2,0,-1,-1,1,-1,-1,4,-1
KR_6662232908,420,-3,-69,-20,-1,-4,4,0,3,1,4,0,0,0,-2,6,4,2,0,-2,1,-8,13,2,-5,3,-1,0,-1,-1,1,-1,1,3,-1
KR_6406122605,420,2,-80,8,-2,-7,7,0,4,1,5,0,1,1,4,2,6,-3,3,0,-1,0,-15,-3,-2,5,-4,0,-2,-1,-1,-1,-1,3,-1
KR_6696517201,420,4,34,12,8,2,3,5,2,3,5,2,4,6,1,1,2,1,1,-2,0,-8,-9,-4,-4,8,-1,0,0,1,-1,-1,1,3,-1
KR_6759459306,440,-2,44,0,-4,2,0,2,0,2,2,-4,6,2,-2,6,4,0,2,-2,1,0,-10,-1,-3,4,-3,0,0,1,-1,-1,1,5,-1
KR_6763492721,440,-3,-40,8,-8,0,3,3,-3,6,3,-2,3,1,-2,4,2,-1,5,-4,0,12,-10,-4,-1,5,-16,0,0,-1,1,-1,1,1,-1
KR_6753420770,420,-2,-44,0,-5,-1,2,1,0,0,0,3,1,4,-3,3,0,-4,4,0,0,1,70,-1,-6,7,-2,0,0,-1,1,0,-1,3,-1
KR_6637606577,420,-4,-19,19,-5,-3,3,0,3,0,3,-2,4,2,-3,3,0,0,0,0,0,4,-23,2,-6,4,4,0,-1,1,-1,-1,-1,6,-1
KR_5533032584,420,-3,-57,-7,-9,0,1,1,1,6,7,-3,5,2,-6,6,0,-1,2,-1,0,18,-9,-1,-6,7,3,0,-2,1,-1,-1,-1,3,-1
KR_6544981674,420,-2,-3,10,2,-4,5,1,1,3,4,3,0,3,2,2,4,0,0,0,0,-9,-18,3,-7,4,0,0,1,-1,1,1,1,5,-1
KR_6762907304,440,-7,-45,-18,-11,0,2,2,-2,3,1,-6,7,1,-1,9,8,-2,3,-1,0,10,-9,-4,0,4,-5,0,-1,-1,1,-1,1,4,-1
KR_6728081429,420,-3,5,-20,-5,-3,5,2,0,1,1,0,2,2,-1,2,1,-1,1,0,0,3,-7,-4,-5,9,1,0,0,-1,-1,0,-1,6,-1
KR_6752824907,440,-3,-6,-34,1,-3,4,1,-1,3,2,2,1,3,2,0,2,1,1,-2,0,-4,1,1,-7,6,8,0,0,-1,-1,0,-1,6,-1
KR_6756608755,420,3,46,17,-4,6,1,7,0,2,2,-4,6,2,-5,5,0,-1,1,0,0,10,0,-1,-2,3,2,0,2,-1,1,1,1,4,-1
KR_6682758524,420,-6,-52,-39,-7,-2,3,1,-3,5,2,-1,3,2,-3,7,4,2,0,-2,-1,10,178,-9,-1,10,-7,0,0,-1,1,0,-1,4,-1
KR_6698938312,420,1,0,-16,6,-3,3,0,5,2,7,0,1,1,1,4,5,3,0,-3,0,-13,-9,1,-6,5,0,0,-1,1,-1,-1,1,4,-1
KR_6698529229,420,-1,34,-21,-8,1,0,1,-2,4,2,-5,5,0,1,3,4,-3,4,-1,0,8,-80,-5,-5,10,4,0,0,-1,-1,-1,-1,6,-1
KR_6751955386,420,0,-30,24,-2,-2,3,1,-1,6,5,-2,3,1,2,0,2,1,1,-2,0,0,32,3,-5,2,7,0,-1,-1,1,-1,-1,4,-1
KR_6690892436,420,-9,-115,-12,-17,-4,5,1,-2,2,0,-7,8,1,-3,3,0,-1,1,0,0,9,-2,-2,-9,11,1,0,-1,-1,-1,-1,-1,6,-1
KR_6594494939,420,-1,-33,-24,-6,0,1,1,-6,7,1,-2,3,1,2,0,2,0,0,0,0,7,0,-2,-2,4,-3,0,-1,1,-1,-1,-1,2,-1
KR_6723103403,440,-3,-14,-9,-8,0,5,5,1,3,4,-1,1,0,-7,7,0,-1,1,0,0,8,-1,-2,-1,3,0,0,-1,0,1,-1,1,0,-1
KR_6737853674,420,-3,-44,-16,-2,-5,5,0,-1,2,1,6,1,7,-1,2,1,-1,2,-1,0,7,225,-2,-1,3,-2,0,-2,-1,1,-1,1,2,-1
KR_6746282440,420,0,-10,11,0,1,3,4,-3,4,1,2,0,2,-2,4,2,2,1,-3,-1,-2,-7,1,-3,2,4,0,-1,-1,1,-1,-1,1,-1
KR_6755615222,420,0,53,-24,0,-3,3,0,-3,7,4,4,1,5,2,1,3,0,0,0,0,4,84,-2,-4,6,-1,0,1,-1,-1,1,-1,2,-1
KR_6718713694,420,3,-30,7,0,-2,3,1,1,1,2,2,2,4,-3,3,0,2,0,-2,0,3,-4,-3,-2,5,-1,0,0,0,-1,-1,1,0,-1
KR_6741422364,420,-1,-67,-4,-8,-4,5,1,1,4,5,-3,4,1,-2,8,6,0,1,-1,1,1,-31,0,-3,3,1,0,-1,1,-1,-1,1,6,-1
KR_6691001802,420,-1,-28,5,-4,0,3,3,0,3,3,-1,3,2,-3,6,3,0,1,-1,0,2,5,0,-5,5,-1,0,0,-1,-1,-1,1,4,-1
KR_6754736482,420,-1,-75,-9,0,-2,3,1,-2,4,2,-1,2,1,5,1,6,0,1,-1,0,-6,208,5,-6,1,1,0,0,1,-1,1,1,6,-1
KR_6692389602,440,-3,-39,-3,-4,1,1,2,3,1,4,-2,3,1,-6,6,0,0,0,0,-1,5,-191,2,-5,3,2,0,-1,-1,-1,-1,-1,4,-1
KR_6762846606,420,-2,4,19,-9,1,1,2,6,3,9,-9,9,0,-6,6,0,-1,1,0,0,3,-7,-1,-2,3,-2,0,0,1,1,1,1,1,-1
KR_6757419758,420,2,7,-8,4,6,0,6,-4,4,0,-2,3,1,4,2,6,0,5,-5,0,2,2,-4,-2,6,-2,0,1,-1,1,1,-1,5,-1
KR_6745350097,420,-3,-62,-28,-6,-9,9,0,-2,3,1,2,2,4,2,0,2,1,1,-2,1,5,11,-6,-1,7,6,0,-1,-1,-1,-1,1,6,-1
KR_6665613034,420,-4,-106,-17,-7,0,0,0,-4,6,2,5,2,7,-7,8,1,-1,3,-2,0,11,27,3,-5,2,5,0,-3,-1,-1,-1,-1,3,-1
KR_6741381660,420,-1,-14,-18,-1,1,2,3,-3,5,2,-1,2,1,-3,4,1,5,0,-5,0,8,3,2,-5,3,0,0,0,-1,1,1,-1,4,-1
KR_6654496731,420,-1,-31,-28,4,-2,3,1,2,2,4,-1,1,0,4,1,5,1,0,-1,0,-9,-3,3,-7,4,-5,0,0,1,-1,-1,1,4,-1
KR_6743897880,420,-1,34,0,-13,-1,3,2,-8,9,1,-1,3,2,-1,1,0,-2,2,0,0,6,-4,2,-8,6,-4,0,0,1,1,0,-1,2,-1
KR_6706521986,420,-2,-11,16,-5,-1,2,1,0,3,3,2,1,3,-4,4,0,-2,2,0,0,10,-70,-6,-1,7,-3,0,0,-1,-1,-1,1,3,-1
KR_6735561914,420,-7,-65,-52,-12,0,4,4,-6,6,0,2,1,3,-7,11,4,-1,3,-2,0,1,1,1,-2,1,5,0,-3,-1,-1,-1,-1,5,-1
KR_6761209097,420,2,36,24,5,3,0,3,5,1,6,0,2,2,-2,4,2,-1,1,0,0,-2,-99,7,-10,3,4,0,0,-1,1,0,1,4,-1
KR_6727265106,420,-1,-32,20,-5,-4,6,2,-3,6,3,-1,1,0,2,1,3,1,0,-1,1,1,-3,-4,-3,7,-1,0,-1,-1,-1,-1,1,6,-1
KR_6475927149,420,-2,-73,2,-6,-4,5,1,-2,6,4,4,2,6,0,3,3,-4,4,0,-1,8,18,-2,-2,4,-1,0,-2,1,-1,-1,-1,5,-1
KR_6746338109,420,-8,-99,-4,-13,-6,6,0,-1,3,2,0,1,1,-2,3,1,-4,4,0,-1,7,202,-3,-2,5,-29,0,-4,-1,-1,-1,-1,2,-1
KR_6747479641,440,-4,-32,-28,-15,-6,6,0,-5,9,4,-3,3,0,0,6,6,-1,1,0,1,5,-1,2,-2,0,3,0,0,-1,-1,-1,1,6,-1
KR_6600777877,420,4,66,-1,2,1,0,1,0,3,3,1,2,3,1,3,4,-1,1,0,0,4,1,1,-4,3,1,0,-1,-1,-1,-1,1,5,-1
KR_6758927583,420,2,-106,-7,-1,-1,2,1,-2,3,1,-3,4,1,3,0,3,2,0,-2,-1,-1,9,2,-3,1,2,0,0,1,-1,0,-1,2,-1
KR_6698994145,420,-6,-48,17,-15,0,2,2,-4,4,0,-4,4,0,-7,7,0,0,2,-2,0,20,0,-4,-4,8,2,0,-2,1,-1,-1,-1,3,-1
KR_6730808469,420,-1,-64,-19,4,5,1,6,-2,4,2,2,4,6,-1,3,2,0,1,-1,0,-3,-18,0,-3,3,0,0,0,0,0,-1,1,0,-1
KR_6722839566,440,-3,21,8,-7,3,1,4,-1,3,2,0,6,6,-8,8,0,-1,1,0,0,11,-2,0,-3,3,3,0,-1,-1,-1,-1,-1,2,-1
KR_6398103785,420,2,25,-42,4,-6,7,1,3,3,6,3,3,6,3,0,3,1,1,-2,0,-11,-1,-1,-7,8,-1,0,1,1,-1,1,-1,4,-1
KR_6762353123,420,0,11,16,-1,-1,2,1,0,2,2,2,0,2,0,1,1,-2,2,0,0,4,3,-2,-3,5,0,0,0,0,1,0,-1,0,-1
KR_6752726470,420,-5,-17,-27,-9,-5,5,0,0,3,3,-3,3,0,-2,3,1,1,0,-1,0,5,24,1,-5,4,1,0,-1,-1,0,-1,-1,6,-1
KR_6658612758,420,-3,-35,-14,-3,-1,1,0,0,2,2,-1,2,1,-4,5,1,3,0,-3,0,5,-5,-2,-3,5,-1,0,-1,1,-1,-1,-1,5,-1
KR_6754804605,440,-4,-38,-4,-8,1,1,2,0,3,3,-6,7,1,-3,4,1,0,1,-1,1,1,5,-2,-1,3,1,0,-2,-1,-1,-1,1,3,-1
KR_6741763248,420,-1,-85,-7,-1,-5,6,1,1,2,3,9,1,10,-3,3,0,-3,4,-1,0,4,5,1,-4,3,-1,0,-1,1,1,-1,1,6,-1
KR_6760539140,440,0,21,-8,-2,-3,3,0,4,1,5,1,0,1,-3,3,0,-1,1,0,0,-2,-4,-1,-3,4,-2,0,0,1,-1,0,-1,4,-1
KR_6763429913,420,1,-25,20,2,1,1,2,1,2,3,0,0,0,1,1,2,-1,1,0,0,-6,14,-1,-1,2,2,0,0,1,-1,1,-1,3,-1
KR_6758889755,420,0,-10,-1,-3,-6,7,1,0,2,2,5,4,9,2,1,3,-4,6,-2,0,-1,-6,-4,-3,7,0,0,-2,-1,-1,-1,-1,2,-1
KR_6705886176,420,-4,-89,-35,-7,-5,10,5,-2,3,1,-5,9,4,4,0,4,1,0,-1,0,0,0,-8,-3,11,3,0,-2,1,-1,-1,-1,5,-1
KR_6721765164,440,-5,-105,20,-14,-2,2,0,-4,4,0,-3,3,0,-4,6,2,-1,1,0,0,18,-4,-3,-1,4,0,0,0,1,0,-1,-1,3,-1
KR_6758490990,420,-2,-35,-12,-4,-2,4,2,-4,8,4,-3,4,1,4,1,5,1,0,-1,0,-5,7,1,-3,2,4,0,-2,-1,-1,-1,-1,5,-1
KR_6688921881,420,-5,-139,-42,-8,2,3,5,3,5,8,-4,4,0,-7,7,0,-2,3,-1,0,10,-9,2,-3,1,-2,0,-1,-1,-1,-1,1,2,-1
KR_6695888479,420,-1,-54,-20,-1,3,1,4,1,0,1,-5,7,2,-1,2,1,1,0,-1,-1,3,-113,-2,-4,6,4,0,-1,1,-1,-1,-1,3,-1
KR_6630615010,420,1,-44,-20,3,-4,4,0,1,2,3,-3,4,1,6,2,8,3,1,-4,0,-19,-272,4,-5,1,-2,0,-1,1,-1,-1,-1,2,-1
KR_6761709361,440,-3,-21,-19,-15,-4,4,0,-1,3,2,-4,5,1,-6,7,1,0,0,0,0,13,-8,-5,-2,7,-1,0,-1,-1,-1,-1,-1,5,-1
KR_6762098421,420,-1,-26,-12,-1,-4,6,2,3,0,3,-2,3,1,1,1,2,1,0,-1,0,-4,58,1,-8,7,36,0,-2,1,-1,-1,-1,2,-1
KR_6758125955,420,1,75,-3,1,3,4,7,-2,2,0,-1,4,3,0,3,3,1,0,-1,0,7,-1,3,-7,4,0,0,1,-1,1,1,1,2,-1
KR_6760430808,420,-1,0,0,-1,-1,2,1,2,0,2,3,0,3,-5,6,1,0,1,-1,0,2,-13,-1,-2,3,-6,0,-1,1,-1,-1,1,4,-1
KR_6683601617,420,0,-67,0,-1,-3,4,1,0,4,4,2,1,3,1,0,1,-1,1,0,0,2,-1,-1,-2,3,0,0,0,-1,-1,0,1,3,-1
KR_6742966246,420,0,70,-25,1,-1,3,2,0,6,6,0,1,1,3,1,4,-1,1,0,0,-2,-46,3,-5,2,1,0,0,1,-1,-1,-1,6,-1
KR_6615503268,420,-6,-124,9,-16,-5,7,2,-5,5,0,-4,4,0,0,3,3,-2,2,0,0,9,57,-3,-3,6,2,-1,-4,-1,1,-1,-1,5,-1
KR_6725943880,420,-6,-11,-21,-10,-5,5,0,0,2,2,-1,2,1,-4,5,1,0,0,0,0,11,8,1,-4,3,4,0,-3,-1,-1,-1,-1,4,-1
KR_6761982817,420,-3,-7,-1,-6,1,1,2,0,2,2,-3,7,4,-2,6,4,-2,2,0,1,3,-28,4,-8,4,-5,0,-1,0,0,-1,1,0,-1
KR_6736371614,420,-2,-48,-36,-3,0,2,2,-1,4,3,-2,3,1,0,1,1,0,1,-1,-1,2,1,4,-6,2,3,0,-2,-1,1,-1,-1,4,-1
KR_6747397523,420,-4,-30,-14,-11,-5,6,1,-2,4,2,-2,3,1,-3,4,1,1,2,-3,0,6,-2,1,-2,1,2,0,-2,0,-1,-1,-1,0,-1
KR_6763044650,440,-3,-1,4,-9,-4,4,0,1,2,3,-6,6,0,1,2,3,-1,3,-2,-1,3,-1,-1,-5,6,2,0,-1,0,-1,-1,-1,0,-1
KR_6762405616,420,-1,0,13,-10,-2,3,1,-3,3,0,2,1,3,-4,4,0,-3,3,0,0,12,3,-2,-4,6,5,0,-2,-1,0,-1,-1,3,-1
KR_6738233499,440,-7,-94,-44,-13,-3,3,0,-7,10,3,2,3,5,-5,11,6,0,0,0,1,12,97,-4,-2,6,7,0,-2,-1,-1,-1,1,5,-1
KR_6728504710,420,-5,-41,8,-11,4,2,6,-3,4,1,-9,10,1,-2,3,1,-1,2,-1,0,13,-48,5,-7,2,-24,0,1,-1,1,1,1,4,-1
KR_6641153552,420,-2,23,21,-10,-6,6,0,-1,3,2,2,2,4,-5,5,0,0,0,0,0,17,30,-1,-2,3,3,0,-1,-1,0,-1,1,5,-1
KR_6751940531,420,-3,-19,-49,-6,2,0,2,-2,3,1,-6,6,0,0,2,2,0,0,0,-1,2,-5,-1,-4,5,3,0,-2,-1,-1,-1,-1,3,-1
KR_6709851668,420,-8,-92,-43,-17,0,2,2,-5,7,2,-3,3,0,-10,10,0,1,1,-2,-2,20,-1,1,-4,3,-1,0,-2,-1,0,-1,-1,2,-1
KR_6757640065,440,1,-14,12,3,-2,2,0,0,0,0,13,0,13,-7,8,1,-1,1,0,-1,2,15,1,-2,1,2,0,0,0,0,1,-1,0,-1
KR_6759635655,420,-6,-90,-26,-10,-2,4,2,-2,4,2,-4,4,0,-3,3,0,1,0,-1,-1,17,-9,1,-4,3,-3,0,-2,-1,-1,-1,-1,4,-1
KR_6737196746,420,-1,-23,-4,-3,0,1,1,1,3,4,-5,5,0,2,1,3,-1,1,0,0,-3,-27,1,-7,6,-8,0,-1,-1,1,-1,-1,6,-1
KR_6747078560,420,0,69,8,-1,0,3,3,0,4,4,-2,3,1,2,1,3,-1,4,-3,0,-1,0,1,-3,2,0,0,0,1,0,0,-1,4,-1
KR_6764556115,440,-3,-40,-7,-11,1,3,4,-2,3,1,1,2,3,-9,9,0,-2,2,0,-3,17,-24,-8,0,8,1,0,-3,1,-1,-1,-1,3,-1
KR_6714305061,420,1,65,4,-1,5,0,5,-3,4,1,-3,5,2,0,2,2,0,0,0,0,5,-3,-3,-3,6,-2,0,0,-1,-1,0,1,6,-1
KR_6759618663,440,-4,-5,-21,-13,-1,3,2,-7,7,0,-1,3,2,0,2,2,-4,4,0,0,16,170,-1,-5,6,0,0,0,-1,0,0,-1,4,-1
KR_6658894914,420,-2,23,16,-7,2,2,4,-4,6,2,0,2,2,-3,4,1,-2,2,0,0,5,-19,-2,-3,5,-2,0,1,-1,1,1,1,5,-1
KR_6650679326,420,-4,-7,5,-7,0,2,2,2,4,6,-3,4,1,-3,4,1,-3,3,0,0,4,0,2,-6,4,-1,0,1,1,-1,1,-1,5,-1
KR_6750108839,420,0,-51,25,1,1,2,3,-1,5,4,-1,2,1,3,1,4,-1,3,-2,0,2,12,0,-3,3,0,0,-2,1,-1,-1,-1,6,-1
KR_6742002083,420,-3,-65,4,-10,-1,1,0,-7,8,1,-2,2,0,-1,3,2,1,1,-2,0,7,1,4,-6,2,1,0,0,-1,1,-1,-1,5,-1
KR_6743174734,420,-3,-27,-24,-4,-2,4,2,-5,9,4,0,3,3,2,2,4,1,5,-6,0,4,-4,0,-2,2,0,0,-2,1,-1,-1,-1,4,-1
KR_6744837405,420,-2,14,-8,-3,-1,3,2,-2,2,0,1,0,1,-1,3,2,0,2,-2,0,5,31,-1,-6,7,1,0,0,1,-1,0,1,3,-1
KR_6699747415,420,-4,-18,-24,-10,2,3,5,-5,7,2,0,3,3,-2,2,0,-5,6,-1,0,13,-35,-1,-3,4,-1,0,-1,-1,0,-1,-1,2,-1
KR_6706751652,440,-2,-25,-20,-8,-2,3,1,-2,4,2,-6,6,0,2,3,5,0,0,0,0,5,3,2,-4,2,3,0,0,-1,1,0,-1,3,-1
KR_6689825271,420,-1,-13,-10,-4,3,0,3,-5,6,1,-5,6,1,1,4,5,2,0,-2,-1,-4,0,0,-3,3,-1,0,-1,1,-1,-1,-1,4,-1
KR_6760820864,420,-2,-13,4,-9,-2,4,2,-1,3,2,-1,4,3,-6,7,1,1,3,-4,-1,15,-6,0,-3,3,-2,0,-1,0,-1,-1,-1,0,-1
KR_6566815737,420,-1,-31,-24,-1,5,1,6,-4,5,1,2,2,4,0,1,1,-4,4,0,-1,9,-23,-1,-3,4,3,0,0,-1,1,0,-1,3,-1
KR_6738399083,440,0,7,0,-4,-1,2,1,1,1,2,-3,4,1,0,3,3,-1,2,-1,0,9,-3,3,-8,5,5,0,0,1,-1,0,-1,4,-1
KR_6719270275,440,-2,13,7,-6,-3,4,1,-4,4,0,1,1,2,0,2,2,0,2,-2,0,9,2,1,-5,4,5,0,-1,0,-1,-1,-1,0,-1
KR_6698283928,420,0,-81,2,2,-1,2,1,1,2,3,-4,5,1,-2,7,5,8,0,-8,1,-11,8,5,-8,3,3,0,-1,1,1,-1,1,1,-1
KR_6762638342,420,-2,64,19,-16,2,0,2,-2,4,2,-5,5,0,-8,10,2,-3,6,-3,0,7,-64,-1,-2,3,3,0,0,-1,-1,-1,-1,4,-1
KR_6752871949,420,-6,-90,-32,-12,-3,3,0,-7,9,2,-5,10,5,3,0,3,0,1,-1,-1,8,10,-1,-4,5,-1,0,-1,-1,-1,-1,-1,1,-1
KR_6680124795,420,-1,59,-28,-4,0,0,0,-5,8,3,-2,2,0,1,1,2,2,0,-2,-1,12,4,-2,-7,9,1,0,1,-1,1,1,-1,3,-1
KR_6763516692,440,-3,-17,-4,-12,-1,3,2,-2,4,2,-6,7,1,-3,5,2,0,3,-3,0,6,-2,-2,-3,5,-3,0,-1,1,-1,-1,-1,5,-1
KR_6648119370,420,2,43,-8,3,2,1,3,4,1,5,-1,1,0,-4,5,1,2,0,-2,0,-3,-35,-1,-5,6,5,0,-1,-1,-1,-1,1,1,-1
KR_6760995135,420,-4,-1,-20,-15,-4,4,0,-8,8,0,-5,6,1,2,4,6,0,0,0,0,12,-4,-2,-4,6,0,0,1,-1,-1,1,-1,2,-1
KR_6723772226,440,-2,-34,-24,0,-2,3,1,-3,6,3,1,1,2,3,2,5,1,0,-1,0,2,-4,-2,-3,5,-3,0,0,-1,0,0,1,2,-1
KR_6659742952,420,-1,-30,-7,0,-2,4,2,1,3,4,0,0,0,1,1,2,0,1,-1,0,-2,-2,0,-3,3,0,0,0,-1,1,0,-1,5,-1
KR_6730345324,420,-6,-87,-29,-14,-5,5,0,-3,4,1,1,1,2,-4,9,5,-3,3,0,0,7,-41,3,-5,2,-11,0,-4,-1,1,-1,-1,3,-1
KR_6690463429,420,-4,-70,32,-11,-1,1,0,0,4,4,-3,3,0,-6,6,0,-1,1,0,0,15,107,2,-5,3,2,0,-1,-1,-1,-1,1,4,-1
KR_6650958601,420,0,8,-7,5,-2,4,2,3,2,5,0,1,1,4,2,6,0,2,-2,0,-6,5,3,-6,3,-1,0,0,1,1,-1,-1,1,-1
KR_6762239420,420,-4,56,-30,-6,0,1,1,-3,4,1,1,1,2,-2,3,1,-2,2,0,0,6,-20,1,-2,1,-1,0,0,-1,0,-1,-1,5,-1
KR_6701529282,440,-1,-1,-16,-4,2,0,2,0,7,7,-3,3,0,1,4,5,-4,5,-1,0,4,5,-1,-4,5,-2,0,0,-1,-1,0,-1,3,-1
KR_6752591407,420,1,-18,-9,0,0,2,2,-1,2,1,0,0,0,1,4,5,0,2,-2,0,-5,-15,-2,-5,7,-6,0,1,-1,1,1,-1,4,-1
KR_6760118526,420,-2,-56,-1,-12,-3,7,4,-4,6,2,-1,4,3,-6,8,2,2,3,-5,-1,16,-8,-1,-3,4,5,0,0,-1,1,-1,-1,1,-1
KR_6635468309,420,-2,55,-27,-4,-1,2,1,6,1,7,-5,5,0,-4,5,1,0,0,0,-1,10,0,4,-8,4,0,0,1,1,1,1,-1,6,-1
KR_6757305014,420,-2,-66,-30,-2,1,2,3,-2,4,2,-1,1,0,-2,5,3,2,1,-3,1,0,-125,-1,-2,3,-3,0,0,1,1,-1,1,4,-1
KR_6761857890,420,0,37,-81,4,2,1,3,1,2,3,-1,2,1,-1,5,4,3,0,-3,0,0,0,-1,-5,6,5,0,-1,0,0,-1,1,0,-1
KR_6756470585,420,0,7,-14,-6,3,0,3,2,2,4,-3,3,0,-1,1,0,-7,7,0,-1,5,6,2,-6,4,1,0,0,-1,1,-1,-1,4,-1
KR_6658038780,420,0,-27,-43,4,4,1,5,-8,9,1,3,0,3,3,0,3,2,2,-4,0,-5,-14,-1,-3,4,-8,0,1,-1,1,1,1,1,-1
KR_6764082500,440,-3,-32,-21,-9,1,2,3,-1,1,0,-1,2,1,-5,6,1,-3,3,0,0,12,-43,-5,-3,8,-20,0,-2,-1,-1,-1,-1,5,-1
KR_6674727163,420,0,-13,-19,0,-4,4,0,-3,4,1,1,2,3,4,1,5,2,1,-3,0,-5,4,3,-6,3,4,0,0,-1,-1,-1,1,2,-1
KR_6685857850,420,-3,-45,-41,-4,-3,3,0,0,5,5,1,5,6,-2,4,2,0,1,-1,0,3,-16,4,-7,3,3,0,0,1,1,1,1,1,-1
KR_6756309893,420,1,-20,-16,12,1,3,4,1,1,2,3,1,4,8,1,9,-1,3,-2,-1,-13,-26,2,-5,3,-22,0,1,-1,1,1,-1,4,-1
KR_6655786235,420,-1,17,-19,-3,-1,2,1,2,2,4,-1,1,0,-1,1,0,-2,2,0,-1,6,2,-4,-6,10,-3,0,-1,1,0,-1,-1,5,-1
KR_6746715061,420,-3,-67,-7,-8,-3,4,1,-1,4,3,-2,3,1,-1,1,0,-1,1,0,0,2,-9,-1,-5,6,3,0,-1,-1,1,-1,-1,3,-1
KR_6763605436,420,0,35,42,-7,-2,2,0,0,2,2,-4,4,0,-1,4,3,0,1,-1,0,9,8,3,-6,3,2,0,0,1,1,0,-1,3,-1
KR_6749576153,420,-2,-86,0,-2,2,0,2,-2,3,1,2,0,2,-3,3,0,-1,2,-1,0,7,0,-1,-1,2,0,0,0,-1,1,0,-1,6,-1
KR_6706509464,420,0,-13,-4,2,-4,4,0,-3,4,1,3,0,3,4,0,4,2,0,-2,0,-10,-5,0,-4,4,-2,0,1,-1,1,1,1,4,-1
KR_6647989730,420,0,30,-32,3,0,3,3,-3,4,1,1,0,1,3,1,4,2,0,-2,1,-7,40,2,-6,4,-4,0,0,-1,1,0,1,6,-1
KR_6763302334,440,-2,20,15,-4,-4,4,0,0,0,0,-1,4,3,-1,1,0,2,0,-2,-1,7,-20,-4,-5,9,1,0,0,1,-1,-1,-1,6,-1
KR_6684907579,420,0,3,13,0,-4,5,1,-1,3,2,4,1,5,-2,5,3,3,0,-3,1,-3,10,3,-6,3,3,0,1,-1,1,1,1,5,-1
KR_6763634676,420,-3,-23,-4,-6,3,0,3,0,2,2,-5,5,0,0,1,1,-4,4,0,0,12,-7,-4,0,4,1,0,-2,-1,-1,-1,1,2,-1
KR_6762100735,440,-1,68,4,-9,1,1,2,-2,3,1,-1,2,1,-5,5,0,-2,3,-1,0,7,-2,0,-2,2,-3,0,-1,0,-1,-1,-1,0,-1
KR_6762985410,420,-1,-18,-20,0,1,3,4,1,1,2,-1,2,1,-2,3,1,1,0,-1,0,2,41,0,-5,5,6,0,0,0,0,0,1,0,-1
KR_6733198781,420,-6,-87,-7,-11,-4,4,0,4,0,4,1,2,3,-8,10,2,-4,4,0,0,13,-13,-1,-2,3,4,0,-1,-1,0,-1,1,5,-1
KR_6722625062,420,-2,-33,3,-5,-1,3,2,-2,4,2,1,0,1,-3,3,0,0,0,0,0,7,-287,2,-5,3,19,0,-1,1,-1,-1,1,5,-1
KR_6747900707,420,0,-6,8,3,-1,1,0,0,4,4,-5,5,0,5,0,5,4,0,-4,0,-9,14,7,-8,1,3,0,0,-1,-1,-1,1,3,-1
KR_6725121783,440,0,12,6,-1,2,2,4,4,2,6,-2,2,0,-7,7,0,2,1,-3,0,7,15,-3,-3,6,-2,0,1,-1,1,1,-1,2,-1
KR_6763342004,420,-1,-23,-8,-4,-5,6,1,3,0,3,-2,2,0,-2,4,2,2,0,-2,0,-5,4,3,-7,4,-3,0,-1,-1,1,-1,1,1,-1
KR_6758071161,420,-3,13,-15,-3,-5,5,0,-2,5,3,3,2,5,-2,2,0,3,0,-3,0,1,2,6,-7,1,3,0,0,-1,1,-1,-1,3,-1
KR_6719077147,420,-7,-162,-35,-15,0,2,2,-2,4,2,-7,9,2,-7,8,1,1,1,-2,0,13,-36,1,-5,4,3,0,-1,-1,1,-1,-1,4,-1
KR_6698608048,420,-1,42,-3,2,-5,5,0,-1,1,0,-2,2,0,9,3,12,1,0,-1,0,-7,325,-4,-4,8,3,0,3,-1,1,1,1,3,-1
KR_6752166145,420,-3,-4,-10,-4,-4,5,1,-3,3,0,1,0,1,0,2,2,2,0,-2,0,3,15,-3,-2,5,-3,0,0,1,-1,-1,1,1,-1
KR_6764392159,420,-5,-82,-4,-14,-5,7,2,-5,5,0,-2,5,3,-2,3,1,0,0,0,-2,14,16,0,-4,4,5,0,-1,-1,-1,-1,-1,2,-1
KR_6764362739,440,0,18,-20,-10,-2,6,4,-1,1,0,-7,7,0,2,2,4,-2,2,0,0,8,-13,-4,0,4,-3,0,0,-1,-1,1,-1,3,-1
KR_6763926615,420,-1,-65,30,-5,0,2,2,-3,4,1,-2,6,4,-2,4,2,2,1,-3,0,14,-10,-2,-5,7,3,0,-1,1,1,-1,1,2,-1
KR_6754319409,420,-6,-63,-20,-15,-8,8,0,-4,5,1,-3,4,1,-2,7,5,2,1,-3,0,6,-1,-5,0,5,3,0,-3,-1,-1,-1,-1,4,-1
KR_6761607506,420,3,53,16,6,2,1,3,-2,5,3,0,0,0,4,2,6,2,1,-3,0,-4,4,1,-7,6,1,0,1,-1,1,1,-1,3,-1
KR_6763775342,420,-3,-56,-28,-6,-4,4,0,-5,5,0,2,3,5,2,0,2,-1,1,0,0,2,3,4,-6,2,-1,0,0,-1,-1,-1,-1,4,-1
KR_6414962066,420,-2,-24,-20,2,-1,4,3,2,2,4,1,2,3,1,2,3,-1,4,-3,0,0,8,3,-6,3,4,0,0,1,1,0,1,3,-1
KR_6735245611,420,-7,-36,16,-13,-1,3,2,-6,9,3,0,4,4,-3,4,1,-3,4,-1,-1,10,-14,-2,-5,7,-3,0,-3,-1,-1,-1,-1,6,-1
KR_6726832041,420,0,-46,-24,1,-2,3,1,-1,1,0,0,1,1,3,0,3,1,1,-2,0,-4,1,1,-2,1,-1,0,0,1,-1,-1,1,3,-1
KR_6756372558,440,-4,24,1,-9,-3,7,4,-5,6,1,-1,3,2,-2,3,1,2,2,-4,0,5,10,3,-4,1,-1,0,-1,1,-1,-1,-1,3,-1
KR_6752320052,420,-1,-48,4,5,0,1,1,3,0,3,5,0,5,-3,3,0,0,2,-2,0,-6,6,2,-5,3,0,0,0,-1,1,1,1,4,-1
KR_6763112335,420,-2,-25,-31,-1,-2,2,0,4,3,7,1,1,2,-2,4,2,-2,2,0,0,8,321,-6,-2,8,1,0,0,-1,1,-1,-1,1,-1
KR_6730808933,420,-5,-46,-9,-5,-1,2,1,-3,6,3,3,1,4,-7,8,1,3,0,-3,0,4,-9,-4,-3,7,0,0,-1,-1,1,-1,-1,6,-1
KR_6758894619,420,0,18,12,-2,2,0,2,0,2,2,0,5,5,-4,8,4,0,1,-1,0,10,-5,-1,-3,4,0,0,0,1,-1,-1,1,1,-1
KR_6762383300,420,-4,44,-5,-7,0,2,2,-5,6,1,0,2,2,0,4,4,-2,3,-1,0,7,15,-3,-1,4,0,0,-1,1,-1,-1,1,1,-1
KR_6755792559,420,0,18,0,-4,3,0,3,2,5,7,-2,3,1,-8,11,3,1,0,-1,0,3,-24,0,-6,6,-3,0,1,1,-1,1,-1,4,-1
KR_6620881806,420,-4,-47,8,-12,-4,4,0,-7,8,1,2,2,4,0,3,3,-3,3,0,0,14,-19,-1,-4,5,0,0,1,-1,1,1,1,5,-1
KR_6764479737,420,0,-5,-5,4,-1,1,0,5,2,7,0,1,1,-1,4,3,1,2,-3,-1,-6,19,-2,-2,4,-4,0,0,1,-1,0,-1,5,-1
KR_6735338472,420,3,54,12,10,4,0,4,0,2,2,-3,3,0,8,2,10,1,0,-1,0,-7,-6,-1,-2,3,-2,0,2,1,1,1,1,2,-1
KR_6755694716,440,-7,-42,-56,-9,-4,5,1,2,1,3,-3,5,2,-4,5,1,0,2,-2,0,7,1,-7,-3,10,-3,0,-1,-1,-1,-1,-1,1,-1
KR_6734271351,440,-2,-66,-15,-3,-1,2,1,4,0,4,-1,1,0,-4,6,2,-1,1,0,0,-4,-10,0,-3,3,-3,0,0,-1,0,0,-1,4,-1
KR_6638492322,420,-2,-41,3,-4,1,1,2,2,2,4,-3,6,3,-4,4,0,0,1,-1,0,1,5,-4,-2,6,-2,0,0,-1,1,1,1,3,-1
KR_6760146970,420,-2,68,-8,-4,-3,3,0,-1,3,2,0,3,3,4,2,6,-4,4,0,0,3,1,-1,-6,7,0,0,1,-1,0,1,-1,5,-1
KR_6709607496,440,-6,-64,-41,-11,-6,7,1,-2,4,2,-1,2,1,-2,3,1,0,0,0,0,4,-3,-3,-3,6,0,-1,-3,0,-1,-1,-1,0,-1
KR_6749051370,440,-1,26,4,-6,-2,3,1,0,1,1,-2,4,2,-1,2,1,-1,2,-1,-2,8,-4,-2,-3,5,-3,0,0,1,-1,0,-1,3,-1
KR_6744236634,420,1,4,-2,5,-2,3,1,4,1,5,2,0,2,1,2,3,0,2,-2,0,-7,-113,4,-6,2,1,0,-1,1,-1,-1,-1,4,-1
KR_6740564887,420,-1,-1,4,-4,-2,3,1,-4,5,1,0,3,3,4,3,7,-2,3,-1,0,2,23,5,-10,5,5,0,-1,-1,0,-1,-1,3,-1
KR_6735208444,420,-2,-55,-9,-4,2,1,3,0,2,2,2,1,3,-6,9,3,-2,3,-1,0,4,-5,2,-4,2,-2,0,0,1,-1,-1,-1,5,-1
KR_6753692534,420,-3,-7,-34,-6,1,1,2,0,2,2,-7,10,3,1,0,1,-1,2,-1,0,4,-7,-1,-3,4,-2,0,-3,-1,-1,-1,-1,6,-1
KR_6596832852,420,-3,14,-12,-2,-2,3,1,-5,8,3,1,1,2,2,1,3,2,0,-2,1,-1,-1,3,-5,2,-1,0,-3,1,-1,-1,1,3,-1
KR_6746868167,420,-1,42,17,-7,-3,3,0,-1,3,2,3,0,3,-6,6,0,0,0,0,0,7,4,-1,-4,5,4,0,-1,1,-1,-1,-1,3,-1
KR_6748193143,420,-3,16,-24,-6,-2,4,2,-3,3,0,-1,2,1,2,0,2,-2,3,-1,0,5,1,1,-5,4,-3,0,0,0,-1,1,-1,0,-1
KR_6740164316,420,-3,-28,-8,0,-1,2,1,-3,4,1,2,0,2,3,0,3,-1,2,-1,0,2,-121,-1,-4,5,-2,0,0,-1,-1,0,1,1,-1
KR_6698425403,420,-6,-119,-48,-9,-2,3,1,0,6,6,-6,7,1,0,5,5,-1,1,0,-2,8,6,6,-10,4,6,0,-2,-1,-1,-1,-1,3,-1
KR_6760665363,440,1,3,-6,-1,-1,1,0,4,1,5,-1,1,0,3,1,4,-6,6,0,0,3,-5,3,-6,3,-4,0,-1,1,1,1,-1,5,-1
KR_6695720645,420,1,-26,-31,-1,1,1,2,0,2,2,3,4,7,-2,2,0,-3,5,-2,0,4,-50,2,-6,4,-35,0,0,-1,0,0,-1,6,-1
KR_6739073788,420,-2,26,-24,-5,2,0,2,3,5,8,-4,5,1,-5,5,0,-1,1,0,0,7,-6,1,-5,4,8,0,-1,-1,0,-1,-1,5,-1
KR_6574513389,420,1,22,-7,4,2,2,4,3,2,5,-1,1,0,3,1,4,-3,3,0,0,-3,1,0,-6,6,0,0,0,1,0,1,1,1,-1
KR_6660121388,420,-1,-80,1,-1,0,0,0,6,1,7,-1,3,2,-6,7,1,0,0,0,0,2,20,1,-5,4,4,0,-2,-1,1,-1,1,3,-1
KR_6680210809,420,0,-25,52,-1,2,0,2,5,4,9,1,1,2,-7,9,2,-2,2,0,1,8,-3,7,-11,4,2,0,-3,1,-1,-1,1,2,-1
KR_6764233317,420,0,71,28,-2,-3,4,1,-3,4,1,-1,1,0,4,0,4,1,0,-1,0,0,2,1,-6,5,2,0,1,0,-1,1,1,0,-1
KR_6745700054,420,-3,-26,-4,-9,3,0,3,0,2,2,-11,11,0,1,1,2,-2,3,-1,-1,12,2,-3,-4,7,-4,0,0,-1,1,1,-1,6,-1
KR_6751489280,420,-1,-13,-20,1,5,0,5,-3,3,0,1,0,1,-1,2,1,-1,2,-1,0,4,28,5,-6,1,2,0,0,0,1,1,-1,0,-1
KR_6705747865,420,-3,-22,-8,-4,1,2,3,1,0,1,-3,4,1,-3,3,0,0,0,0,1,1,-3,-4,-2,6,2,0,-2,-1,-1,-1,1,1,-1
KR_6762285084,420,-1,-81,21,-1,-1,1,0,1,3,4,-2,2,0,1,2,3,0,1,-1,0,0,30,-1,-5,6,2,0,0,1,-1,0,-1,4,-1
KR_6756168547,420,0,-3,22,11,1,2,3,3,3,6,1,1,2,6,3,9,0,2,-2,0,-9,5,6,-6,0,-2,0,0,1,0,0,1,3,-1
KR_6619709394,420,0,-33,16,-5,4,0,4,0,2,2,-2,4,2,-6,7,1,-1,2,-1,1,9,-12,-5,-4,9,-1,0,0,-1,0,0,1,6,-1
KR_6741635141,420,-1,-25,-8,-1,0,0,0,4,2,6,-1,1,0,-3,4,1,-1,1,0,0,0,-3,-4,-2,6,0,0,-1,-1,-1,-1,-1,1,-1
KR_6739901431,420,-5,-102,-13,-8,5,1,6,-4,6,2,-3,3,0,-2,4,2,-4,5,-1,-3,11,0,3,-7,4,0,0,-3,1,-1,-1,-1,5,-1
KR_6744425439,420,-4,-31,-18,-1,4,1,5,-1,2,1,0,1,1,-4,6,2,0,3,-3,-1,3,2,-4,-4,8,-3,0,-1,-1,1,-1,-1,5,-1
KR_6672613811,420,-4,-18,-56,-2,0,3,3,-8,9,1,2,3,5,2,1,3,2,1,-3,0,-12,-17,4,-5,1,-2,0,-1,0,-1,-1,-1,0,-1
KR_6742055451,440,0,-103,-20,3,-6,6,0,3,1,4,0,2,2,4,3,7,2,2,-4,0,-7,9,2,-3,1,2,0,0,-1,0,1,1,6,-1
KR_6652835316,420,-4,-39,-4,-10,-3,3,0,-4,5,1,-1,1,0,-1,3,2,-1,1,0,0,6,-17,1,-6,5,0,0,0,1,-1,-1,-1,2,-1
KR_6761831465,440,-5,-85,-33,-19,-4,5,1,-4,4,0,0,6,6,-10,14,4,-1,1,0,-3,19,3,-4,-1,5,6,0,-3,-1,-1,-1,-1,5,-1
KR_6688768403,420,-2,34,-32,-2,-1,1,0,-1,4,3,5,7,12,-2,3,1,-3,4,-1,0,7,8,-2,-4,6,21,0,0,1,-1,-1,-1,6,-1
KR_6729032374,440,-3,-42,-30,-6,-1,1,0,2,2,4,-1,5,4,1,3,4,-7,8,-1,-3,18,5,6,-7,1,5,0,-1,-1,1,-1,-1,6,-1
KR_6761482460,420,0,-27,-4,-2,-7,7,0,5,2,7,0,4,4,-1,2,1,1,0,-1,-1,-7,-20,-2,-1,3,2,0,-1,-1,0,-1,-1,4,-1
KR_6760207109,420,-2,-20,-24,-4,-2,3,1,-4,6,2,0,3,3,1,1,2,1,0,-1,0,2,0,2,-6,4,1,0,-1,-1,-1,-1,-1,6,-1
KR_6733307004,440,-3,-46,9,-13,2,1,3,-2,4,2,-4,6,2,-3,6,3,-6,8,-2,0,8,2,0,-3,3,2,0,0,0,1,0,1,0,-1
KR_6739799893,420,-1,46,19,-7,-4,6,2,0,3,3,-3,4,1,1,2,3,-1,3,-2,1,8,30,5,-8,3,9,0,1,1,1,1,1,2,-1
KR_6763112985,420,-4,-25,16,-7,-4,5,1,2,0,2,-1,5,4,-3,3,0,-1,2,-1,-1,6,-2,-4,-5,9,-4,0,-1,-1,-1,-1,-1,2,-1
KR_6739243961,420,1,10,8,-1,-2,3,1,1,1,2,3,2,5,-3,6,3,0,3,-3,0,4,-5,0,-3,3,-2,0,-1,-1,-1,-1,1,2,-1
KR_6755474264,420,-2,-71,-17,-8,0,2,2,-2,5,3,-1,1,0,-6,7,1,1,1,-2,-1,8,6,-2,-1,3,1,0,0,0,-1,-1,1,0,-1
KR_6728078343,420,-1,20,-5,-4,1,2,3,1,2,3,-1,1,0,-5,7,2,0,1,-1,0,8,1,0,-5,5,3,0,1,0,1,1,-1,0,-1
KR_6706161152,420,-2,-3,4,-7,1,1,2,-3,3,0,1,3,4,-1,2,1,-5,5,0,0,5,-9,-3,-2,5,-2,0,-1,-1,1,-1,1,6,-1
KR_6763227268,420,3,26,28,2,5,0,5,-3,3,0,1,0,1,-1,1,0,0,0,0,0,-1,-3,2,-7,5,0,0,0,1,1,0,-1,4,-1
KR_6683581297,440,-6,-129,-26,-11,2,1,3,-2,5,3,-5,8,3,-4,5,1,-2,3,-1,-3,12,5,5,-7,2,2,0,0,-1,-1,-1,-1,2,-1
KR_6763534633,420,1,-33,20,3,3,1,4,3,1,4,1,2,3,-4,6,2,0,1,-1,0,-7,-8,1,-8,7,-2,0,0,1,-1,-1,-1,3,-1
KR_6694794386,420,4,69,20,0,2,1,3,-2,3,1,0,3,3,-1,3,2,1,1,-2,0,0,-6,2,-4,2,2,0,0,-1,-1,0,-1,4,-1
KR_6639369046,420,-1,-64,-24,-2,-2,2,0,-2,8,6,0,1,1,2,1,3,0,0,0,0,-6,-65,-2,-4,6,-2,0,-1,1,1,-1,-1,5,-1
KR_6752218922,420,-4,-82,-19,-8,0,4,4,2,2,4,-3,3,0,-4,5,1,-3,3,0,0,7,-1,-4,-2,6,3,0,-2,-1,-1,-1,-1,4,-1
KR_6704107937,420,-3,-87,-13,-5,-7,7,0,1,3,4,0,2,2,2,4,6,-1,2,-1,0,-9,7,2,-5,3,1,0,-2,-1,-1,-1,1,3,-1
KR_6763541958,420,-5,-44,0,-4,-3,4,1,0,1,1,1,4,5,-1,3,2,-1,2,-1,1,7,-56,-2,-4,6,2,0,0,1,-1,-1,1,4,-1
KR_6758967267,440,-5,14,-13,-16,-6,6,0,2,3,5,-1,3,2,-10,10,0,-1,2,-1,0,11,1,-1,-2,3,2,0,-1,-1,-1,-1,1,2,-1
KR_6762496647,420,0,-23,56,0,-7,7,0,4,0,4,3,2,5,0,1,1,0,0,0,0,4,-8,-3,-3,6,-4,0,-1,-1,1,-1,-1,6,-1
KR_6761105721,420,-1,-40,-12,-2,1,1,2,0,3,3,-4,4,0,1,2,3,0,1,-1,-1,6,-12,1,-9,8,3,0,0,-1,1,0,-1,6,-1
KR_6653179789,420,2,-12,4,-1,-1,2,1,-2,2,0,3,1,4,-2,2,0,1,0,-1,0,6,22,-4,-1,5,2,0,-1,-1,-1,-1,-1,4,-1
KR_6357082756,420,0,-6,-4,-2,0,1,1,0,5,5,1,1,2,-3,3,0,0,0,0,0,8,0,0,0,0,13,0,0,-1,1,0,1,3,-1
KR_6761716139,420,-1,-3,-7,-6,-9,10,1,-1,4,3,-1,2,1,6,2,8,-1,2,-1,1,1,-4,-2,-4,6,1,0,-1,-1,-1,-1,1,2,-1
KR_6749216060,420,-3,-117,-4,1,1,2,3,0,5,5,1,1,2,-2,2,0,1,0,-1,0,0,-2,1,-4,3,1,0,0,-1,0,0,1,4,-1
KR_6603758924,420,-5,-71,30,-10,-3,3,0,-1,1,0,1,3,4,-5,7,2,-2,3,-1,0,16,148,-4,-2,6,1,0,1,-1,1,1,-1,2,-1
KR_6762368982,420,2,19,-12,5,1,3,4,-1,4,3,3,1,4,2,0,2,0,0,0,0,-8,-12,-3,-4,7,0,0,0,1,-1,0,1,5,-1
KR_6757064737,420,1,-18,-32,-8,0,2,2,-2,4,2,-2,2,0,-5,7,2,1,4,-5,-1,12,2,-3,-1,4,0,0,0,-1,0,0,-1,3,-1
KR_6710279339,420,-5,-94,-4,-9,-4,4,0,-3,3,0,-2,2,0,-3,5,2,3,0,-3,0,6,0,0,-5,5,5,0,-1,0,-1,-1,-1,0,-1
KR_6740615898,420,0,-23,-12,-3,2,2,4,-1,6,5,1,4,5,0,3,3,-5,6,-1,0,5,-5,-1,-3,4,-2,0,-1,1,1,-1,-1,1,-1
KR_6414475037,420,-6,-84,-25,-18,-7,7,0,1,0,1,-4,5,1,-7,7,0,-1,1,0,0,12,-12,2,-2,0,0,0,-3,-1,0,-1,-1,4,-1
KR_6720134990,420,-1,-4,-18,-1,-2,3,1,1,2,3,1,2,3,-2,4,2,1,1,-2,0,-1,-20,1,-2,1,3,0,0,-1,-1,1,-1,1,-1
KR_6759545047,420,0,19,-13,-1,2,0,2,0,1,1,-5,5,0,1,0,1,1,0,-1,0,6,1,3,-8,5,2,0,1,1,-1,1,-1,6,-1
KR_6756539208,420,-1,60,-22,-4,-1,2,1,1,1,2,2,3,5,-4,8,4,-2,3,-1,0,-8,-1,1,-4,3,-4,0,0,1,-1,0,1,5,-1
KR_6749563264,420,-7,-61,-10,-13,1,1,2,-4,4,0,-3,3,0,-5,6,1,-2,2,0,0,11,-9,-3,-3,6,-5,0,-1,1,-1,-1,-1,4,-1
KR_6713966568,420,-4,-119,-17,-5,2,0,2,-4,4,0,-3,5,2,-1,2,1,1,0,-1,0,1,26,1,-4,3,8,0,-1,-1,0,-1,-1,2,-1
KR_6747489906,440,3,23,-10,0,6,0,6,-2,4,2,-5,7,2,2,3,5,-1,1,0,0,1,-45,1,-4,3,-19,0,0,-1,0,0,1,1,-1
KR_6639406463,420,-4,-77,10,-3,-2,4,2,0,3,3,1,0,1,-1,2,1,-1,3,-2,0,1,-4,-2,-5,7,3,0,-1,-1,0,-1,-1,6,-1
KR_6648345959,420,-3,-10,-12,-2,1,2,3,1,2,3,-1,2,1,-3,4,1,0,1,-1,0,5,-8,-5,-2,7,-2,0,0,-1,1,0,-1,2,-1
KR_6665272254,420,-1,25,1,2,2,0,2,2,1,3,0,2,2,-1,2,1,-1,1,0,0,4,6,3,-7,4,-4,0,0,1,1,1,1,3,-1
KR_6746069738,420,-1,-6,-8,-4,-1,1,0,-7,8,1,-2,4,2,3,0,3,3,1,-4,0,8,-3,0,-6,6,-5,0,1,-1,1,1,1,2,-1
KR_6671639942,420,1,-45,-6,-2,2,2,4,-1,4,3,2,1,3,-3,4,1,-2,2,0,0,3,205,1,-3,2,-14,0,0,1,-1,-1,-1,4,-1
KR_6757964879,420,-1,4,0,-1,0,1,1,2,1,3,-2,3,1,-5,8,3,4,0,-4,0,-10,6,2,-6,4,2,0,0,-1,-1,-1,-1,3,-1
KR_6758377065,420,-1,-35,-27,-1,-1,3,2,2,1,3,-2,5,3,0,7,7,0,0,0,0,-4,2,1,-4,3,3,0,0,1,-1,-1,1,4,-1
KR_6728945022,440,-2,-28,-16,-3,-2,2,0,1,3,4,-1,2,1,1,2,3,-2,6,-4,0,3,1,-3,-3,6,-1,0,0,1,-1,0,-1,2,-1
KR_6752293653,420,1,-9,-20,-7,0,2,2,-4,5,1,-3,4,1,-2,6,4,2,0,-2,0,13,-1,-3,-2,5,-1,0,1,-1,1,1,-1,3,-1
KR_6760482815,420,-2,-24,0,-5,-1,3,2,-4,4,0,-2,3,1,-3,6,3,5,2,-7,0,8,5,1,-5,4,9,0,0,1,-1,1,-1,1,-1
KR_6731186315,420,-1,-29,-36,0,-2,2,0,-2,4,2,-1,1,0,4,2,6,1,0,-1,0,2,-119,-6,-3,9,-2,0,0,-1,-1,-1,-1,6,-1
KR_6666429759,420,-1,-6,11,-4,-1,5,4,3,0,3,-3,7,4,-2,4,2,-1,1,0,0,12,-4,0,-8,8,-3,0,1,-1,1,1,-1,1,-1
KR_6754430823,420,-5,-32,19,-9,1,2,3,0,1,1,-8,8,0,-4,5,1,2,1,-3,0,3,-8,-3,-4,7,3,0,-1,-1,-1,-1,-1,5,-1
KR_6763697824,420,-2,-2,-24,-7,0,2,2,0,1,1,-3,5,2,-2,3,1,-2,4,-2,0,13,54,6,-10,4,36,0,-2,1,-1,-1,-1,6,-1
KR_6761160994,420,-1,-36,-6,-12,-1,2,1,-4,4,0,-3,6,3,-3,3,0,-1,1,0,-1,14,0,2,-5,3,2,0,0,1,-1,0,-1,4,-1
KR_6688313050,420,2,-61,23,4,4,0,4,1,3,4,1,2,3,-2,2,0,0,2,-2,-1,-9,178,-1,-5,6,-11,0,0,-1,1,1,-1,1,-1
KR_6522325443,420,-5,-80,-44,-12,-2,3,1,0,2,2,-2,3,1,-6,8,2,-2,2,0,0,13,9,2,-2,0,-1,0,-2,-1,-1,-1,-1,3,-1
KR_6757623018,420,3,25,72,8,-1,5,4,0,2,2,5,1,6,2,1,3,2,0,-2,0,-6,-4,-2,0,2,-2,0,0,1,1,-1,-1,5,-1
KR_6728711748,440,-1,29,-17,1,-3,4,1,-4,5,1,0,1,1,4,0,4,4,1,-5,0,1,12,1,-4,3,3,0,0,-1,0,1,1,5,-1
KR_6761575753,420,-4,-34,-32,-1,-1,3,2,0,2,2,3,0,3,-6,7,1,3,0,-3,0,1,321,1,-2,1,1,0,-2,-1,-1,-1,1,6,-1
KR_6438739965,420,-2,-59,-15,-7,0,2,2,-4,5,1,1,0,1,-2,3,1,-2,2,0,0,10,-308,0,-4,4,2,0,0,-1,-1,1,-1,6,-1
KR_6677246400,420,-9,-141,-59,-21,-5,5,0,-2,4,2,-4,6,2,-2,3,1,-8,9,-1,0,16,-47,-1,-4,5,-22,0,-3,-1,-1,-1,-1,5,-1
KR_6765015287,420,0,-80,4,3,-2,2,0,4,0,4,-1,1,0,4,0,4,-2,2,0,0,-5,-4,-1,-3,4,-8,0,-1,-1,-1,-1,-1,4,-1
KR_6757824748,420,-4,-64,-8,1,-1,2,1,1,1,2,2,2,4,0,4,4,-1,2,-1,0,-6,-5,3,-8,5,3,0,0,-1,1,0,-1,3,-1
KR_6756912242,420,3,38,8,15,2,1,3,6,0,6,3,2,5,2,2,4,2,2,-4,0,-18,-4,6,-7,1,0,0,1,1,0,1,1,2,-1
KR_6724934182,420,-1,-57,12,-5,3,1,4,0,2,2,-3,4,1,1,1,2,-6,7,-1,0,5,-47,-1,-3,4,-28,0,-1,1,-1,-1,-1,1,-1
KR_6755411246,420,-2,-1,5,-7,-3,6,3,2,2,4,-5,6,1,-2,4,2,1,1,-2,0,11,12,-6,-2,8,0,0,-3,-1,-1,-1,-1,1,-1
KR_6764373256,420,1,-33,20,-1,-3,4,1,3,0,3,1,1,2,-2,4,2,0,1,-1,0,0,0,3,-5,2,-2,0,-1,-1,1,-1,-1,1,-1
KR_6763482680,440,-4,-78,-53,-7,-1,3,2,-2,6,4,0,2,2,-1,5,4,-3,6,-3,0,4,-3,-2,-1,3,0,0,0,0,0,-1,-1,0,-1
KR_6747408112,420,-5,-31,-12,-4,3,2,5,-2,3,1,-1,1,0,-5,7,2,1,1,-2,0,4,-7,2,-4,2,-1,0,-1,-1,-1,-1,1,4,-1
KR_6739803995,420,0,82,-33,-5,-3,3,0,-4,7,3,0,1,1,0,3,3,2,0,-2,0,6,-6,-1,-6,7,-2,0,1,-1,1,1,1,4,-1
KR_6622583110,420,1,-30,-5,-3,2,1,3,-1,3,2,-2,4,2,-2,3,1,0,3,-3,0,0,3,0,-3,3,1,0,0,-1,1,0,-1,5,-1
KR_6714037227,420,-2,-28,-25,-6,1,0,1,-4,7,3,-3,4,1,1,0,1,-1,1,0,0,2,-29,0,-6,6,-2,0,0,-1,1,-1,-1,6,-1
KR_6763359066,440,-3,-31,-8,-7,-1,3,2,-1,4,3,-4,5,1,0,1,1,-1,3,-2,0,12,-2,-2,-1,3,-2,0,0,-1,0,0,1,5,-1
KR_6748539469,420,-1,-47,-5,2,0,1,1,5,1,6,-1,3,2,-2,5,3,0,0,0,0,3,5,4,-10,6,0,0,-1,1,-1,-1,1,6,-1
KR_6734991528,420,-4,-13,-12,-11,-1,2,1,1,0,1,-9,9,0,-2,3,1,0,1,-1,0,10,110,0,-4,4,2,0,-1,1,-1,-1,-1,4,-1
KR_6662063872,420,-3,54,-17,-4,-1,1,0,-4,5,1,-1,2,1,2,0,2,0,0,0,0,7,-101,0,-2,2,2,0,0,0,-1,-1,-1,0,-1
KR_6763339233,420,1,-57,-24,-1,0,0,0,1,2,3,0,0,0,-3,5,2,1,0,-1,0,2,-2,-3,-3,6,-3,0,0,1,-1,0,1,1,-1
KR_6763319448,420,1,-2,-8,-2,-2,2,0,-2,3,1,2,0,2,1,1,2,-1,6,-5,0,6,2,1,-4,3,19,0,0,-1,0,0,1,4,-1
KR_6692160281,420,-6,-46,-28,-8,1,2,3,-4,4,0,-5,6,1,-1,2,1,1,3,-4,0,8,-8,-2,-2,4,4,0,1,-1,1,1,-1,3,-1
KR_6758060499,420,-1,25,-28,-6,-3,4,1,0,2,2,1,1,2,-4,4,0,0,1,-1,0,2,-6,0,-6,6,0,0,0,0,-1,-1,-1,0,-1
KR_6721857980,440,0,39,4,8,2,1,3,5,1,6,-1,2,1,1,2,3,1,2,-3,0,-1,-255,-2,-3,5,-4,0,0,1,1,1,1,4,-1
KR_6741839440,420,-4,-87,-24,-13,1,1,2,-8,10,2,-2,3,1,-4,5,1,0,1,-1,0,19,18,-3,-4,7,-1,0,-2,-1,-1,-1,-1,5,-1
KR_6764686976,420,1,56,0,2,-3,3,0,6,1,7,-2,3,1,2,2,4,-1,1,0,0,-7,3,-6,-3,9,-1,0,0,1,1,0,1,3,-1
KR_6728825516,440,1,54,-3,0,1,1,2,0,6,6,-2,2,0,-3,5,2,4,1,-5,0,11,-2,-3,-1,4,-1,0,0,-1,-1,1,1,2,-1
KR_6760859213,420,-2,8,-4,-9,-1,2,1,1,3,4,-8,8,0,-1,2,1,0,1,-1,0,3,-8,-2,-2,4,-3,0,-1,-1,-1,-1,-1,5,-1
KR_6764378706,420,-3,37,-17,-6,0,2,2,-6,8,2,-4,4,0,4,4,8,0,1,-1,1,1,-1,0,-6,6,3,0,-2,1,-1,-1,1,3,-1
KR_6673520220,420,-3,-22,-56,0,-1,3,2,1,3,4,3,0,3,-1,2,1,-2,3,-1,-1,-1,-1,-2,-4,6,3,0,-2,0,-1,-1,-1,0,-1
KR_6757160549,420,0,-5,7,-2,2,2,4,-1,4,3,-2,4,2,0,4,4,-1,2,-1,-1,6,77,0,-4,4,21,0,1,-1,1,1,-1,5,-1
KR_6747416212,420,1,23,-1,-1,0,1,1,0,1,1,3,2,5,-7,9,2,3,0,-3,0,13,-2,2,-6,4,1,0,1,1,1,1,1,6,-1
KR_6689180594,420,-3,-36,-24,3,-1,4,3,1,2,3,0,4,4,3,1,4,0,3,-3,0,-6,9,4,-8,4,4,0,0,-1,1,1,1,2,-1
KR_6671796064,420,-2,-73,11,-7,1,1,2,-2,5,3,-4,4,0,-2,4,2,0,0,0,0,7,1,0,-4,4,2,0,0,0,0,0,-1,0,-1
KR_6746378338,420,-4,-102,16,-11,1,2,3,-1,1,0,0,0,0,-6,6,0,-5,7,-2,0,16,1,6,-8,2,3,0,-2,-1,1,-1,-1,2,-1
KR_6752034750,420,-3,-47,-32,0,2,1,3,-5,5,0,1,0,1,3,1,4,-1,2,-1,0,-4,6,8,-8,0,-1,0,0,-1,-1,0,-1,4,-1
KR_6676815313,440,-1,43,-38,-4,1,0,1,-1,2,1,-2,4,2,-4,8,4,2,0,-2,0,4,-26,0,-5,5,-21,0,-1,-1,-1,-1,-1,2,-1
KR_6742159022,420,-3,-105,-16,-1,0,1,1,2,0,2,4,2,6,-6,6,0,-1,1,0,0,1,-3,0,-3,3,4,0,0,-1,1,1,-1,4,-1
KR_6740160229,420,-1,-39,23,-6,0,0,0,-2,3,1,1,3,4,-3,4,1,-2,2,0,0,1,7,-1,-4,5,3,0,-1,-1,0,-1,-1,3,-1
KR_6519319546,420,0,-69,5,-3,-4,5,1,0,2,2,1,2,3,-1,5,4,1,0,-1,0,10,-7,-6,-2,8,-2,0,1,1,1,1,-1,2,-1
KR_6695088695,420,0,-63,-13,-1,1,0,1,1,1,2,-2,2,0,0,2,2,-1,1,0,0,1,-1,-5,-2,7,-1,0,0,-1,1,0,-1,4,-1
KR_6681149415,420,-2,20,12,-3,0,2,2,0,1,1,-1,3,2,-1,1,0,-1,2,-1,0,3,5,1,-9,8,2,0,0,1,1,0,-1,1,-1
KR_6737584905,420,5,91,4,11,1,2,3,1,2,3,5,0,5,1,5,6,3,0,-3,1,-6,231,-1,-1,2,-1,0,1,-1,1,1,1,6,-1
KR_6747509493,420,-9,-110,-57,-17,-2,2,0,-2,4,2,-9,11,2,-4,7,3,0,0,0,0,24,111,1,-5,4,6,0,-2,-1,1,-1,-1,5,-1
KR_6740950158,420,-1,-80,32,-13,-1,3,2,-3,5,2,-8,9,1,-3,5,2,2,0,-2,-2,11,226,-4,-2,6,-4,0,-1,-1,1,-1,-1,1,-1
KR_6759982583,420,-2,-53,-16,1,2,0,2,0,1,1,5,0,5,-4,6,2,-2,2,0,0,3,39,-5,-3,8,5,0,1,-1,1,1,-1,4,-1
KR_6667716720,420,1,49,8,-5,3,0,3,0,2,2,-2,4,2,-3,3,0,-3,4,-1,0,11,107,3,-10,7,3,0,0,0,-1,0,1,0,-1
KR_6744664702,420,-1,29,-8,1,1,1,2,-1,4,3,2,0,2,0,3,3,-1,2,-1,0,0,90,8,-15,7,-1,0,0,1,-1,0,1,2,-1
KR_6731405339,420,-5,-113,-13,-13,1,1,2,-3,3,0,-1,2,1,-6,6,0,-4,4,0,0,12,-456,-3,-1,4,3,0,0,-1,1,1,-1,3,-1
KR_6634101168,420,-1,-39,-8,-2,0,1,1,0,4,4,2,2,4,-2,4,2,-2,2,0,0,2,-144,-2,-3,5,2,0,-1,-1,-1,-1,-1,1,-1
KR_6753726939,420,-1,-2,-68,1,2,0,2,-4,4,0,-2,3,1,4,1,5,1,1,-2,-1,-3,217,2,-4,2,0,0,0,-1,1,-1,-1,5,-1
KR_6659949276,420,-2,14,-16,-2,-4,5,1,0,2,2,-3,4,1,5,1,6,0,0,0,1,-2,2,1,-5,4,6,0,-2,-1,-1,-1,1,4,-1
KR_6741276252,440,-3,14,-16,-11,0,2,2,-1,3,2,-2,5,3,-6,8,2,-2,2,0,1,7,-4,-3,0,3,0,0,-1,1,-1,-1,1,2,-1
KR_6724702779,440,0,-59,-65,-4,0,1,1,-2,3,1,0,3,3,-2,2,0,0,1,-1,0,13,7,1,-4,3,1,0,-2,-1,-1,-1,1,1,-1
KR_6733593618,420,-1,7,-24,-2,2,0,2,-1,2,1,1,2,3,-2,3,1,-2,2,0,0,0,7,-1,-2,3,0,0,-1,-1,-1,-1,-1,4,-1
KR_6759408185,420,-5,-104,10,-10,1,0,1,-4,5,1,-3,4,1,-1,2,1,-3,3,0,0,10,-198,-1,-3,4,-1,0,-1,1,-1,-1,-1,6,-1
KR_6713280674,420,-2,-19,28,-2,-3,3,0,1,2,3,1,1,2,-2,6,4,1,0,-1,2,4,2,-3,-6,9,1,0,-1,1,-1,1,1,4,-1
KR_6742855957,420,-2,-21,-16,-9,0,2,2,-2,4,2,-4,5,1,-3,3,0,0,0,0,0,12,-8,-6,-3,9,1,0,-1,-1,-1,-1,-1,1,-1
KR_6764936411,440,-4,-98,8,-8,-2,2,0,-1,4,3,-2,2,0,0,3,3,-3,4,-1,0,9,8,5,-8,3,4,0,-1,-1,-1,-1,1,1,-1
KR_6634794220,420,-3,-47,-14,-5,2,0,2,-3,3,0,-2,2,0,-1,2,1,-1,2,-1,0,4,6,2,-6,4,0,0,0,-1,-1,-1,-1,1,-1
KR_6734894434,420,-1,2,-4,0,2,1,3,-3,4,1,0,3,3,3,2,5,-2,2,0,0,0,-111,-6,-3,9,1,0,0,-1,-1,0,1,1,-1
KR_6662601505,420,-1,33,14,-3,2,2,4,-1,1,0,-3,6,3,0,2,2,-1,1,0,0,3,2,1,-6,5,4,0,1,0,0,1,1,0,-1
KR_6683015632,420,-1,0,8,3,-1,1,0,0,2,2,-1,2,1,3,1,4,2,1,-3,0,-2,128,6,-7,1,2,0,0,1,-1,1,1,1,-1
KR_6704872371,420,3,31,20,1,0,1,1,-3,4,1,4,0,4,1,3,4,-1,2,-1,1,-2,5,4,-6,2,-4,0,2,1,1,1,1,4,-1
KR_6695045601,420,-5,-96,4,-7,-2,3,1,-1,1,0,-2,4,2,0,0,0,-2,2,0,1,9,-119,-4,-2,6,3,0,-2,-1,-1,-1,1,4,-1
KR_6738387830,420,-5,-80,0,-10,0,2,2,0,1,1,0,1,1,-6,7,1,-4,5,-1,0,9,-41,0,-5,5,2,0,-1,-1,-1,-1,-1,3,-1
KR_6661814915,440,-1,-17,24,-6,3,2,5,-2,3,1,-3,6,3,1,6,7,-5,7,-2,1,9,-5,-2,-4,6,4,0,-2,-1,1,-1,1,2,-1
KR_6668271422,420,-3,-32,8,-4,-2,2,0,9,0,9,-7,11,4,-3,3,0,-1,1,0,0,-1,141,-1,-4,5,-3,0,-2,-1,-1,-1,-1,3,-1
KR_6731516964,420,-3,29,-4,-12,-3,3,0,-4,5,1,-2,2,0,-1,6,5,-2,2,0,0,12,8,-4,-3,7,1,0,0,-1,0,0,-1,3,-1
KR_6668829839,420,4,52,17,5,-4,5,1,2,1,3,-1,2,1,8,0,8,0,0,0,0,-11,-275,0,-3,3,-2,0,2,1,1,1,-1,3,-1
KR_6612227687,420,1,11,-4,1,1,0,1,-5,7,2,0,1,1,6,1,7,-1,2,-1,0,-1,1,1,-3,2,-1,0,1,-1,1,1,-1,3,-1
KR_6757063434,440,0,43,-17,-5,5,1,6,-14,14,0,-1,3,2,3,0,3,2,0,-2,0,1,-3,2,-7,5,-4,0,1,-1,-1,-1,-1,4,-1
KR_6644032423,420,0,17,-28,-4,1,2,3,0,3,3,1,3,4,-4,6,2,-2,2,0,0,11,-13,2,-7,5,-2,0,0,-1,-1,-1,1,2,-1
KR_6733968537,420,-2,-26,-9,1,2,0,2,0,2,2,-1,4,3,2,3,5,-2,4,-2,0,-11,-10,-1,-2,3,-3,0,-2,-1,-1,-1,1,2,-1
KR_6741458988,420,-4,-28,11,-13,-2,2,0,-3,5,2,-1,2,1,-6,8,2,-1,1,0,0,8,3,8,-10,2,6,0,-2,1,-1,-1,-1,2,-1
KR_6720101859,420,-3,-11,-16,-1,-3,3,0,2,1,3,0,1,1,-1,1,0,1,1,-2,0,-3,-124,1,-3,2,0,0,0,-1,1,0,1,6,-1
KR_6612447490,420,2,-64,28,6,2,1,3,1,0,1,3,0,3,0,2,2,0,1,-1,-1,-2,-9,-1,-2,3,0,0,1,1,1,1,-1,6,-1
KR_6718095195,420,-4,-52,-4,-1,0,2,2,3,3,6,-2,4,2,-2,3,1,0,1,-1,0,-1,38,5,-7,2,14,0,-1,-1,-1,-1,-1,4,-1
KR_6756627619,420,-3,16,-7,-1,-2,3,1,-7,8,1,0,5,5,7,1,8,1,0,-1,2,6,4,1,-4,3,-3,0,1,-1,1,1,1,1,-1
KR_6752286635,420,-3,-60,-22,-5,-5,7,2,0,0,0,3,2,5,-1,4,3,-2,2,0,0,6,-3,-4,-1,5,3,0,-2,-1,-1,-1,-1,4,-1
KR_6761632636,420,0,-32,-4,0,1,2,3,1,0,1,2,0,2,-2,6,4,-2,3,-1,1,4,-12,1,-8,7,3,0,-1,1,0,-1,1,1,-1
KR_6736059742,420,-2,-85,-24,-7,0,1,1,-5,7,2,-1,4,3,-3,4,1,2,1,-3,-1,6,131,-5,-1,6,-6,0,-1,-1,-1,-1,-1,1,-1
KR_6652856831,420,-1,15,-29,-7,-2,2,0,-1,4,3,-3,5,2,-1,1,0,0,0,0,0,3,3,0,-3,3,-2,0,-1,-1,-1,-1,-1,2,-1
KR_6676715678,440,-4,-104,-43,-9,1,1,2,-7,8,1,-3,3,0,0,2,2,0,1,-1,1,2,-5,1,-7,6,3,0,-1,-1,0,-1,1,5,-1
KR_6764384910,420,-4,-81,-28,-11,-2,3,1,-8,9,1,0,4,4,-2,5,3,1,0,-1,0,1,-23,1,-7,6,5,0,0,-1,1,1,1,5,-1
KR_6694403133,420,-2,3,8,-4,1,1,2,-5,6,1,-1,4,3,-1,3,2,2,1,-3,0,3,1,-2,-3,5,-1,0,0,1,-1,1,1,6,-1
KR_6762827650,440,-1,-35,-24,1,4,1,5,0,5,5,-1,2,1,0,0,0,-2,2,0,0,-1,0,-1,-3,4,0,0,-1,1,-1,-1,1,5,-1
KR_6730734847,420,2,-11,4,5,5,2,7,1,0,1,-4,5,1,2,1,3,1,0,-1,0,-5,-5,-2,-6,8,1,0,-1,-1,-1,1,-1,3,-1
KR_6728443559,420,1,7,29,2,2,2,4,0,6,6,1,1,2,-1,4,3,0,1,-1,0,0,-96,-6,-3,9,-1,0,1,-1,1,1,-1,2,-1
KR_6735257502,420,0,6,8,-2,-3,3,0,0,5,5,1,0,1,3,2,5,-3,3,0,0,3,-8,-1,-7,8,-1,0,0,1,-1,0,-1,5,-1
KR_6735319387,420,-1,-52,4,-4,1,1,2,-1,5,4,2,0,2,-2,4,2,-4,4,0,0,5,-51,3,-6,3,0,0,-1,-1,1,-1,1,3,-1
KR_6732635181,420,-4,-43,5,-11,-3,3,0,-1,1,0,1,1,2,-2,4,2,-6,7,-1,0,5,-4,0,-2,2,-3,0,0,1,1,-1,-1,6,-1
KR_6763564621,420,2,20,9,3,3,0,3,2,2,4,2,1,3,-2,5,3,-2,2,0,0,1,9,-5,-2,7,0,0,0,1,-1,0,-1,5,-1
KR_6697053137,420,-1,-27,0,6,3,1,4,-1,5,4,2,1,3,1,2,3,1,0,-1,0,-10,-16,3,-6,3,-20,0,1,1,1,1,1,2,-1
KR_6757039651,420,-3,-82,-19,-6,-1,2,1,-4,4,0,-1,5,4,-2,4,2,2,1,-3,0,8,-2,-2,-3,5,1,0,0,-1,-1,-1,-1,6,-1
KR_6752231731,420,2,5,10,4,0,2,2,2,1,3,5,2,7,-2,3,1,-1,1,0,1,-2,1,1,-6,5,-2,0,0,1,-1,0,1,4,-1
KR_6625888616,420,-5,-42,-16,-11,-3,5,2,2,3,5,-5,5,0,-2,7,5,-3,3,0,-1,5,-222,3,-8,5,4,0,-1,-1,-1,-1,-1,1,-1
KR_6745320248,420,0,10,15,-5,0,2,2,-1,2,1,-4,5,1,-1,2,1,1,1,-2,0,6,9,1,-7,6,4,0,0,1,0,0,-1,1,-1
KR_6755364460,420,-1,-36,9,-1,0,1,1,0,2,2,0,2,2,2,1,3,-3,3,0,0,2,3,2,-6,4,-5,0,0,1,-1,1,-1,1,-1
KR_6725805326,420,-1,14,7,-2,-1,2,1,-1,4,3,-1,3,2,2,2,4,-1,1,0,1,-4,7,-5,-3,8,-2,0,0,-1,-1,0,1,6,-1
KR_6749307524,420,-1,0,-20,-5,-4,4,0,3,0,3,-7,8,1,1,1,2,2,0,-2,0,0,-6,0,-8,8,3,0,0,-1,-1,1,-1,3,-1
KR_6695149139,420,-4,-56,-12,-4,-4,5,1,1,4,5,0,1,1,0,2,2,-1,1,0,0,-6,8,2,-3,1,1,0,-1,-1,1,-1,1,1,-1
KR_6692150101,420,0,15,8,2,0,2,2,2,2,4,-2,4,2,2,2,4,0,4,-4,-1,-6,-235,3,-4,1,-2,0,1,1,1,1,-1,1,-1
KR_6746467011,420,-1,9,-24,-6,1,3,4,1,1,2,2,1,3,-7,7,0,-3,3,0,0,7,6,-1,-2,3,-1,0,-1,1,1,1,1,6,-1
KR_6758561775,440,-4,-51,-8,-11,-4,4,0,-7,10,3,-3,5,2,2,0,2,1,0,-1,0,7,41,-2,-1,3,28,0,-1,1,-1,-1,-1,1,-1
KR_6761653922,420,3,53,7,4,5,2,7,0,4,4,-2,3,1,0,3,3,1,0,-1,0,2,55,-1,-5,6,-4,0,1,-1,1,1,-1,3,-1
KR_6736531095,420,-3,-75,-15,-9,-1,3,2,0,5,5,-2,3,1,-5,5,0,-1,1,0,-3,13,3,-2,-3,5,4,0,-2,1,-1,-1,-1,2,-1
KR_6718002317,440,-2,-71,-16,-6,-2,4,2,0,3,3,-7,8,1,3,2,5,0,1,-1,-1,14,4,-2,-2,4,1,0,-1,-1,1,1,-1,4,-1
KR_6745617244,420,0,57,-8,6,0,3,3,2,1,3,2,3,5,0,1,1,2,3,-5,0,-1,1,-1,-2,3,1,0,2,0,0,1,-1,0,-1
KR_6675381342,420,-2,-1,-8,-6,2,1,3,-8,8,0,2,1,3,-2,4,2,0,1,-1,1,11,-2,-1,-5,6,1,0,0,-1,1,1,1,6,-1
KR_6758841506,420,-4,-51,0,-11,-5,5,0,0,3,3,-3,3,0,-3,3,0,0,0,0,0,11,2,2,-5,3,3,0,-2,-1,-1,-1,1,6,-1
KR_6737882353,420,-3,-6,26,-9,0,2,2,-5,9,4,2,3,5,-6,10,4,0,0,0,2,5,10,-2,-3,5,2,0,0,0,-1,-1,1,0,-1
KR_6395267860,420,-4,-96,-9,-11,0,2,2,-5,6,1,1,1,2,-4,6,2,-3,3,0,0,12,-10,-3,-1,4,0,0,-1,-1,-1,-1,1,5,-1
KR_6762755203,420,-3,-65,-12,-4,-1,3,2,1,2,3,-6,7,1,2,0,2,0,0,0,0,-8,2,1,-4,3,3,0,-2,-1,-1,-1,-1,1,-1
KR_6700531053,420,2,-15,-10,8,3,3,6,0,4,4,4,2,6,1,1,2,0,0,0,2,-9,-14,-6,-3,9,-1,0,0,0,0,0,1,0,-1
KR_6747340600,420,-9,-48,-25,-14,0,0,0,-4,8,4,-6,6,0,-2,3,1,-2,3,-1,0,18,-82,-4,-3,7,0,0,-1,1,1,-1,1,2,-1
KR_6695012671,420,-6,-72,0,-14,-2,2,0,1,2,3,-3,4,1,-10,10,0,0,1,-1,0,14,-2,1,-4,3,1,0,0,-1,-1,-1,-1,5,-1
KR_6758234003,420,-2,-14,-24,2,3,1,4,0,2,2,3,0,3,-3,6,3,-1,2,-1,0,-3,0,-1,-4,5,2,0,-2,-1,-1,-1,-1,6,-1
KR_6737266790,420,-1,-32,33,-4,-5,5,0,2,2,4,0,1,1,-1,2,1,0,0,0,0,1,6,2,-5,3,-1,0,0,-1,-1,-1,-1,3,-1
KR_6709565856,440,0,10,16,-1,4,0,4,1,1,2,-2,6,4,-3,3,0,-1,2,-1,0,7,0,-1,-6,7,-1,0,-1,-1,1,-1,-1,1,-1
KR_6732098210,420,-2,-23,-3,0,-1,1,0,-2,2,0,-5,6,1,7,2,9,1,0,-1,0,2,1,0,-4,4,-1,0,0,-1,0,-1,-1,3,-1
KR_6691847105,420,-3,-117,12,-6,-1,1,0,3,2,5,-4,5,1,-3,9,6,-1,1,0,0,1,-33,2,-9,7,-1,0,-1,-1,1,-1,-1,1,-1
KR_6758157092,420,-1,-26,0,-4,-4,4,0,-3,3,0,0,3,3,2,2,4,1,0,-1,0,-4,1,-1,-6,7,2,0,1,-1,1,1,1,3,-1
KR_6729656544,420,-1,-21,16,-5,-1,2,1,2,3,5,1,0,1,-6,6,0,-1,2,-1,0,12,-105,-3,-2,5,0,0,0,0,0,-1,-1,0,-1
KR_6763323999,420,-1,-21,4,-1,0,1,1,-1,5,4,1,4,5,-3,3,0,2,1,-3,-1,-4,83,-1,-3,4,-1,0,0,1,-1,-1,-1,1,-1
KR_6674488568,420,-2,-27,1,-12,-2,4,2,-3,5,2,0,0,0,-2,4,2,-5,5,0,0,8,2,1,-7,6,5,0,0,-1,-1,-1,-1,6,-1
KR_6743170105,420,1,85,26,-1,-3,3,0,4,2,6,-1,1,0,0,4,4,-1,2,-1,1,0,-10,0,-5,5,2,0,0,-1,1,1,1,4,-1
KR_6727645049,420,0,-17,-3,-8,-5,8,3,-6,8,2,3,1,4,-1,5,4,1,0,-1,0,-2,113,-5,0,5,1,0,-2,-1,-1,-1,-1,1,-1
KR_6754934596,420,-6,-82,-36,-9,-2,4,2,-1,2,1,-1,2,1,-5,8,3,0,1,-1,0,-1,15,-4,-1,5,-1,0,0,-1,1,0,-1,5,-1
KR_6763880257,420,1,57,-7,-5,-3,5,2,3,2,5,0,1,1,-4,5,1,-1,1,0,0,3,5,0,-3,3,4,0,-2,0,-1,-1,-1,0,-1
KR_6743171836,440,3,108,32,6,0,1,1,2,1,3,-1,4,3,2,2,4,3,0,-3,2,-6,8,4,-7,3,9,0,0,1,-1,1,1,1,-1
KR_6753932333,420,-4,17,-19,-9,-3,3,0,2,2,4,-3,4,1,-3,3,0,-2,2,0,0,4,1,-1,-3,4,-1,0,-1,0,-1,-1,-1,0,-1
KR_6619227865,420,-2,-70,4,-4,2,4,6,0,1,1,-4,5,1,-1,6,5,-1,1,0,1,-4,-56,-1,-2,3,2,0,-2,-1,-1,-1,1,6,-1
KR_6684210022,420,-3,-23,24,-4,-3,3,0,4,0,4,-4,4,0,-3,4,1,2,0,-2,0,-2,-11,-4,-2,6,-3,0,0,1,1,-1,-1,2,-1
KR_6668934300,420,-1,-11,-20,-7,-3,5,2,0,2,2,-5,7,2,1,1,2,0,0,0,0,5,-139,-5,-2,7,-7,0,-1,0,-1,-1,1,0,-1
KR_6763494238,440,0,-43,-11,-3,1,2,3,-1,1,0,-1,3,2,-3,3,0,1,2,-3,0,3,2,-5,0,5,3,0,-1,-1,-1,-1,-1,6,-1
KR_6743778232,440,2,68,-29,5,1,3,4,-2,4,2,1,2,3,4,1,5,1,2,-3,2,-7,-8,2,-4,2,-1,0,0,-1,-1,1,-1,2,-1
KR_6647563924,420,-5,-19,-29,-10,-9,9,0,-2,4,2,-4,4,0,3,0,3,2,0,-2,0,2,-3,-3,-1,4,-2,0,-3,-1,-1,-1,-1,4,-1
KR_6731063981,420,-6,-85,-39,-9,2,1,3,-6,8,2,-5,6,1,-2,3,1,2,0,-2,-1,9,-41,-3,-2,5,-1,0,-2,-1,-1,-1,-1,5,-1
KR_6751909995,420,-3,5,-1,0,-4,4,0,0,2,2,3,0,3,1,1,2,0,0,0,0,-2,52,0,-6,6,1,0,0,1,0,0,1,4,-1
KR_6761003377,420,-5,-73,-32,-10,-5,7,2,-2,4,2,-4,7,3,1,2,3,0,1,-1,-2,6,5,2,-6,4,4,0,-1,0,-1,-1,-1,0,-1
KR_6601251734,420,-1,-32,-8,-5,-1,1,0,-4,9,5,0,2,2,2,0,2,-2,2,0,0,-3,-5,-2,-2,4,3,0,-3,-1,-1,-1,-1,5,-1
KR_6761949916,420,0,-12,2,-5,2,1,3,1,0,1,-1,8,7,-7,10,3,0,0,0,0,1,21,1,-4,3,-1,0,0,-1,-1,-1,-1,2,-1
KR_6762551252,420,-5,-45,-61,-9,-2,3,1,-8,8,0,3,1,4,0,3,3,-2,5,-3,0,10,-33,-2,-5,7,-2,0,-2,-1,-1,-1,1,2,-1
KR_6725802903,420,-4,-11,-29,-8,0,1,1,-1,3,2,-4,5,1,-2,5,3,-1,1,0,0,7,4,-2,-3,5,6,0,0,-1,1,0,1,2,-1
KR_6744204180,420,-1,9,-12,-5,-1,1,0,2,2,4,-4,5,1,-2,3,1,0,1,-1,0,-7,3,-1,-7,8,-1,0,-1,-1,-1,-1,-1,6,-1
KR_6756621274,420,-1,-28,-2,1,0,3,3,2,2,4,1,2,3,-3,4,1,1,1,-2,0,-5,12,-1,-4,5,-2,0,1,0,1,1,1,0,-1
KR_6763478647,420,0,11,12,-2,2,1,3,-1,3,2,-2,3,1,0,4,4,-1,3,-2,0,1,145,2,-6,4,5,0,1,0,1,1,-1,0,-1
KR_6749091938,420,0,-27,-4,2,-2,2,0,2,1,3,0,2,2,-1,3,2,3,0,-3,0,-7,0,-2,-4,6,3,0,0,-1,1,0,-1,6,-1
KR_6758941326,420,-2,-59,-16,-7,-4,5,1,0,5,5,0,1,1,-1,3,2,-2,3,-1,0,5,0,-1,-4,5,4,0,0,-1,1,-1,-1,2,-1
KR_6636111769,420,1,-13,0,9,-1,2,1,1,5,6,5,2,7,2,1,3,2,2,-4,0,-22,386,0,-2,2,0,0,0,-1,1,1,1,4,-1
KR_6696011633,420,-1,18,4,-7,5,1,6,-3,4,1,-8,9,1,0,0,0,-1,1,0,0,8,169,0,-3,3,1,0,-2,0,0,1,1,0,-1
KR_6723042374,440,0,-13,-6,-1,-1,2,1,-1,2,1,2,2,4,-1,1,0,0,0,0,0,3,-3,0,-2,2,1,0,0,-1,-1,0,1,4,-1
KR_6680272455,440,-9,-81,-43,-14,-4,7,3,-3,4,1,1,2,3,-5,6,1,-3,3,0,1,12,-4,2,-4,2,3,0,-4,1,-1,-1,1,2,-1
KR_6714952469,420,-1,16,12,-14,0,0,0,-4,4,0,-2,4,2,-6,7,1,-2,2,0,0,13,-62,-1,-2,3,1,0,2,1,1,1,-1,3,-1
KR_6726612687,420,-3,-77,-12,-5,0,3,3,2,2,4,-2,2,0,-4,6,2,-1,2,-1,-1,1,-4,-6,-3,9,0,0,-2,-1,-1,-1,-1,1,-1
KR_6741978896,440,-1,-55,7,-8,2,2,4,-1,2,1,-1,3,2,-7,7,0,-1,1,0,0,14,-25,1,-6,5,0,0,0,1,-1,1,-1,4,-1
KR_6650587190,420,1,28,8,-2,0,2,2,-5,8,3,2,1,3,0,4,4,1,2,-3,-1,-6,3,-3,-2,5,-2,0,0,1,0,0,-1,5,-1
KR_6762867329,440,-3,-47,-16,-9,-3,4,1,-3,3,0,-1,2,1,0,0,0,-2,2,0,0,10,-34,5,-9,4,-1,0,-2,1,-1,-1,-1,1,-1
KR_6738036969,420,0,-60,10,-1,-4,4,0,-3,4,1,1,4,5,1,2,3,4,0,-4,-1,-7,14,-1,-4,5,5,0,-1,1,-1,-1,-1,4,-1
KR_6731391284,420,-3,-44,-17,-14,2,0,2,-5,7,2,-2,2,0,-6,6,0,-3,3,0,0,13,-19,-2,-5,7,-3,0,-1,-1,-1,-1,-1,3,-1
KR_6762225350,420,-4,-69,-20,-13,-1,2,1,-1,3,2,-5,11,6,-5,6,1,-1,1,0,0,14,-8,-6,-6,12,2,0,-2,0,-1,-1,-1,0,-1
KR_6739127051,420,0,-2,-23,-6,4,1,5,-2,4,2,-4,5,1,-4,4,0,0,0,0,0,12,-21,-2,-3,5,0,0,0,-1,1,-1,-1,5,-1
KR_6749432551,420,0,19,4,1,2,2,4,2,1,3,1,1,2,-2,3,1,-2,3,-1,0,2,20,4,-7,3,1,0,-1,1,-1,-1,-1,1,-1
KR_6652455646,420,-2,-18,1,-2,-1,2,1,2,2,4,1,2,3,-1,4,3,-3,5,-2,0,2,-10,-2,0,2,-2,0,0,1,-1,1,1,1,-1
KR_6739175524,420,-1,47,-24,-2,3,0,3,-4,4,0,0,2,2,-1,4,3,0,1,-1,0,5,113,-1,-3,4,1,0,0,1,-1,0,-1,2,-1
KR_6691923716,420,-3,-87,-18,-9,3,1,4,-4,5,1,-1,4,3,-8,8,0,1,1,-2,-1,10,-13,0,-3,3,2,0,-2,-1,-1,-1,-1,6,-1
KR_6763569747,420,-1,8,1,1,0,1,1,2,1,3,5,3,8,-4,5,1,-2,4,-2,0,-2,-60,2,-5,3,-20,0,0,0,1,0,-1,0,-1
KR_6756802110,440,2,40,36,-1,3,0,3,-1,2,1,0,2,2,-3,3,0,0,0,0,0,7,-60,0,-4,4,-4,0,1,1,0,1,-1,1,-1
KR_6739247528,420,-5,-31,-26,-12,-2,2,0,-6,6,0,-1,4,3,-2,2,0,-1,3,-2,-1,17,2,4,-6,2,0,0,-1,-1,-1,-1,-1,3,-1
KR_6756682155,420,-1,-43,-14,0,-4,5,1,2,2,4,3,1,4,-1,1,0,0,0,0,-1,-3,-19,-3,-5,8,5,0,-1,1,-1,-1,-1,5,-1
KR_6705686505,420,-1,-44,-4,0,-4,6,2,3,3,6,3,2,5,-2,5,3,0,0,0,-1,5,12,8,-11,3,1,0,0,1,1,1,-1,6,-1
KR_6742163548,420,-4,-31,-24,-10,-5,5,0,3,2,5,-3,4,1,-5,6,1,0,0,0,0,9,35,7,-8,1,4,0,-2,0,-1,-1,-1,0,-1
KR_6713512523,420,-4,-27,-3,-4,0,2,2,3,3,6,-1,3,2,-6,6,0,0,0,0,0,5,-42,-1,-4,5,-10,0,-1,0,-1,-1,-1,0,-1
KR_6749282291,420,-2,-89,24,-8,0,1,1,-2,3,1,-1,2,1,-5,5,0,0,1,-1,0,7,-140,-2,-4,6,-1,0,0,1,1,0,-1,3,-1
KR_6644646909,420,-2,24,-22,-6,0,2,2,-6,7,1,-5,6,1,2,0,2,3,1,-4,2,3,5,-6,-1,7,1,0,1,-1,-1,1,1,3,-1
KR_6644109518,420,-1,-60,17,-1,0,2,2,-4,5,1,1,4,5,4,1,5,-2,2,0,0,-2,0,5,-6,1,0,0,-2,-1,1,-1,-1,5,-1
KR_6716007919,440,2,-23,-21,6,2,1,3,-3,4,1,2,1,3,3,0,3,2,2,-4,0,-3,200,6,-8,2,4,0,1,0,0,1,1,0,-1
KR_6756769394,420,0,107,-12,-4,-2,6,4,1,1,2,-1,5,4,-2,2,0,0,0,0,0,18,14,-1,-4,5,2,0,2,-1,-1,1,1,5,-1
KR_6739354260,420,-1,-22,0,-3,-3,3,0,-1,6,5,-3,5,2,6,1,7,-2,5,-3,0,-4,29,1,-5,4,-1,0,-1,1,-1,-1,1,1,-1
KR_6726475784,420,-4,22,-21,-10,-2,2,0,-2,4,2,-6,6,0,2,0,2,-2,2,0,-1,14,51,0,-4,4,0,0,0,-1,-1,-1,-1,5,-1
KR_6749442993,420,-3,-43,-44,-8,-1,3,2,-2,4,2,-1,5,4,-3,3,0,-1,2,-1,0,1,-7,-1,-2,3,-2,0,-1,-1,-1,-1,1,5,-1
KR_6734165058,440,-4,4,-16,-10,6,0,6,-2,3,1,-2,3,1,-11,11,0,-1,1,0,0,11,-1,0,-4,4,-1,0,-2,-1,1,-1,-1,5,-1
KR_6724965551,420,-6,-23,-28,-16,0,0,0,-3,6,3,-6,9,3,-4,5,1,-3,3,0,0,17,2,3,-6,3,-1,0,-1,-1,1,-1,1,5,-1
KR_6746310487,420,-4,-36,4,-11,0,3,3,-4,5,1,0,0,0,-6,7,1,-1,1,0,-1,16,-12,-3,-4,7,-1,0,-2,-1,-1,-1,-1,1,-1
KR_6626163613,420,1,31,21,0,2,0,2,-3,4,1,1,3,4,-2,3,1,2,0,-2,0,-5,9,4,-8,4,0,0,1,0,1,1,-1,0,-1
KR_6762999709,420,-7,-97,-54,-18,-4,4,0,-2,4,2,-7,8,1,-4,8,4,-1,3,-2,0,13,-1,0,-3,3,1,0,-1,-1,1,-1,-1,5,-1
KR_6732101225,420,-5,-36,-35,-9,-2,2,0,2,1,3,-7,8,1,-2,2,0,0,0,0,0,5,-1,0,-4,4,1,0,-1,1,-1,-1,-1,2,-1
KR_6752641130,420,-3,-69,0,-4,-3,3,0,-1,2,1,2,0,2,-2,4,2,0,0,0,0,5,54,-1,-3,4,-2,0,-1,1,-1,-1,-1,2,-1
KR_6752912050,420,-1,-118,-22,-5,0,1,1,1,3,4,-2,5,3,-1,4,3,-3,4,-1,-2,4,-133,4,-7,3,-2,0,-1,-1,1,-1,-1,2,-1
KR_6713216018,420,-3,-40,-11,-6,-3,3,0,-2,6,4,0,1,1,0,2,2,-1,1,0,0,-3,-2,1,-5,4,1,0,0,-1,-1,-1,-1,3,-1
KR_6722360661,420,0,-42,-24,0,-1,5,4,3,2,5,2,0,2,-5,5,0,1,0,-1,-1,-11,-39,1,-6,5,-16,0,-1,-1,-1,-1,1,1,-1
KR_6759115165,420,-4,-35,-23,-11,3,1,4,-4,5,1,-2,5,3,-4,6,2,-4,6,-2,0,11,2,5,-6,1,1,0,-2,-1,-1,-1,-1,2,-1
KR_6673451929,420,0,-25,-4,2,-1,4,3,0,3,3,1,1,2,1,3,4,1,1,-2,0,1,6,-1,-6,7,-3,0,1,1,1,1,1,5,-1
KR_6748015116,420,-2,-20,-16,-10,-2,2,0,-4,4,0,0,1,1,-1,2,1,-3,3,0,0,19,-16,-3,-4,7,4,0,0,-1,-1,0,-1,3,-1
KR_6695807242,420,-2,-20,0,-5,-1,3,2,-5,6,1,1,2,3,0,1,1,0,2,-2,-1,7,5,0,-3,3,-1,0,0,-1,1,1,-1,3,-1
KR_6709222228,420,-5,-48,43,-9,-3,4,1,-2,4,2,2,1,3,-5,9,4,-1,1,0,-3,10,-2,-7,-2,9,6,0,0,-1,1,-1,-1,5,-1
KR_6758675518,420,-5,-74,-45,-12,-5,6,1,-2,3,1,-2,4,2,0,0,0,-3,3,0,0,4,-21,-1,-3,4,-2,0,-1,-1,-1,-1,-1,4,-1
KR_6684936635,420,0,-25,-8,-8,0,3,3,1,3,4,-7,7,0,-2,4,2,0,1,-1,0,5,-4,0,-4,4,-4,0,0,-1,1,0,-1,6,-1
KR_6698870478,420,1,3,-16,8,-1,4,3,1,1,2,2,0,2,3,2,5,3,1,-4,0,-5,-16,0,-4,4,-2,0,-1,0,1,-1,-1,0,-1
KR_6751464397,420,-1,31,-16,-6,1,0,1,-7,7,0,1,1,2,-1,2,1,0,1,-1,0,12,129,3,-4,1,0,0,1,-1,0,1,-1,2,-1
KR_6620229434,440,-1,-13,8,6,-4,7,3,1,1,2,3,2,5,5,2,7,1,2,-3,1,-12,5,0,-1,1,1,0,-1,0,0,-1,1,0,-1
KR_6764938717,420,1,-38,32,-4,-1,5,4,1,0,1,1,1,2,-4,5,1,-1,1,0,0,1,-3,3,-6,3,3,0,0,1,-1,-1,1,4,-1
KR_6762877583,440,-3,-58,0,-9,-1,2,1,-1,3,2,-1,3,2,-8,8,0,2,0,-2,0,7,-8,3,-3,0,0,0,0,0,0,-1,1,0,-1
KR_6764895590,420,1,-9,-17,-4,2,1,3,-5,6,1,-4,5,1,2,1,3,1,0,-1,0,6,-41,1,-3,2,-26,0,1,-1,1,1,-1,5,-1
KR_6706351226,420,0,19,-3,-3,1,0,1,-2,4,2,5,1,6,0,3,3,-7,7,0,-2,3,44,1,-7,6,33,0,-1,1,-1,-1,-1,5,-1
KR_6751058155,420,-2,-37,0,-7,-1,1,0,2,0,2,-3,3,0,-4,4,0,-1,3,-2,0,4,45,-2,-1,3,1,0,-2,-1,-1,-1,-1,1,-1
KR_6663100982,420,1,-14,44,1,2,0,2,2,2,4,0,5,5,-5,5,0,2,0,-2,0,-1,-2,-3,-3,6,2,0,0,-1,1,0,-1,6,-1
KR_6632026532,420,-7,-108,-18,-19,-2,4,2,-2,2,0,-2,3,1,-12,13,1,-1,1,0,0,17,4,-1,-3,4,1,0,-4,-1,-1,-1,-1,1,-1
KR_6756928190,420,-1,-72,26,-10,-3,3,0,-9,10,1,0,2,2,2,1,3,0,1,-1,0,3,10,5,-6,1,8,0,-1,1,-1,-1,1,5,-1
KR_6760057426,420,-1,-74,24,-3,3,0,3,0,1,1,3,1,4,-7,8,1,-2,2,0,-1,0,-2,-4,-4,8,2,0,-1,1,1,-1,-1,2,-1
KR_6758278621,420,-3,-10,2,-4,0,0,0,0,1,1,-1,2,1,-4,8,4,1,1,-2,0,8,-3,-1,-4,5,-1,0,0,-1,1,0,1,6,-1
KR_6721294991,420,2,40,23,1,1,2,3,-4,5,1,2,4,6,1,0,1,1,1,-2,0,7,1,-3,-4,7,5,0,0,0,0,0,-1,0,-1
KR_6759985001,420,2,37,-15,1,3,0,3,-2,3,1,1,0,1,-1,6,5,0,0,0,1,7,-28,0,-4,4,2,0,1,-1,1,1,1,3,-1
KR_6715621327,420,-5,-40,-28,-9,1,1,2,0,3,3,-4,4,0,-3,6,3,-3,6,-3,1,2,4,6,-11,5,4,0,-3,-1,-1,-1,1,3,-1
KR_6762541463,420,-1,-12,-4,-2,-2,3,1,-3,4,1,1,0,1,1,5,6,1,0,-1,-1,3,0,0,-6,6,-1,0,0,-1,-1,0,-1,4,-1
KR_6737953659,420,-3,-59,4,-6,2,1,3,-4,5,1,-2,4,2,0,3,3,-2,2,0,0,2,-4,3,-6,3,1,0,0,1,-1,0,-1,1,-1
KR_6764479576,420,4,-10,6,11,0,3,3,2,1,3,3,2,5,4,2,6,2,2,-4,1,-30,-278,0,-3,3,1,0,-1,-1,-1,-1,1,6,-1
KR_6757601684,440,-3,-8,-31,2,3,1,4,5,0,5,-4,7,3,-1,1,0,-1,2,-1,0,-7,1,2,-2,0,1,0,1,-1,-1,1,-1,3,-1
KR_6640421318,420,1,126,4,-4,0,2,2,-5,6,1,-1,1,0,1,2,3,1,2,-3,0,12,-1,-1,-4,5,0,0,0,1,-1,0,-1,1,-1
KR_6678080439,420,-2,47,-30,-4,-1,3,2,-3,4,1,-1,2,1,2,0,2,-1,1,0,1,1,5,5,-10,5,0,0,1,-1,1,1,1,6,-1
KR_6750974167,440,-1,-26,-17,5,0,3,3,-1,2,1,2,0,2,2,6,8,2,0,-2,0,-5,23,4,-7,3,2,0,0,1,-1,0,1,3,-1
KR_6756139363,420,-3,-28,-18,-1,3,2,5,-3,7,4,-1,5,4,1,5,6,-1,1,0,-1,-3,2,-4,-6,10,5,0,-2,1,1,-1,-1,4,-1
KR_6737565500,420,-1,17,12,1,1,0,1,1,4,5,1,2,3,-2,3,1,0,1,-1,0,2,5,-1,-7,8,8,0,0,1,-1,-1,1,6,-1
KR_6712006955,420,-2,-32,12,-9,2,0,2,-3,5,2,0,1,1,-8,9,1,0,0,0,-1,18,-9,-6,-2,8,-1,0,0,-1,1,0,-1,1,-1
KR_6725869488,420,-6,-40,-20,-5,-2,5,3,0,2,2,-3,3,0,-1,2,1,1,1,-2,0,1,5,-1,-4,5,3,0,1,1,1,1,1,4,-1
KR_6763064406,440,-2,-31,11,-7,-1,1,0,-6,9,3,2,1,3,-1,1,0,-1,1,0,0,7,68,-4,-3,7,1,0,-1,1,-1,-1,-1,6,-1
KR_6693386994,440,-1,-4,35,-2,0,3,3,1,2,3,0,1,1,-4,8,4,1,0,-1,0,2,2,-1,-3,4,1,0,0,-1,1,0,1,4,-1
KR_6755148808,420,0,-26,20,5,0,2,2,1,3,4,3,1,4,0,2,2,1,1,-2,0,-8,8,1,-5,4,0,0,1,1,-1,1,-1,2,-1
KR_6739501444,420,-4,-123,6,-7,-6,7,1,-2,2,0,4,2,6,0,3,3,-3,5,-2,0,6,-2,-2,-4,6,4,0,-1,-1,-1,-1,-1,4,-1
KR_6761271844,420,2,11,16,-1,1,0,1,-1,2,1,0,3,3,-1,2,1,0,0,0,0,3,-10,-3,-5,8,1,0,-1,-1,1,-1,-1,3,-1
KR_6751036696,440,-1,-89,-4,-4,-2,3,1,8,3,11,-3,4,1,-10,10,0,3,0,-3,0,-4,2,0,-3,3,0,0,-1,1,-1,-1,-1,2,-1
KR_6756718076,420,0,-44,20,-12,-6,7,1,-3,4,1,-2,3,1,-4,8,4,3,0,-3,-1,6,-3,-7,-3,10,-3,0,-2,1,-1,-1,-1,3,-1
KR_6759823276,420,-5,-61,-36,-15,-7,7,0,-7,8,1,-2,3,1,2,3,5,-1,2,-1,0,11,20,-6,-2,8,4,0,0,-1,-1,-1,1,1,-1
KR_6511426959,420,0,-32,-24,-6,0,1,1,-4,4,0,0,7,7,-3,4,1,1,1,-2,-1,14,-5,4,-7,3,2,0,-2,-1,-1,-1,-1,4,-1
KR_6735819755,420,0,-1,4,-2,0,2,2,0,2,2,-5,6,1,3,5,8,0,0,0,0,7,14,0,-2,2,-1,0,0,1,-1,1,-1,5,-1
KR_6690655524,420,-3,-100,-30,-4,1,2,3,-1,4,3,-3,3,0,-1,1,0,0,1,-1,0,-2,6,0,-4,4,0,0,-1,-1,-1,-1,1,3,-1
KR_6759832125,440,-1,-32,-28,1,2,0,2,-1,4,3,3,1,4,0,4,4,-3,3,0,0,7,-13,-3,-1,4,-2,0,-2,1,0,-1,1,6,-1
KR_6754156304,440,-3,3,-47,-3,-4,5,1,1,4,5,1,1,2,-1,5,4,0,0,0,1,3,1,1,-1,0,1,0,-1,0,-1,-1,1,0,-1
KR_6577469288,420,-1,-26,-4,-4,1,0,1,1,0,1,0,1,1,-6,8,2,0,0,0,0,8,-23,-2,-3,5,3,0,-1,0,0,-1,1,0,-1
KR_6691572136,420,-4,11,-6,-10,-5,5,0,-5,7,2,-3,6,3,5,3,8,-2,3,-1,0,3,5,-2,-2,4,2,0,-2,-1,-1,-1,-1,5,-1
KR_6720747128,420,-2,-15,4,-1,-2,2,0,1,3,4,-2,2,0,4,4,8,-2,2,0,0,10,104,-3,0,3,20,0,-1,-1,1,-1,1,5,-1
KR_6741480786,420,-4,-10,-48,-7,-6,6,0,-4,6,2,1,3,4,3,2,5,-1,2,-1,0,0,-39,-1,-6,7,-4,0,-1,1,-1,-1,1,1,-1
KR_6587832167,440,-4,-40,-3,-15,1,0,1,-1,2,1,0,1,1,-13,14,1,-2,2,0,-1,23,-5,1,-4,3,-3,0,-2,-1,1,1,-1,6,-1
KR_6757188729,420,-4,-32,-43,-9,2,1,3,0,1,1,-8,9,1,-4,5,1,1,1,-2,0,7,13,-1,0,1,0,0,-1,-1,1,-1,1,1,-1
KR_6725767912,420,-3,-150,19,-6,-2,2,0,3,2,5,-3,4,1,-2,4,2,-2,3,-1,0,4,-13,-3,-2,5,0,0,-1,1,-1,-1,1,5,-1
KR_6684737139,420,-6,-125,-4,-8,-2,2,0,-5,6,1,0,4,4,-3,3,0,2,0,-2,0,4,10,-6,0,6,4,0,-2,-1,-1,-1,-1,4,-1
KR_6754940621,420,-7,-112,-4,-15,-4,5,1,-11,13,2,0,1,1,2,3,5,-2,3,-1,0,11,-11,1,-6,5,1,0,-2,1,-1,-1,1,3,-1
KR_6740214684,440,-1,-17,12,-5,-6,8,2,2,1,3,-1,1,0,0,2,2,0,3,-3,0,0,-1,-1,-4,5,2,0,0,-1,-1,-1,-1,6,-1
KR_6744440970,420,-4,-42,-7,-6,0,3,3,0,1,1,-3,5,2,-3,3,0,0,0,0,-1,11,-7,1,-5,4,-5,0,-1,1,-1,-1,-1,3,-1
KR_6757701673,440,-4,-68,-44,-9,9,1,10,1,3,4,-8,8,0,-7,7,0,-4,4,0,1,0,-71,3,-6,3,7,0,-3,-1,-1,-1,1,5,-1
KR_6671090543,420,-2,-51,-4,-5,-1,1,0,-4,6,2,-2,4,2,-1,4,3,3,0,-3,1,-4,-20,-6,-1,7,-5,0,-1,1,-1,-1,1,5,-1
KR_6764874451,420,-3,-31,-16,-13,0,1,1,-1,1,0,-6,6,0,-6,9,3,0,1,-1,0,11,-13,-6,-2,8,-1,0,0,0,-1,-1,1,0,-1
KR_6718980902,420,-1,-55,-4,0,2,0,2,1,1,2,-5,6,1,0,2,2,2,2,-4,0,-4,-2,-1,-6,7,0,0,0,1,1,0,-1,2,-1
KR_6723346033,420,-7,-30,-28,-15,-7,7,0,-2,2,0,-6,8,2,1,1,2,-1,1,0,0,10,38,-1,-4,5,27,0,0,-1,-1,0,-1,5,-1
KR_6748155396,420,-1,-42,-4,-5,-1,3,2,-1,2,1,-2,2,0,-2,2,0,1,0,-1,0,10,14,2,-5,3,2,0,0,1,1,0,-1,6,-1
KR_6643058007,420,-4,-52,-34,-4,-2,4,2,-1,3,2,-2,5,3,3,1,4,-2,2,0,0,-2,39,-4,-2,6,24,0,-1,1,1,-1,1,2,-1
KR_6745207502,440,-3,-21,-13,-7,0,3,3,-5,6,1,-1,4,3,-3,5,2,2,0,-2,1,2,135,1,-6,5,-3,0,-1,-1,1,-1,1,1,-1
KR_6756159070,420,-1,-3,-4,-10,1,2,3,-6,7,1,-5,7,2,5,2,7,-5,6,-1,0,12,-24,-6,0,6,0,0,2,-1,1,1,-1,2,-1
KR_6668375706,420,-2,-26,-20,0,2,3,5,-2,5,3,-1,3,2,0,5,5,1,0,-1,-1,4,-251,-2,-6,8,2,0,1,-1,-1,-1,-1,1,-1
KR_6447703832,420,2,8,10,4,-1,2,1,3,1,4,-4,4,0,4,1,5,2,1,-3,-1,-8,23,-1,-7,8,1,0,-1,1,-1,-1,-1,4,-1
KR_6760548326,420,-5,-42,-4,-10,-8,8,0,0,1,1,1,0,1,-3,3,0,0,0,0,0,4,-22,-2,-4,6,2,0,-1,-1,-1,-1,-1,5,-1
KR_6713918837,420,-4,-14,-32,-3,-1,2,1,1,2,3,0,2,2,-2,3,1,-1,2,-1,0,-2,1,3,-8,5,3,0,-1,-1,-1,-1,-1,1,-1
KR_6647087569,420,0,-64,5,-5,-1,1,0,3,0,3,-1,4,3,-3,6,3,-3,4,-1,0,2,-45,-3,-2,5,-25,0,-2,1,1,-1,-1,4,-1
KR_6722276113,420,-2,-2,-4,0,-2,2,0,4,0,4,-1,3,2,-1,3,2,0,0,0,0,-4,10,6,-7,1,3,0,0,-1,-1,0,-1,4,-1
KR_6668349585,420,0,-24,35,8,8,1,9,1,4,5,0,2,2,-2,4,2,1,0,-1,0,-3,1,0,-3,3,0,0,0,1,0,0,1,4,-1
KR_6736262890,440,4,27,-4,17,-1,2,1,10,1,11,4,2,6,4,3,7,0,2,-2,1,-16,3,5,-6,1,3,0,0,1,1,1,1,1,-1
KR_6600839919,420,-4,-37,26,-19,-4,5,1,-3,4,1,-8,10,2,-5,6,1,1,0,-1,0,26,-7,-2,-1,3,4,0,-4,-1,-1,-1,1,6,-1
KR_6754221017,420,3,50,-1,5,2,0,2,-1,2,1,4,1,5,2,4,6,-2,2,0,0,-3,-110,0,-5,5,0,0,-1,-1,-1,-1,-1,4,-1
KR_6762961681,420,0,16,-6,-1,0,1,1,1,1,2,1,0,1,2,0,2,-5,5,0,0,-2,-295,-5,-1,6,0,0,0,0,1,0,-1,0,-1
KR_6715131128,420,0,29,27,2,-3,4,1,-1,2,1,2,1,3,1,3,4,3,0,-3,0,-3,14,0,-4,4,-2,0,-1,-1,-1,-1,-1,5,-1
KR_6735621172,420,-2,-3,0,1,2,0,2,2,0,2,-2,7,5,0,2,2,-1,2,-1,0,-1,22,3,-3,0,-1,0,-1,-1,1,-1,-1,1,-1
KR_6710820887,420,-2,-6,-8,-3,-1,2,1,-2,4,2,1,0,1,-3,6,3,2,0,-2,1,8,198,-4,-3,7,3,0,-1,1,-1,1,1,2,-1
KR_6736863706,420,-4,-72,-3,-7,5,0,5,1,5,6,-5,6,1,-5,5,0,-3,4,-1,0,13,29,0,-4,4,15,0,-2,1,-1,-1,-1,2,-1
KR_6684447761,420,0,-29,-4,3,1,2,3,0,1,1,0,2,2,4,1,5,-2,2,0,-1,-7,-32,4,-4,0,3,0,0,1,0,0,-1,1,-1
KR_6591393991,420,0,-49,-19,0,-6,6,0,2,3,5,0,3,3,3,2,5,1,1,-2,1,-7,24,-2,-4,6,-3,0,-3,-1,-1,-1,1,4,-1
KR_6643214055,420,1,9,-35,6,1,3,4,4,1,5,-5,7,2,3,0,3,3,0,-3,0,-13,113,1,-7,6,3,0,-1,-1,-1,1,-1,5,-1
KR_6734224467,440,0,-44,30,-5,-3,5,2,-1,2,1,-1,4,3,0,2,2,0,1,-1,0,10,-18,1,-7,6,-2,0,0,-1,-1,1,-1,1,-1
KR_6753896090,420,-2,2,-16,-5,-2,3,1,1,3,4,-1,1,0,-1,1,0,-2,2,0,0,1,-59,0,-4,4,2,0,-1,0,-1,-1,-1,0,-1
KR_6675631100,420,2,-38,0,5,2,0,2,2,2,4,-3,4,1,4,1,5,0,1,-1,0,-6,-12,-3,-2,5,-2,0,-1,1,-1,-1,-1,3,-1
KR_6756491530,420,-1,6,-16,-6,2,0,2,-5,6,1,-1,3,2,1,2,3,-3,4,-1,0,8,-144,-1,-4,5,-5,0,-1,1,0,-1,-1,4,-1
KR_6726543735,420,-2,-1,-19,-9,3,0,3,0,1,1,-4,4,0,-4,7,3,-4,4,0,0,11,2,3,-5,2,4,0,0,-1,1,-1,-1,5,-1
KR_6730143819,420,0,-22,3,8,0,4,4,5,2,7,-1,1,0,4,2,6,0,1,-1,0,-19,-10,-5,-1,6,-5,0,-1,1,-1,-1,1,6,-1
KR_6746081075,420,5,37,14,14,-1,2,1,1,1,2,9,1,10,4,4,8,1,0,-1,0,0,-176,3,-6,3,-15,0,2,1,1,1,1,2,-1
KR_6466680944,420,-2,54,-43,-4,0,0,0,-4,7,3,-2,4,2,1,3,4,1,0,-1,0,3,-36,-1,-2,3,2,0,-1,-1,-1,-1,1,5,-1
KR_6676319169,420,-3,-59,8,-10,-2,3,1,-4,6,2,-5,5,0,2,3,5,-1,1,0,-1,17,-275,-6,0,6,-5,0,-3,-1,-1,-1,1,4,-1
KR_6764299496,440,-5,-53,-36,-11,-1,3,2,-2,3,1,-8,10,2,1,2,3,-1,3,-2,0,-6,-4,-5,-1,6,-1,0,-2,-1,-1,-1,-1,5,-1
KR_6197052788,420,-3,-28,-5,-10,0,2,2,-2,3,1,-1,1,0,-4,4,0,-3,3,0,0,14,-13,-6,-3,9,4,0,-2,-1,-1,-1,-1,1,-1
KR_6739111947,420,3,11,0,6,-3,5,2,3,1,4,0,1,1,4,3,7,2,1,-3,0,-10,7,-1,-7,8,-10,0,0,-1,1,1,1,5,-1
KR_6764898063,440,-4,-25,-8,-4,3,1,4,1,4,5,-2,2,0,-9,11,2,3,2,-5,0,5,5,-4,-2,6,-3,0,0,0,-1,-1,-1,0,-1
KR_6733278284,420,-1,-26,4,0,0,2,2,1,2,3,0,1,1,-1,5,4,0,1,-1,0,0,0,4,-6,2,2,0,0,1,-1,0,1,4,-1
KR_6716113483,440,3,23,15,0,3,1,4,1,2,3,0,0,0,-1,1,0,-3,4,-1,0,0,-9,-5,-4,9,-2,0,0,-1,-1,0,-1,2,-1
KR_6761948662,420,-3,-3,-6,-6,0,1,1,0,5,5,-2,3,1,-4,6,2,0,1,-1,0,11,-18,5,-8,3,5,0,0,-1,-1,0,1,6,-1
KR_6760407394,420,-4,-15,-20,-4,-3,4,1,3,1,4,-2,4,2,-2,3,1,0,1,-1,0,2,-4,2,-5,3,2,0,0,-1,1,0,-1,2,-1
KR_6658777257,420,2,49,0,-1,0,3,3,-1,5,4,-8,10,2,7,1,8,1,1,-2,-1,-1,7,4,-9,5,6,0,1,1,-1,1,-1,6,-1
KR_6731826622,420,-2,-54,-8,-6,1,1,2,0,5,5,-1,3,2,-3,7,4,-3,5,-2,0,1,-12,2,-3,1,0,0,-2,-1,1,-1,1,2,-1
KR_6759579430,440,-3,-20,-8,-8,3,0,3,-3,3,0,-2,3,1,-4,5,1,-2,4,-2,0,10,-379,5,-7,2,13,0,0,-1,-1,-1,-1,2,-1
KR_6648246420,420,1,23,20,5,-2,5,3,-1,2,1,2,2,4,7,0,7,-1,2,-1,0,4,9,-3,-6,9,2,0,1,-1,-1,1,-1,2,-1
KR_6743915620,440,-4,-51,-16,-8,-1,2,1,0,1,1,-5,6,1,2,4,6,-4,5,-1,0,-6,-5,1,-3,2,1,0,0,-1,-1,1,1,3,-1
KR_6759673520,420,1,5,9,1,0,1,1,3,1,4,1,1,2,-2,3,1,-1,2,-1,0,-6,-8,-2,-1,3,1,0,0,1,-1,-1,1,6,-1
KR_6756104578,420,-3,-57,24,-6,2,1,3,-2,4,2,-3,3,0,-2,3,1,-1,3,-2,0,9,0,2,-5,3,0,0,0,1,-1,0,-1,3,-1
KR_6763052586,420,-1,-4,-19,-5,0,1,1,1,2,3,-6,6,0,-1,2,1,1,3,-4,0,3,12,1,-4,3,0,0,-1,-1,-1,-1,-1,1,-1
KR_6759958976,420,-6,-74,-44,-16,-3,4,1,-5,5,0,1,0,1,-7,7,0,-2,2,0,0,16,-14,-5,-1,6,1,0,-3,-1,-1,-1,-1,3,-1
KR_6715980072,420,-9,-48,-62,-15,-2,2,0,-3,5,2,-5,7,2,-3,4,1,-2,2,0,0,11,153,-3,-2,5,2,0,-2,-1,-1,-1,-1,3,-1
KR_6759655917,440,-3,-40,-28,-6,-2,3,1,2,2,4,-11,12,1,2,2,4,3,2,-5,0,-3,5,-2,-3,5,0,0,-2,-1,1,-1,-1,4,-1
KR_6620118252,420,0,-48,3,-2,-1,5,4,1,1,2,0,1,1,-4,5,1,2,2,-4,-1,0,-136,1,-4,3,-3,0,0,-1,-1,-1,-1,3,-1
KR_6743676146,440,-5,-45,-21,-11,-1,2,1,-2,4,2,-5,5,0,-2,4,2,-1,1,0,-1,7,-212,2,-6,4,2,0,-2,-1,-1,-1,-1,4,-1
KR_6445317747,420,1,16,-16,-2,-1,1,0,2,4,6,4,0,4,-7,9,2,0,0,0,-1,2,1,-3,-6,9,2,0,0,1,-1,0,-1,3,-1
KR_6733930342,420,-6,4,-20,-15,-1,3,2,-4,6,2,-2,3,1,-7,9,2,-1,3,-2,0,17,1,-2,-5,7,3,0,-3,1,-1,-1,1,5,-1
KR_6646164130,420,-4,-39,3,-6,-3,3,0,0,2,2,1,1,2,-1,3,2,-3,3,0,1,2,-5,0,-5,5,0,0,-3,-1,-1,-1,1,5,-1
KR_6754376829,420,-2,-56,-4,-13,-1,1,0,5,3,8,-10,10,0,-6,6,0,-1,2,-1,-1,19,-8,-4,-1,5,1,0,-1,-1,0,-1,-1,1,-1
KR_6693139555,420,-7,-67,-12,-12,-1,1,0,-4,5,1,-1,3,2,-5,6,1,-1,3,-2,0,10,-1,2,-5,3,3,0,-1,-1,-1,-1,1,6,-1
KR_6763199032,420,-1,-31,32,-4,-1,4,3,0,2,2,-2,3,1,-1,1,0,0,0,0,0,8,112,0,-1,1,1,0,-1,1,-1,-1,-1,1,-1
KR_6764456433,420,-2,-47,28,-2,-2,4,2,2,1,3,-4,4,0,1,1,2,1,0,-1,0,4,10,-1,-5,6,1,0,-2,0,-1,-1,1,0,-1
KR_6763361567,420,-4,-43,-12,-9,-7,7,0,1,0,1,-2,3,1,-4,6,2,3,0,-3,-1,5,0,-3,-3,6,4,0,-1,-1,-1,-1,-1,4,-1
KR_6756305047,420,-4,-112,-31,-9,1,1,2,-3,3,0,-4,4,0,-3,6,3,0,1,-1,0,9,7,-2,-2,4,1,0,-1,-1,1,-1,1,6,-1
KR_6730241827,420,-3,-21,-35,-2,-4,5,1,2,3,5,3,1,4,-2,2,0,-1,1,0,0,-1,6,2,-6,4,4,0,-1,1,-1,-1,-1,1,-1
KR_6730006886,420,2,12,1,8,4,0,4,-1,2,1,2,2,4,2,2,4,1,0,-1,0,-4,13,1,-4,3,-2,0,0,1,1,0,1,3,-1
KR_6726535116,420,-2,-29,-8,-1,-5,6,1,0,4,4,1,1,2,4,0,4,-1,4,-3,0,7,179,4,-5,1,4,0,0,1,-1,-1,1,2,-1
KR_6733960544,420,2,24,10,4,0,1,1,2,2,4,2,2,4,0,1,1,0,2,-2,1,1,12,1,-4,3,3,0,1,1,1,1,1,2,-1
KR_6761802569,420,-3,-28,-4,-4,-1,1,0,0,1,1,-4,4,0,3,1,4,-2,2,0,0,2,-32,1,-5,4,5,0,-1,0,-1,-1,1,0,-1
KR_6662621680,420,-3,-62,-5,3,-3,3,0,3,1,4,5,2,7,-3,5,2,1,0,-1,0,0,-95,-2,-2,4,2,0,-1,-1,0,-1,-1,5,-1
KR_6691240758,420,-4,-65,42,-13,-5,5,0,-4,5,1,-3,5,2,1,1,2,-2,2,0,0,7,25,2,-4,2,1,0,-1,1,1,-1,-1,6,-1
KR_6738984140,420,-3,-33,-20,-4,1,1,2,-7,8,1,3,2,5,1,2,3,-2,2,0,0,15,-4,3,-6,3,4,0,-1,-1,-1,-1,1,5,-1
KR_6727062976,420,-6,-102,-14,-12,-4,4,0,-1,4,3,-5,6,1,1,2,3,-3,3,0,-1,16,3,5,-6,1,1,0,-2,-1,1,-1,-1,2,-1
KR_6663472332,420,0,-55,4,-6,3,2,5,-1,6,5,3,2,5,-7,8,1,-4,5,-1,0,11,0,5,-6,1,5,0,-2,1,-1,-1,-1,6,-1
KR_6760987400,420,-1,-46,-21,0,2,2,4,0,1,1,1,0,1,-3,3,0,0,1,-1,0,0,3,2,-6,4,-1,0,0,-1,1,0,-1,2,-1
KR_6763439531,440,-1,-44,-67,-4,1,1,2,-3,6,3,3,1,4,-5,5,0,0,0,0,0,6,-2,-3,-2,5,2,0,0,-1,-1,0,-1,3,-1
KR_6718777043,420,-8,-76,-36,5,2,1,3,2,0,2,0,2,2,1,0,1,0,0,0,1,-3,-19,0,-2,2,-1,0,-1,-1,1,-1,1,4,-1
KR_6763555631,440,3,59,0,4,3,1,4,0,0,0,0,0,0,1,0,1,0,1,-1,0,-2,-2,-3,-4,7,-5,0,2,0,-1,1,1,0,-1
KR_6753728276,420,-4,-20,-4,-15,-1,3,2,-1,1,0,-8,8,0,-2,2,0,-3,3,0,0,20,0,-2,-1,3,2,0,0,-1,0,-1,-1,5,-1
KR_6757038924,420,-1,-53,-4,-7,1,1,2,-2,5,3,-3,3,0,-2,4,2,-1,1,0,0,11,0,-1,-5,6,-3,0,-2,-1,0,-1,-1,6,-1
KR_6761723766,440,1,46,0,10,3,0,3,5,0,5,-4,6,2,6,0,6,0,0,0,0,-6,4,0,-7,7,-3,0,0,0,-1,0,1,0,-1
KR_6752080987,420,1,-28,20,1,-2,2,0,0,1,1,1,1,2,4,3,7,-2,4,-2,0,0,-1,-6,-1,7,0,0,0,-1,1,0,-1,2,-1
KR_6729502033,420,1,60,23,-1,3,1,4,0,5,5,0,2,2,-2,6,4,-2,3,-1,0,9,0,1,-4,3,3,0,0,-1,1,0,1,3,-1
KR_6707625085,420,-1,13,4,-6,-1,4,3,0,2,2,-4,7,3,-2,4,2,1,0,-1,0,2,4,-3,-8,11,1,0,0,1,-1,-1,-1,6,-1
KR_6762844229,440,-3,-12,12,-7,1,0,1,-9,10,1,-4,6,2,2,2,4,3,0,-3,0,13,45,-7,0,7,35,0,-2,-1,1,-1,-1,1,-1
KR_6746294501,420,-1,-86,8,3,2,1,3,-1,4,3,1,1,2,1,1,2,0,0,0,0,-5,-381,-1,-2,3,4,0,-2,-1,1,-1,1,3,-1
KR_6662837543,420,1,9,-2,-9,1,3,4,1,1,2,-10,10,0,-1,4,3,0,0,0,0,5,7,-3,-6,9,-1,0,1,-1,0,1,-1,6,-1
KR_6689296106,420,-2,-4,8,-4,0,1,1,-5,5,0,-1,2,1,1,2,3,1,2,-3,0,3,-110,-1,-1,2,-2,0,0,1,-1,1,1,3,-1
KR_6706656440,420,-3,-26,8,0,-3,3,0,3,4,7,4,0,4,-3,6,3,-1,1,0,0,-8,-9,-1,-3,4,1,0,0,1,1,-1,-1,2,-1
KR_6751197248,440,-2,-15,13,-10,0,2,2,2,1,3,-5,6,1,-8,9,1,1,0,-1,0,3,9,0,-6,6,1,0,-2,1,1,-1,-1,4,-1
KR_6740835325,420,1,32,-27,4,3,0,3,2,0,2,-4,6,2,2,2,4,1,0,-1,0,-7,-2,3,-5,2,0,0,0,1,-1,0,1,4,-1
KR_6693571109,420,-4,-18,8,-10,-4,4,0,-5,6,1,-1,2,1,0,1,1,0,1,-1,0,7,0,1,-3,2,3,0,-1,1,-1,-1,-1,1,-1
KR_6458129416,420,4,1,28,5,2,0,2,3,2,5,6,3,9,-5,6,1,-1,1,0,1,-6,7,1,-4,3,6,0,-1,1,1,-1,1,5,-1
KR_6752781207,420,2,-30,16,8,0,1,1,0,1,1,5,0,5,3,1,4,0,0,0,0,-7,26,1,-4,3,0,0,0,0,1,0,1,0,-1
KR_6671903036,420,-3,-8,-43,-15,0,3,3,-3,5,2,-3,6,3,-3,7,4,-6,6,0,-3,18,0,0,-2,2,4,0,0,-1,-1,-1,-1,1,-1
KR_6720736429,420,0,-29,-9,-1,3,2,5,1,0,1,-2,2,0,-3,3,0,0,0,0,1,0,204,-2,-4,6,-3,0,-1,-1,1,-1,1,4,-1
KR_6757961978,420,-4,-38,-13,4,-2,2,0,1,3,4,1,2,3,6,1,7,-2,3,-1,0,-6,-3,1,-5,4,-1,0,0,-1,0,0,1,4,-1
KR_6650245479,420,0,21,-8,-1,3,1,4,3,1,4,-2,2,0,-4,4,0,-1,1,0,0,6,9,4,-8,4,3,0,0,-1,-1,0,1,6,-1
KR_6718024990,440,3,-14,0,4,4,2,6,-3,4,1,-2,5,3,5,0,5,0,1,-1,1,-10,49,3,-6,3,16,0,1,1,0,1,1,3,-1
KR_6723215945,420,-3,-55,-12,0,-5,6,1,3,0,3,-1,1,0,2,0,2,1,0,-1,0,2,-8,4,-6,2,1,0,-2,1,-1,-1,1,3,-1
KR_6758606065,420,-2,-71,12,-11,-1,2,1,-2,2,0,1,1,2,-9,9,0,0,0,0,0,11,-3,-4,-2,6,4,0,-1,-1,0,-1,-1,2,-1
KR_6725100052,420,-2,-6,-27,-5,-5,5,0,0,4,4,5,0,5,-6,7,1,1,1,-2,0,5,5,-1,-3,4,1,0,-1,-1,1,-1,-1,4,-1
KR_6625383374,420,-3,-126,-32,-4,-4,4,0,3,1,4,5,3,8,-5,5,0,-3,3,0,0,0,10,2,-3,1,9,0,-1,-1,0,-1,-1,1,-1
KR_6751672829,420,1,14,-8,-4,0,1,1,-2,4,2,0,3,3,-2,5,3,0,2,-2,0,4,-6,-6,-4,10,0,0,0,-1,-1,0,-1,6,-1
KR_6649444308,420,1,56,32,0,0,1,1,-3,3,0,-3,3,0,6,0,6,0,1,-1,0,-5,-6,2,-5,3,0,0,-1,1,-1,-1,1,1,-1
KR_6605994804,420,-4,-50,-36,-8,-3,4,1,-4,4,0,3,0,3,-3,4,1,-1,1,0,0,11,-26,-2,-4,6,1,0,-2,-1,-1,-1,-1,3,-1
KR_6689539254,420,-1,-75,-10,2,0,2,2,-1,2,1,2,2,4,1,1,2,0,3,-3,0,0,-13,0,-2,2,-5,0,-1,-1,1,-1,1,3,-1
KR_6762461641,420,1,61,40,-3,-1,4,3,0,1,1,-2,4,2,0,4,4,0,2,-2,1,0,-167,-2,-4,6,-2,0,3,1,1,1,1,2,-1
KR_6761806677,420,-1,36,12,-10,-4,4,0,0,2,2,-3,5,2,-5,8,3,2,0,-2,0,3,25,-3,-2,5,7,0,0,0,0,1,-1,0,-1
KR_6761640866,420,-2,-48,-63,-6,-1,2,1,-3,8,5,1,2,3,-3,5,2,0,2,-2,0,2,15,4,-5,1,1,0,-2,-1,-1,-1,1,4,-1
KR_6697537006,420,1,-25,32,0,2,2,4,1,3,4,-1,1,0,-2,2,0,0,2,-2,1,4,340,-5,-3,8,-2,0,-1,1,-1,-1,1,4,-1
KR_6751296275,440,0,76,-32,7,-1,2,1,0,1,1,3,0,3,4,0,4,1,2,-3,0,-8,-42,-1,-5,6,-29,0,-1,-1,-1,-1,1,4,-1
KR_6748509756,420,-5,-19,-40,-1,1,1,2,1,1,2,-1,5,4,-1,1,0,-1,1,0,0,3,-9,-1,-7,8,0,0,0,-1,0,0,1,5,-1
KR_6762602522,420,0,1,9,-5,1,1,2,0,5,5,-2,2,0,-2,3,1,-2,2,0,0,4,174,0,-3,3,2,0,-1,-1,1,-1,1,1,-1
KR_6716905488,420,-4,-32,-28,-9,0,1,1,-3,4,1,2,0,2,-8,12,4,0,1,-1,0,12,31,-1,-2,3,15,0,0,-1,-1,-1,1,2,-1
KR_6709496461,420,-2,-17,5,-3,-4,4,0,4,1,5,-1,2,1,-2,4,2,0,0,0,0,0,3,-3,-2,5,-4,0,0,-1,-1,-1,1,6,-1
KR_6748700557,420,-1,-35,-43,-2,-4,4,0,1,0,1,-2,5,3,2,1,3,1,2,-3,0,1,2,-4,-4,8,-4,0,-1,-1,1,1,-1,5,-1
KR_6762327265,420,-1,14,-20,-2,-4,4,0,-1,2,1,1,3,4,1,0,1,1,0,-1,0,0,2,1,-3,2,5,0,0,-1,-1,-1,-1,3,-1
KR_6618169979,420,-2,-39,24,-2,-1,1,0,2,1,3,-1,4,3,-2,3,1,0,1,-1,0,4,5,-1,-4,5,4,0,0,1,-1,-1,1,6,-1
KR_6754436823,420,0,23,-24,1,0,0,0,-3,4,1,0,1,1,3,1,4,1,1,-2,0,-5,28,-4,-3,7,2,0,0,1,-1,0,-1,6,-1
KR_6764934295,420,1,-9,-4,3,5,2,7,3,1,4,2,0,2,-5,8,3,-2,2,0,1,0,-6,2,-6,4,-2,0,0,-1,1,1,1,5,-1
KR_6735702039,420,-1,-84,-8,-3,-1,1,0,1,0,1,1,1,2,-3,5,2,-1,1,0,0,4,8,-2,-5,7,5,0,0,1,-1,0,-1,2,-1
KR_6764001608,440,0,-50,12,4,-1,4,3,0,3,3,3,2,5,1,2,3,1,2,-3,0,-2,-10,1,-5,4,1,0,-1,-1,-1,-1,-1,5,-1
KR_6749923053,420,-1,-86,28,-6,4,0,4,2,1,3,-2,5,3,-7,7,0,-3,6,-3,0,5,-1,-3,-1,4,2,0,-2,-1,-1,-1,-1,5,-1
KR_6720204049,420,-1,-43,-23,-1,-4,4,0,0,1,1,-4,6,2,5,1,6,2,0,-2,0,-6,13,3,-6,3,6,0,-1,-1,-1,-1,1,2,-1
KR_6620147129,440,1,33,-27,-2,6,2,8,-1,2,1,2,0,2,-7,7,0,-2,2,0,0,6,-3,-1,-2,3,1,0,-1,-1,1,-1,1,5,-1
KR_6711800292,420,-3,-32,-17,-6,1,4,5,-1,3,2,-3,5,2,0,4,4,-3,6,-3,1,12,-6,1,-4,3,6,0,0,1,-1,0,1,5,-1
KR_6758520946,420,-1,-31,-1,0,3,0,3,1,3,4,0,1,1,-1,1,0,-3,3,0,0,2,3,-5,-3,8,-1,0,-2,-1,-1,-1,-1,4,-1
KR_6749575327,420,-6,-28,-13,-17,3,0,3,-10,10,0,-8,8,0,-2,2,0,0,0,0,0,21,-1,1,-6,5,-4,0,0,0,1,-1,-1,0,-1
KR_6717229893,420,-1,6,0,-5,-3,4,1,-5,6,1,0,2,2,3,1,4,0,2,-2,0,4,8,2,-5,3,1,0,0,-1,-1,0,-1,2,-1
KR_6659839604,440,-3,13,-20,-5,-1,2,1,0,2,2,-2,2,0,0,3,3,-2,2,0,0,-2,-6,-3,-3,6,-4,0,0,1,-1,0,1,6,-1
KR_6662931190,420,-4,-28,0,-6,0,4,4,-6,8,2,1,1,2,1,1,2,-2,3,-1,2,1,0,-3,-4,7,2,0,-1,-1,-1,-1,1,3,-1
KR_6196056743,420,1,74,-30,-3,0,2,2,1,2,3,-1,2,1,-4,4,0,1,0,-1,0,6,94,-7,-3,10,-3,0,0,-1,-1,-1,-1,3,-1
KR_6447402147,420,-6,68,-48,-13,-1,1,0,-7,9,2,-2,5,3,-2,3,1,-1,1,0,0,15,34,-2,-3,5,20,0,0,-1,1,0,1,5,-1
KR_6462584454,420,-3,18,16,-6,-3,5,2,-2,5,3,1,0,1,-2,3,1,0,1,-1,0,4,-3,-2,-4,6,4,0,-1,-1,-1,-1,-1,4,-1
KR_6603624353,420,-1,29,-2,-4,2,1,3,-6,7,1,-5,7,2,3,1,4,2,0,-2,0,2,6,-1,-5,6,4,0,1,-1,1,1,-1,5,-1
KR_6754386760,420,-3,-106,-35,-11,-3,3,0,-3,5,2,-4,6,2,0,4,4,-1,1,0,0,10,0,-5,-1,6,0,0,-1,0,-1,-1,-1,0,-1
KR_6764117899,420,-1,-15,-24,-2,1,1,2,-7,8,1,-1,1,0,5,0,5,0,0,0,0,-2,7,4,-8,4,4,0,0,-1,-1,0,-1,1,-1
KR_6745776196,440,-6,-83,-24,-10,-6,6,0,-1,3,2,-1,3,2,-2,4,2,0,3,-3,0,3,3,-5,-4,9,0,0,-2,-1,1,-1,-1,2,-1
KR_6530297112,420,0,-13,-2,2,1,2,3,1,4,5,2,2,4,-2,4,2,0,0,0,1,-4,-4,-3,-6,9,-3,0,1,1,-1,1,1,2,-1
KR_6669402704,420,0,0,-24,-5,0,4,4,1,8,9,-2,2,0,-2,6,4,-2,2,0,0,15,-4,0,-6,6,0,0,0,1,-1,1,1,5,-1
KR_6756629853,420,-4,-35,-27,4,0,1,1,-1,4,3,0,3,3,2,4,6,3,0,-3,0,-4,-257,2,-3,1,-2,0,-4,-1,1,-1,1,4,-1
KR_6689918318,420,-1,8,-1,0,-1,1,0,1,5,6,-3,3,0,3,3,6,0,2,-2,2,-5,14,4,-7,3,1,0,-1,-1,-1,-1,1,2,-1
KR_6758776620,420,0,87,-52,-1,1,2,3,0,3,3,2,0,2,-1,6,5,-3,3,0,0,8,-26,-7,-3,10,-1,0,2,-1,-1,1,1,5,-1
KR_6761024076,420,2,47,0,-2,2,0,2,-1,3,2,4,0,4,-3,6,3,-4,5,-1,1,7,-5,4,-7,3,3,0,0,1,-1,0,1,1,-1
KR_6714158145,420,-2,13,-40,-2,-3,3,0,-1,4,3,2,3,5,2,0,2,-2,3,-1,0,-19,-2,0,-4,4,-4,0,0,0,1,0,1,0,-1
KR_6700541235,420,-2,-73,-11,-9,0,3,3,-3,3,0,-11,13,2,-3,5,2,8,1,-9,0,11,-14,-7,0,7,2,0,-1,0,1,-1,-1,0,-1
KR_6698934031,420,-2,-74,-8,-7,-5,5,0,-3,4,1,1,1,2,1,1,2,-1,3,-2,0,5,-50,-4,-3,7,-25,0,-3,-1,-1,-1,-1,5,-1
KR_6764328975,440,-1,-1,9,1,-3,8,5,1,0,1,8,0,8,-1,1,0,-4,4,0,0,0,-6,-1,-4,5,-3,0,0,-1,-1,-1,1,2,-1
KR_6681494538,420,-3,-81,9,0,-2,3,1,3,0,3,1,1,2,-1,3,2,-1,3,-2,1,-10,-32,-5,-1,6,-17,0,-1,1,-1,-1,1,1,-1
KR_6763381420,420,-3,-44,-2,-6,-1,1,0,0,2,2,-3,3,0,1,5,6,-3,3,0,1,5,-3,2,-7,5,2,0,0,1,-1,-1,1,3,-1
KR_6762181878,420,-2,-18,-4,3,-2,5,3,6,0,6,2,0,2,-3,5,2,0,0,0,0,-12,4,-1,-4,5,1,0,1,1,1,1,1,2,-1
KR_6692459198,420,-3,-50,-48,1,1,4,5,-1,4,3,0,1,1,4,2,6,-3,6,-3,-1,-1,24,3,-8,5,4,0,-3,-1,-1,-1,-1,5,-1
KR_6756768223,420,-2,12,-23,-5,1,1,2,-8,8,0,-1,1,0,2,2,4,1,1,-2,0,5,0,4,-6,2,26,0,0,-1,1,1,-1,5,-1
KR_6739988755,420,4,-32,50,6,1,2,3,3,1,4,-3,4,1,3,2,5,2,0,-2,0,-2,4,-1,-4,5,-4,0,1,0,-1,1,1,0,-1
KR_6757659342,440,3,39,4,7,-2,2,0,1,1,2,0,2,2,0,3,3,8,0,-8,1,-5,0,2,-4,2,0,0,1,1,-1,1,-1,2,-1
KR_6749419697,420,-5,-32,-32,-14,-1,4,3,-3,5,2,-4,5,1,-7,7,0,1,3,-4,0,13,9,3,-5,2,4,0,0,-1,-1,0,-1,5,-1
KR_6743152520,440,2,-15,-5,-2,-1,3,2,-2,3,1,-4,5,1,0,2,2,5,3,-8,1,-8,-5,0,-3,3,1,0,-1,1,-1,-1,1,2,-1
KR_6763238424,420,-3,-13,5,-5,-2,5,3,-3,3,0,4,0,4,-4,4,0,0,0,0,0,6,-11,-3,-2,5,2,0,-2,-1,-1,-1,-1,5,-1
KR_6730062769,420,-7,-44,-20,-7,-4,5,1,-1,1,0,-3,3,0,-2,5,3,3,0,-3,1,1,0,-4,-3,7,3,0,-3,-1,-1,-1,1,3,-1
KR_6763964925,420,-3,-70,0,-3,2,1,3,-1,1,0,-5,6,1,2,2,4,-1,3,-2,0,-4,-3,0,-7,7,-8,0,-1,-1,1,1,1,1,-1
KR_6649912275,420,0,31,-16,1,-2,3,1,1,6,7,-4,6,2,3,1,4,3,0,-3,1,-12,-1,0,-5,5,0,0,0,-1,-1,0,1,3,-1
KR_6738591878,420,-1,-8,-2,-1,0,0,0,-1,3,2,-1,3,2,2,2,4,-1,3,-2,1,3,-26,-3,-2,5,5,0,0,0,0,0,1,0,-1
KR_6690980436,420,1,95,28,3,5,0,5,0,3,3,0,2,2,-1,1,0,-1,2,-1,1,-4,-16,0,-5,5,-2,0,0,1,-1,1,1,3,-1
KR_6196862330,420,-5,-58,-33,-10,-3,3,0,1,2,3,-2,2,0,-5,5,0,-1,1,0,0,9,-2,-2,-4,6,-2,0,-1,-1,1,-1,-1,1,-1
KR_6758438827,440,-2,-30,-8,-3,1,1,2,3,4,7,1,1,2,-7,8,1,-1,1,0,0,2,-15,-5,-2,7,-6,0,-1,-1,-1,-1,-1,1,-1
KR_6751278122,420,0,-12,-12,-4,-5,5,0,2,0,2,1,1,2,-2,2,0,0,0,0,0,-2,-1,-3,-4,7,7,0,0,-1,-1,0,-1,1,-1
KR_6743345430,420,-3,-21,-8,-1,-3,4,1,-1,6,5,2,3,5,3,2,5,-2,2,0,0,4,6,5,-8,3,6,0,-1,1,-1,-1,1,4,-1
KR_6749270977,420,1,-38,12,-1,2,2,4,0,3,3,-1,2,1,-3,4,1,1,0,-1,0,1,7,1,-3,2,2,0,0,-1,-1,-1,-1,1,-1
KR_6701314269,420,-4,-33,-16,-6,3,2,5,0,1,1,-3,3,0,-7,7,0,1,1,-2,1,11,245,-2,-3,5,4,0,-1,-1,1,-1,1,5,-1
KR_6740957782,420,2,25,-6,5,0,1,1,1,1,2,-1,1,0,3,1,4,2,1,-3,1,-8,0,0,-5,5,2,0,0,1,-1,1,1,6,-1
KR_6706661887,440,0,-8,8,-1,4,0,4,2,2,4,-3,6,3,-3,4,1,-1,2,-1,1,5,-4,2,-6,4,2,0,0,-1,1,-1,1,1,-1
KR_6763098483,420,-4,-62,-15,-6,-1,3,2,0,2,2,-3,6,3,-2,3,1,0,2,-2,0,4,-114,-4,0,4,1,0,-2,-1,-1,-1,1,5,-1
KR_6715159686,420,-1,-9,-16,-6,-2,2,0,-4,4,0,1,1,2,0,3,3,-1,1,0,-1,8,-10,-2,-4,6,0,0,-1,-1,-1,-1,-1,2,-1
KR_6762311397,420,-6,-92,-40,-11,-5,7,2,-1,2,1,-1,4,3,-2,3,1,-2,3,-1,2,-2,-6,-2,-4,6,-1,0,-4,-1,1,-1,1,1,-1
KR_6672291840,420,-3,-97,-32,-6,-2,3,1,-1,2,1,-1,1,0,-3,4,1,1,0,-1,0,6,-8,-4,-2,6,-1,0,-1,-1,-1,-1,-1,1,-1
KR_6761530973,420,-3,-21,-4,-8,2,0,2,-3,6,3,1,5,6,-9,10,1,1,0,-1,0,8,-3,-1,-7,8,0,0,0,1,-1,-1,-1,6,-1
KR_6517680688,420,-2,-9,-4,1,0,1,1,0,1,1,-1,3,2,1,0,1,1,0,-1,0,-4,30,1,-4,3,-3,0,0,-1,-1,0,1,5,-1
KR_6757103633,440,-3,-8,-18,-5,2,1,3,-3,3,0,0,1,1,-4,6,2,0,1,-1,0,2,-19,1,-7,6,-3,0,0,1,-1,0,-1,6,-1
KR_6745123797,440,0,-23,8,-1,3,1,4,-3,3,0,2,2,4,0,1,1,-3,3,0,0,9,-9,-1,-3,4,2,0,0,-1,1,0,-1,2,-1
KR_6759315972,440,2,-20,5,-1,-1,2,1,0,2,2,0,3,3,-3,6,3,3,0,-3,-1,-5,18,-1,-7,8,1,0,0,1,-1,-1,-1,2,-1
KR_6609067969,420,-3,-27,-8,-12,1,1,2,-1,2,1,-7,10,3,-5,6,1,0,1,-1,-1,17,-223,-2,-1,3,1,0,-3,-1,-1,-1,-1,2,-1
KR_6748797610,420,2,-11,12,3,-2,3,1,1,4,5,1,4,5,4,1,5,-1,2,-1,1,-16,-9,0,-3,3,-6,0,0,1,0,0,1,1,-1
KR_6761865874,420,-1,23,-5,1,-5,6,1,2,4,6,2,0,2,3,2,5,-1,2,-1,0,-3,10,0,-3,3,-4,0,2,-1,1,1,-1,1,-1
KR_6684321839,420,1,44,-12,6,0,0,0,0,1,1,3,0,3,2,2,4,1,1,-2,-1,-12,9,4,-5,1,-1,0,0,1,-1,1,-1,6,-1
KR_6760493832,420,-3,-8,1,-9,0,0,0,-5,6,1,-4,6,2,0,4,4,0,1,-1,0,11,-144,2,-5,3,5,0,0,-1,-1,0,-1,5,-1
KR_6740506827,420,-3,-62,-7,-10,-1,3,2,-7,7,0,-1,3,2,-3,7,4,2,0,-2,0,9,-2,0,-2,2,4,0,-1,1,1,-1,-1,2,-1
KR_6754754414,420,-3,-31,-38,-4,-1,5,4,-3,6,3,0,1,1,-2,2,0,2,2,-4,0,3,-135,-2,-4,6,3,0,-1,-1,-1,-1,1,6,-1
KR_6697856451,420,-2,-47,-14,-6,1,4,5,1,3,4,-5,5,0,-1,3,2,-2,3,-1,0,9,-1,0,-6,6,0,0,-2,-1,0,-1,1,2,-1
KR_6743858719,420,1,45,-28,6,-1,1,0,-2,4,2,1,1,2,7,0,7,1,2,-3,0,0,-7,-3,-4,7,-6,0,1,1,-1,1,1,1,-1
KR_6761871587,420,-1,17,0,-6,2,1,3,-1,1,0,-7,8,1,0,2,2,0,0,0,0,5,-7,1,-6,5,4,0,0,-1,-1,0,-1,5,-1
KR_6740450176,420,1,6,4,3,-1,1,0,0,3,3,-3,6,3,5,2,7,2,0,-2,1,-7,2,-1,-2,3,0,0,0,-1,-1,-1,1,1,-1
KR_6720794898,420,2,37,16,7,3,1,4,3,2,5,3,3,6,-3,8,5,1,0,-1,0,4,16,1,-4,3,3,0,1,-1,1,1,1,4,-1
KR_6740617247,420,-7,-112,-8,-14,-1,2,1,-7,7,0,3,1,4,-6,9,3,-3,3,0,0,13,4,-6,-1,7,0,0,-2,0,-1,-1,-1,0,-1
KR_6753911343,420,-3,-32,-20,-11,-2,2,0,-1,1,0,0,3,3,-7,7,0,-1,2,-1,0,17,9,1,-4,3,4,0,0,-1,-1,-1,-1,5,-1
KR_6735665835,420,-3,1,-16,-5,3,2,5,0,1,1,1,1,2,-8,8,0,-1,2,-1,0,8,20,-3,-6,9,2,0,0,-1,-1,0,1,3,-1
KR_6728777124,420,1,-34,0,1,0,2,2,0,3,3,1,1,2,0,4,4,0,0,0,-1,0,14,3,-7,4,3,0,0,0,1,-1,-1,0,-1
KR_6763853312,440,-5,-78,-28,-9,6,0,6,-5,7,2,-6,6,0,-3,3,0,-1,1,0,0,10,5,1,-3,2,3,0,-2,-1,-1,-1,1,5,-1
KR_6741695102,420,-3,-2,-33,-3,2,0,2,-4,5,1,-2,3,1,1,2,3,0,0,0,0,9,-121,0,-4,4,1,0,0,-1,1,0,-1,2,-1
KR_6747445750,420,-3,5,8,-2,0,3,3,2,2,4,-2,4,2,-2,5,3,0,1,-1,0,0,15,-5,-5,10,-1,0,-1,-1,1,-1,1,5,-1
KR_6763163075,420,-4,-79,-20,-1,-2,2,0,0,0,0,2,0,2,0,2,2,-1,1,0,0,2,2,3,-5,2,0,0,0,0,-1,0,1,0,-1
KR_6721907619,420,0,14,2,-6,7,0,7,-1,2,1,-1,3,2,-7,10,3,-4,4,0,0,16,-6,-1,-5,6,-1,0,-1,-1,1,1,-1,2,-1
